Would you like to turn on accessibility features like no ASCII art and no special characters? (enter "A" to turn on accessibility features, "N" to turn them off)

>f
You pass into the aft airlock, the outer door closing behind you.

The Second Law of Thermodynamics, in one formulation, states that disorganization always increases in the absence of some outside force. A corollary is that things will always break down in the absence of someone to fix them. As a member of the repair corps of Space Station Omicron-5, you're that someone.

Your last assignment of the day, on the SS Usagi, a Space Marines fighting ship, looks routine enough. Fix the microwave and a jammed locker door, and then you're off for the day.

Aft Airlock
You are in the aft airlock. Outside is the gangway back to Space Station Omicron-5. Forward leads into the ship.

A pleasant androgynous voice says, "Welcome to the SS Usagi. This is the shipboard computer. Please feel free to call upon me for any information you may need. Use the command 'computer, help' for more information."

* * *

>f
You enter the ship from the airlock. The inner door closes behind you.

Staging Area
This is the staging area of the ship, where marines prepare for missions. It is adjacent to the aft airlock. It houses a number of vac suits in an open locker, and various munitions in locked compartments set into the walls. A ladder leads up into the rest of the ship. 
Through the airlock windows you can see the gangway to Space Station Omicron-5.

What looks like part of an engine is stowed in a corner.

>open locker
That's already open.

>x suit
A puffy yellow suit with an attached helmet and magnetic boots. The gloves are misshapen things, optimized for carrying weaponry, not precision work. There is a nozzle on the front through which air can be recharged or vented. Lights indicate the boots are currently off. A gauge indicates the suit has 15 units of air left.
[I always wanted one of these.]

⇒ You can vent air by using "vent suit."

>x gloves
Rather than being optimized for manual dexterity, these gloves are shaped to more easily wield a laser rifle.

>x helmet
A big transparent fish bowl.

>x gloves
Rather than being optimized for manual dexterity, these gloves are shaped to more easily wield a laser rifle.

>x boots
Big boots with a thick sole. Lights indicate these boots are currently off.

>x nozzle
This is useful for venting air from the suit.

>x gauge
The gauge indicates the suit has 15 units of air left.

>turn on boots
You switch the Magnetic boots on.

>x boots
Big boots with a thick sole. Lights indicate these boots are currently on.

>x suit
A puffy yellow suit with an attached helmet and magnetic boots. The gloves are misshapen things, optimized for carrying weaponry, not precision work. There is a nozzle on the front through which air can be recharged or vented. Lights indicate the boots are currently on. A gauge indicates the suit has 15 units of air left.

>wear suit
(first taking the vac suit)
In general, the crew's gear is off-limits.

>l
Staging Area
This is the staging area of the ship, where marines prepare for missions. It is adjacent to the aft airlock. It houses a number of vac suits in an open locker, and various munitions in locked compartments set into the walls. A ladder leads up into the rest of the ship. 
Through the airlock windows you can see the gangway to Space Station Omicron-5.

What looks like part of an engine is stowed in a corner.

>x engine
This is a wide, low, trapezoidal hunk of metal bearing the marking JL-758 on one side. Numerous electrical contacts dot the upper surface. Someone has threaded a thick cord with clips on both ends through some openings on the top and side.

>x contacts
It looks like the JL-758 is meant to be put under something, so that it makes contact with some other device.

>x cord
It looks like this is meant to attach the brand-new JL-758 to something.

* * *

>x clips
It looks like this is meant to attach the brand-new JL-758 to something.

>l
Staging Area
This is the staging area of the ship, where marines prepare for missions. It is adjacent to the aft airlock. It houses a number of vac suits in an open locker, and various munitions in locked compartments set into the walls. A ladder leads up into the rest of the ship. 
Through the airlock windows you can see the gangway to Space Station Omicron-5.

What looks like part of an engine is stowed in a corner.

>x windows
You can see the aft airlock through a window in the airlock door. Beyond the airlock is the gangway back to Space Station Omicron-5.

>u
You climb the la--

***BOOM***

Press any key...

A gigantic force grabs the ship, knocking you off the ladder and sending you flying against an aft bulkhead. The inertial dampers are probably all that saved you from being smashed to jelly rather than just banged up. 

Press any key...

Some time later you find yourself lying on the floor of the staging area with a throbbing headache. Gingerly you push yourself to your knees and stand up. The vac suit locker has detached from its mounting and slammed into the airlock door.

[Thank god I wasn't in the way of that.]

Looking outside --

[Holy -- ]

[Where's the station?].

Where Space Station Omicron-5 was, is now an expanding sphere of rubble, dimly lit by the blue light of far-off Deneb. The rubble is clearly receding behind the ship. [We're moving!]

[How am I going to get off this ship?]

Press any key...

Staging Area
This is the staging area of the ship, where marines prepare for missions. It is adjacent to the aft airlock. Locked compartments set into the walls hold various munitions. A ladder leads up into the rest of the ship. 

An equipment locker is sprawled across the room, with its door to the ground.
 
Through the airlock windows you see the blank space left by the destruction of Space Station Omicron-5.

What looks like part of an engine is stowed in a corner.

A vac suit is here, lying prone as if it were some malformed yellow person knocked unconscious by the shaking of the ship. It has chewing gum stuck to it.

[What now?]

[I think I spit out my gum.]

Crash
An Interactive Disaster by Phil Riley
Release 6 / Serial number 220730 / Inform 7 build 6M62 (I6/v6.34 lib 6/12N) SD

>x gum
It's a used wad of pink chewing gum. It used to taste like grape, but now it tastes of nothing. It's stuck to the vac suit.

>take it
You unstick the chewing gum from the vac suit.

>take it
You already have that.

>chew it
You put the chewing gum in your mouth.

>l
Staging Area
This is the staging area of the ship, where marines prepare for missions. It is adjacent to the aft airlock. Locked compartments set into the walls hold various munitions. A ladder leads up into the rest of the ship. 

An equipment locker is sprawled across the room, with its door to the ground.
 
Through the airlock windows you see the blank space left by the destruction of Space Station Omicron-5.

What looks like part of an engine is stowed in a corner.

A vac suit is here, lying prone as if it were some malformed yellow person knocked unconscious by the shaking of the ship.

>put gum on suit
(first spitting out the chewing gum)
You stick the chewing gum to the vac suit.

>wear suit
(first taking the vac suit)
You put on the vac suit.

>x gum
It's a used wad of pink chewing gum. It used to taste like grape, but now it tastes of nothing. It's stuck to the vac suit.

>remove suit
You take off the vac suit.

>take gum
You unstick the chewing gum from the vac suit.

>put it on uniform
You stick the chewing gum to the repair corps uniform.

>wear suit
You put on the vac suit.

>x gum
You know it's on the repair corps uniform, but you can't see it with the vac suit over it.

>take it
You can't reach the gum with the vac suit on top of your uniform.

>remove suit
You take off the vac suit.

>take gum
You unstick the chewing gum from the repair corps uniform.

The chewing gum has become stuck to the vac suit.

>chew it
You can't chew the gum when it's stuck to the vac suit.

>i
You are carrying:
  a vac suit with chewing gum stuck to it
  a To-Do list
  a repair corps uniform (being worn)
  a toolbox

>take gum
You unstick the chewing gum from the vac suit.

>i
You are carrying:
  some used chewing gum
  a vac suit
  a To-Do list
  a repair corps uniform (being worn)
  a toolbox

>x me
Nice uniform.

The chewing gum has become stuck to the vac suit.

>x gum
It's a used wad of pink chewing gum. It used to taste like grape, but now it tastes of nothing. It's stuck to the vac suit.

>l
Staging Area
This is the staging area of the ship, where marines prepare for missions. It is adjacent to the aft airlock. Locked compartments set into the walls hold various munitions. A ladder leads up into the rest of the ship. 

An equipment locker is sprawled across the room, with its door to the ground.
 
Through the airlock windows you see the blank space left by the destruction of Space Station Omicron-5.

What looks like part of an engine is stowed in a corner.

>x locker
The vac suit locker has fallen with its door to the ground. It looks pretty heavy.

>open it
The locker has fallen door-side down.

>take suit
You already have that.

>turn locker
It's much too heavy to turn over.

>flip it over
It's much too heavy to turn over.

>x ladder
An ordinary metal ladder, it connects the staging area to the crew quarters.

>u
Junction
This is a busy place when the ship is populated. To port and starboard are the crew quarters, aft is the closed door to the captain's private quarters, and fore is the galley. A ladder leads down to the staging area.

⇒ You can enter "hints" at any time for help in progressing in the game.

>x door
The Captain's Door is a conventional, self-opening starship door. It is painted in the traditional red of a starship captain. It features a slot through which you may slide the appropriate access card. Beside the door is an access panel, which is closed.

>x lader
You can't see any such thing.

>x ladder
An ordinary metal ladder, it connects the staging area to the crew quarters.

>x slot
It's a typical card slot, perfect for sliding thin things through.

>x panel
The access panel is set in the bulkhead to the left of the door. It is closed and held fast with a screw.

>open it
You open the panel, hanging on to the blue screw that held it shut.

The access panel opens to reveal a row of fuses, one of which is blown.

>take blow fuse
You can't see any such thing.

>take blown fuse
Taken.

>x it
A typical yellow cartridge fuse, turned a smoky black.

>x fuses
The panel holds a row of fuses, with one empty spot.

>l
Junction
This is a busy place when the ship is populated. To port and starboard are the crew quarters, aft is the closed door to the captain's private quarters, and fore is the galley. A ladder leads down to the staging area.

>open door
You can't just open the door with your bare hands. It needs an access card.

>unlock door
What do you want to unlock the Captain's Door with?

>card
You can't see any such thing.

>unlock door with gum
(first taking the chewing gum)
You unstick the chewing gum from the vac suit.

That doesn't seem to be something you can unlock.

>f
Galley
This narrow space is barely enough room for two Marines to prepare and eat a meal. There is a counter with a drawer, and two stools, a microwave oven, and a large closet here. Pots and pans hang from hooks in the ceiling. A ladder leads up through the midship door, and you can leave aft.

On the starboard wall is a panel on which is a blue button. Tacked to the panel is the operator's manual for the midship door.

You faintly hear someone speaking above.

>x marines
You can't see any such thing.

>x counter
A standard kitchen counter.

>x drawer
A small kitchen drawer which is closed.

>open it
You open the kitchen drawer, revealing a knife, a fork, and a spoon.

>take lal
You can't see any such thing.

>take all
knife: Taken.
fork: Taken.
spoon: Taken.

>x microwave
(the microwave oven)
The microwave is closed. It's plugged into a socket inset in the countertop. The front display is black. A large red button below the display says "Start".

The chewing gum has become stuck to the vac suit.

>x display
The front display is black.

>x button
Which do you mean, the start button or the galley's blue button?

>start
What do you want to start?

>x start button
It's a red button. It says "Start".

>start microwave
(the microwave oven)
Nothing happens, but it's unclear why.

>press red button
Nothing happens, but it's unclear why.

>x cord
You can't see any such thing.

>x socket
It's an ordinary grounded wall socket. The microwave oven is plugged in to it.

>unplug
What do you want to unplug?

>oven
You unplug the microwave oven.

>x socket
It's an ordinary grounded wall socket. Upon close inspection, you notice that it's clogged up with dust.

>x plug
It's an ordinary grounded plug.

>x socket
It's an ordinary grounded wall socket. Upon close inspection, you notice that it's clogged up with dust.

>l
Galley
This narrow space is barely enough room for two Marines to prepare and eat a meal. There is a counter with a drawer, and two stools, a microwave oven, and a large closet here. Pots and pans hang from hooks in the ceiling. A ladder leads up through the midship door, and you can leave aft.

On the starboard wall is a panel on which is a blue button. Tacked to the panel is the operator's manual for the midship door.

You faintly hear someone speaking above.

>x pots
There is a wide array of cookware here, none of which is likely to be useful to you.

>take pots
The pots and pans are not something you need to fix the ship.

>x ladder
It's an ordinary metal ladder. It connects the Galley to the Operations Deck. It has a small gap halfway up to accomodate the midship door.

>up
(first opening Midship Door)
You can't open that with your bare hands.

>x door
(Midship Door)
The midship door is a square hatch, separating Operations Deck from the Galley. It is made of a strong black plastic/metal alloy.

>listen
You can hear someone talking above you, but it's unclear if they're male or female. They're talking in short bursts with pauses between them, and no one seems to be answering.

>knock at door
I didn't understand that sentence.

>knock on door
(Midship Door)
Whoever's up there, they didn't hear you apparently.

>yell
Whoever is talking doesn't seem to hear you.

>scream
Whoever is talking doesn't seem to hear you.

>shout
Whoever is talking doesn't seem to hear you.

>press button
Which do you mean, the start button or the galley's blue button?

>blue
A loud buzzer sounds and a red light flashes on the door, which stays resolutely shut.

>x light
You can't see any such thing.

>l
Galley
This narrow space is barely enough room for two Marines to prepare and eat a meal. There is a counter with a drawer, and two stools, a microwave oven, and a large closet here. Pots and pans hang from hooks in the ceiling. A ladder leads up through the midship door, and you can leave aft.

On the starboard wall is a panel on which is a blue button. Tacked to the panel is the operator's manual for the midship door.

You faintly hear someone speaking above.

>x stools
You can't use multiple objects with that verb.

>x stool
Which do you mean, the left stool or the right stool?

* * *

>left
A tall bar-type stool, bolted to the floor.

>x manual
Most of the manual is concerned with the technical details of the door, such as installation, maintainance, and repair. There is a small section towards the end detailing its safety features; for example: "To prevent injury, the Portmaster V S-65 will not open when it senses weight pressing upon it from above. In this case, an audible signal and a red warning light will indicate that an obstruction exists."

>take it
It is chained securely to the control panel. Best leave it.

>x panel
The control panel features a prominent blue button for opening the door above. The door operations manual dangles on a chain from the panel.

>take button
Which do you mean, the start button or the galley's blue button?

>blue
That seems to be a part of the control panel.

>l
Galley
This narrow space is barely enough room for two Marines to prepare and eat a meal. There is a counter with a drawer, and two stools, a microwave oven, and a large closet here. Pots and pans hang from hooks in the ceiling. A ladder leads up through the midship door, and you can leave aft.

On the starboard wall is a panel on which is a blue button. Tacked to the panel is the operator's manual for the midship door.

You faintly hear someone speaking above.

>f
The obvious exits are aft (to junction) and up.

* * *

>a
Junction
This is a busy place when the ship is populated. To port and starboard are the crew quarters, aft is the closed door to the captain's private quarters, and fore is the galley. A ladder leads down to the staging area.

>s
Starboard-Side Crew Quarters
All crew members who aren't the captain sleep in this or the opposite-side bunk room. This one sleeps two in a bunk bed, done up with military precision. There is a large cabinet here, stretching almost to the ceiling. It is closed. Mounted in the wall is a crew personal storage unit. The sole exit is to port.

In a shocking lapse of military precision, there is a sticky note attached to the bed post.

A pair of slippers peeks out from under the bed.

* * *

>x slippers
These seem comfy.

>x bed
A fairly typical military bunk bed.

>x bunk
A fairly typical military bunk bed.

>x    unit
The storage unit consists of top and bottom drawers, with an attached keypad and display. There is a keyhole under the keypad. Both drawers are closed.

>x keypad
A standard 0-9 keypad with a "*" and "#". Below the keys is a small keyhole.

>x display
The display says "Enter Code".

>type 3445
The storage unit buzzes and the display lights up "ERROR".

>unlock unit
What do you want to unlock the crew personal storage unit with?

>gum
(first taking the chewing gum)
You unstick the chewing gum from the vac suit.

That doesn't seem to be something you can unlock.

The chewing gum has become stuck to the vac suit.

>unlock keypad
What do you want to unlock the keypad with?

>l
Starboard-Side Crew Quarters
All crew members who aren't the captain sleep in this or the opposite-side bunk room. This one sleeps two in a bunk bed, done up with military precision. There is a large cabinet here, stretching almost to the ceiling. It is closed. Mounted in the wall is a crew personal storage unit. The sole exit is to port.

In a shocking lapse of military precision, there is a sticky note attached to the bed post.

A pair of slippers peeks out from under the bed.

>x cabinet
A simple black-painted steel cabinet, it is closed.

* * *

>x door
You look closely, but you can't see anything from here that would stop the door from opening all the way.

>open it
The door is stuck one-quarter open. You try to open the cabinet the rest of the way, but the door is jammed.

>look in locker
You can't see any such thing.

>look in cabinet
You can't see inside, since the starboard-side equipment cabinet is closed.

>up
The only obvious exit is port (to junction).

>get on bunk
You get onto the top bunk.

>open door
The door is stuck one-quarter open. You try to open the cabinet the rest of the way, but the door is jammed.

>x cabinet
You can see the problem from up here: the top hinge of the cabinet door has a crooked screw, probably from the door being slammed too many times. You'll have to replace it.

>take screw
(the crooked screw)
You unscrew the old screw and replace it with a new one from your toolbox.

You cross out an item ("fix the cabinet") on your to-do list.

[Your score has just gone up by one point.]

>d
You get off the top bunk.

Starboard-Side Crew Quarters
All crew members who aren't the captain sleep in this or the opposite-side bunk room. This one sleeps two in a bunk bed, done up with military precision. There is a large cabinet here, stretching almost to the ceiling. It is closed. Mounted in the wall is a crew personal storage unit. The sole exit is to port.

In a shocking lapse of military precision, there is a sticky note attached to the bed post.

A pair of slippers peeks out from under the bed.

>x screwdriver
All of your tools are top quality.

>x screw
It's a fairly small screw, covered in blue enamel.

>i
You are carrying:
  a spoon
  a fork
  a knife
  a blown fuse
  a blue screw
  a vac suit with chewing gum stuck to it
  a To-Do list
  a repair corps uniform (being worn)
  a toolbox

>i
You are carrying:
  a spoon
  a fork
  a knife
  a blown fuse
  a blue screw
  a vac suit with chewing gum stuck to it
  a To-Do list
  a repair corps uniform (being worn)
  a toolbox

>x fasteners
All of your tools are top quality.

>x screw
It's a fairly small screw, covered in blue enamel.

>x screws
All of your tools are top quality.

>x bolts
All of your tools are top quality.

>x nails
You can't see any such thing.

>l
Starboard-Side Crew Quarters
All crew members who aren't the captain sleep in this or the opposite-side bunk room. This one sleeps two in a bunk bed, done up with military precision. There is a large cabinet here, stretching almost to the ceiling. It is closed. Mounted in the wall is a crew personal storage unit. The sole exit is to port.

In a shocking lapse of military precision, there is a sticky note attached to the bed post.

A pair of slippers peeks out from under the bed.

>read note
Written on the note is "Mail package to Mitchell ASAP".

>take it
Taken.

>stick it to slippers
The sticky note seems to have lost its stick.

>drop it
Dropped.

>take slippers
As you lean to take the slippers, you notice something under the bed.

>take bed
That's hardly portable.

>look under it
You find a black trunk and move it out from under the bottom bunk.

Starboard-Side Crew Quarters
All crew members who aren't the captain sleep in this or the opposite-side bunk room. This one sleeps two in a bunk bed, done up with military precision. There is a large cabinet here, stretching almost to the ceiling. It is closed. Mounted in the wall is a crew personal storage unit. The sole exit is to port.

You can see a black trunk (closed) and a sticky note here.

>x trunk
This is a large, plain black trunk with steel trim. It latches shut, but doesn't have a locking mechanism.

>open it
You open the black trunk, revealing a present.

* * *

>take present
Taken.

>x it
This is a box wrapped in paper obviously intended for a child. Written on the outside is the message "To Mitchell, Happy Second Birthday! Love, Uncle Fred"

>open it
[I'll go to hell for this, but here goes...]

You rip off the wrapping paper and open the box. Inside is a stuffed bear you recognize as Bertie the Bear™. You discard the paper and box.

>x bear
Bertie the Bear™ is a massively popular toy. It accepts voice commands, and its eyes, actually advanced optical sensors, can differentiate between individuals. This bear's blindly staring eyes are unnerving.

>x paper
The paper, which is adorned with cartoon animals in primary colors prancing around the words "Happy Birthday", is ripped beyond repair.

* * *

>x eyes
They're well disguised, but the eyes are clearly top-of-the-line optical sensors that you might see in more serious uses, such as in facial recognition devices.

>remove eyes
[Am I really going to do this? Yes, yes, I am, apparently.]

You grasp one of the eyes and give it a tug, first softly then harder. Eventually it gives and you extract the eye from the bear. Upon examination you discover that the eye is in fact an optical sensor in camouflage. It looks like you didn't pull it carefully enough, however, because the connector at the end has been damaged.

You try again more carefully with the second eye, and manage to produce an undamaged optical sensor.

>i
You are carrying:
  a new optical sensor
  Bertie the Bear™
  some pair of slippers
  a spoon
  a fork
  a knife
  a blown fuse
  a blue screw
  a vac suit with chewing gum stuck to it
  a To-Do list
  a repair corps uniform (being worn)
  a toolbox

>x sensor
The optical sensor is a small component with a two-pronged connector on the back and a blue metallic circle on the other.

* * *

>p
Junction
This is a busy place when the ship is populated. To port and starboard are the crew quarters, aft is the closed door to the captain's private quarters, and fore is the galley. A ladder leads down to the staging area.

>kick door
I'm not sure what you're trying to say. I might just not recognize the words you're using.

>hit door
Violence isn't the answer to this one.

>p
Port-Side Crew Quarters
All crew members who aren't the captain sleep in this or the opposite-side bunk room. This one sleeps two in a bunk bed, done up with military precision. There is a large cabinet here, stretching almost to the ceiling. It is closed. Mounted in the wall is a crew personal storage unit. The sole exit is to starboard.

>x bunk
A fairly typical military bunk bed.

>x cabinet
A simple black-painted steel cabinet, it is closed.

* * *

>x door
It's a simple black-painted steel door.

>open it
It isn't something you can open.

>open cabinet
You open the port-side equipment cabinet, revealing an engineering uniform and an Universal Game Emulator.

>x uniform
(the repair corps uniform)
The repair corps uniform is a smart hunter green color, with a patch featuring a hammer and a wrench, crossed.

>x engineering uniform
Colored the traditional mustard yellow of Engineering, it's really a remarkably ugly uniform.

In the engineering uniform is a piece of note paper.

>read note
Scribbled on the paper is the number 9467.

>key 9467
As you press a key, the storage unit starts buzzing continuously. The display lights up with random characters, and you smell the distinct odor of burning wires. The bottom storage drawer pops out a centimeter or two.

You add an item ("fix the storage unit") to your to-do list.

>press 9467
The storage unit seems to be broken.

>x bottom drawer
The bottom drawer is labeled "Khotpanya". The bottom drawer juts out by a couple of centimeters.

>put gum in drawer
Which do you mean, the top drawer or the bottom drawer?

>bottom
You'll have to open the drawer all of the way to put something in it.

>open it
It isn't something you can open.

>open bottom drawer
The drawer is partially open, but you can't find a purchase on it firm enough to open it.

>i
You are carrying:
  a new optical sensor
  Bertie the Bear™
  some pair of slippers
  a spoon
  a fork
  a knife
  a blown fuse
  a blue screw
  a vac suit with chewing gum stuck to it
  a To-Do list
  a repair corps uniform (being worn)
  a toolbox

>pry bottom drawer open with screwdriver
The screwdriver is too large to pry open the bottom drawer.
[Dang. I really thought that would work.]

>pry bottom drawer open with wrench
The wrench is too large to pry open the bottom drawer.

>pry bottom drawer open with knife
You wedge the knife into the seam and lever the drawer open, revealing the red access card.

>take card
Taken.

>x it
The card is red, with the Space Authority symbol that designates it as an access card, but otherwise featureless. [Looks like the captain's card. Why would that be in a crewman's drawer?]

>s
Junction
This is a busy place when the ship is populated. To port and starboard are the crew quarters, aft is the closed door to the captain's private quarters, and fore is the galley. A ladder leads down to the staging area.

>open door with card
The door won't function until the panel is closed.
[Who designed this thing?]

>unlock door with card
The door won't function until the panel is closed.

>close panel
[Why should I close it when I haven't fixed it yet?]

>x it
The access panel is set in the bulkhead to the left of the door. It is open, leaving an empty hole where the screw was.

The panel holds a row of fuses, with one empty spot.

>i
You are carrying:
  the red access card
  a new optical sensor
  Bertie the Bear™
  some pair of slippers
  a spoon
  a fork
  a knife
  a blown fuse
  a blue screw
  a vac suit with chewing gum stuck to it
  a To-Do list
  a repair corps uniform (being worn)
  a toolbox

>l
Junction
This is a busy place when the ship is populated. To port and starboard are the crew quarters, aft is the closed door to the captain's private quarters, and fore is the galley. A ladder leads down to the staging area.

>d
Staging Area
This is the staging area of the ship, where marines prepare for missions. It is adjacent to the aft airlock. Locked compartments set into the walls hold various munitions. A ladder leads up into the rest of the ship. 

An equipment locker is sprawled across the room, with its door to the ground.
 
Through the airlock windows you see the blank space left by the destruction of Space Station Omicron-5.

What looks like part of an engine is stowed in a corner.

* * *

>a
You try to enter the airlock, but the automatic door fails to open for you.
[It's always just opened in the past.]

You add an item ("fix the airlock door") to your to-do list.

>open door
It isn't something you can open.

>x it
The airlock door is an imposing solid barrier between vacuum and safety. It is colored yellow with red warning symbols on it. Above the door is a panel of electronic components.

>x symbols
You can't see any such thing.

>drop trunk
You can't see any such thing.

* * *

>u
Junction
This is a busy place when the ship is populated. To port and starboard are the crew quarters, aft is the closed door to the captain's private quarters, and fore is the galley. A ladder leads down to the staging area.

>s
Starboard-Side Crew Quarters
All crew members who aren't the captain sleep in this or the opposite-side bunk room. This one sleeps two in a bunk bed, done up with military precision. There is a large cabinet here, stretching almost to the ceiling. It is closed. Mounted in the wall is a crew personal storage unit. The sole exit is to port.

You can see a cardboard box (empty), some wrapping paper, a black trunk (empty), and a sticky note here.

>take trunk
Taken.

* * *

>drop trunk
Dropped.

>up
Junction
This is a busy place when the ship is populated. To port and starboard are the crew quarters, aft is the closed door to the captain's private quarters, and fore is the galley. A ladder leads down to the staging area.

>d
Staging Area
This is the staging area of the ship, where marines prepare for missions. It is adjacent to the aft airlock. Locked compartments set into the walls hold various munitions. A ladder leads up into the rest of the ship. 

An equipment locker is sprawled across the room, with its door to the ground.
 
Through the airlock windows you see the blank space left by the destruction of Space Station Omicron-5.

What looks like part of an engine is stowed in a corner.

You can also see a black trunk (empty) here.

>get on trunk
(first closing the black trunk)
You get onto the black trunk.

>x panel
The prominent features of the panel are two optical sensors. One of them has become partially detached and looks broken.

>d
You get off the black trunk.

Staging Area
This is the staging area of the ship, where marines prepare for missions. It is adjacent to the aft airlock. Locked compartments set into the walls hold various munitions. A ladder leads up into the rest of the ship. 

An equipment locker is sprawled across the room, with its door to the ground.
 
Through the airlock windows you see the blank space left by the destruction of Space Station Omicron-5.

What looks like part of an engine is stowed in a corner.

You can also see a black trunk (closed) here.

>x panel
The component panel is too high.

>take broken sensor
You can't see any such thing.

>get on trunk
You get onto the black trunk.

>open trunk
You'll have to get off the black trunk first.

>d
You get off the black trunk.

Staging Area
This is the staging area of the ship, where marines prepare for missions. It is adjacent to the aft airlock. Locked compartments set into the walls hold various munitions. A ladder leads up into the rest of the ship. 

An equipment locker is sprawled across the room, with its door to the ground.
 
Through the airlock windows you see the blank space left by the destruction of Space Station Omicron-5.

What looks like part of an engine is stowed in a corner.

You can also see a black trunk (closed) here.

>open trunk
You open the black trunk.

>get on trunk
(first closing the black trunk)
You get onto the black trunk.

* * *

>x panel
The prominent features of the panel are two optical sensors. One of them has become partially detached and looks broken.

>take broken sensor
You remove the broken sensor from the panel.

>put sensor in panel
Which do you mean, the broken sensor or the new optical sensor?

>new
You insert the fresh sensor into the empty socket.
[There. That should do it.]

You cross out an item ("fix the airlock door") on your to-do list.

[Your score has just gone up by one point.]

>a
(first getting off the black trunk)

Aft Airlock
You are in the aft airlock. Outside is the blackness of space, speckled with the dying embers of what was once Space Station Omicron-5. Forward leads into the ship.

>x boots
Big boots with a thick sole. Lights indicate these boots are currently off.

>turn on boots
You switch the Magnetic boots on.

>out
Not without a vac suit, you aren't.

>i
You are carrying:
  a broken sensor
  the red access card
  Bertie the Bear™
  some pair of slippers
  a spoon
  a fork
  a knife
  a blown fuse
  a blue screw
  a vac suit with chewing gum stuck to it
  a To-Do list
  a repair corps uniform (being worn)
  a toolbox

>wear suit
You put on the vac suit.

>out
It's dangerous out there. I recommend saving the game first...
⇒ Use "save" to save the game, or go "out" again to continue without saving.

>out
Outside the Aft Airlock (vacuum)
You are standing on the hull of the ship, outside the aft airlock, secured by your vac suit's mag boots. Most of the hull is taken up by the protrusions of various machinery, antennae, radio dishes, and heat sinks. There is a clear path to fore among the obstructions. You can also go in to the airlock.

A hook protrudes from the hull next to the airlock door.

Your vac suit pings gently to indicate you have expended a unit of air.

>turn off boots
You switch the Magnetic boots off.

Your vac suit pings gently to indicate you have expended a unit of air.

>l
Outside the Aft Airlock (vacuum)
You are floating in the blackness of space outside of the aft airlock. Most of the hull is taken up by the protrusions of various machinery, antennae, radio dishes, and heat sinks. There is a clear path to fore among the obstructions. You can also go in to the airlock.

A hook protrudes from the hull next to the airlock door.

Your vac suit pings gently to indicate you have expended a unit of air.

>f
You take a step on the hull of the ship, and keep going, and going... Should have turned those mag boots on.
[Oops.]

    *** You float forever in the vastness of space ***

In that game you scored 2 out of a possible 10, in 211 turns.

Your death was completely pointless and preventable. All the same we grudgingly award you one point each for what you did accomplish, which was:
- fixing the equipment cabinet in the starboard-side crew quarters
- fixing the aft airlock door

Would you like to RESTART, RESTORE a saved game, QUIT, or UNDO the last command?

>undo
Outside the Aft Airlock (vacuum)
[Previous turn undone.]

>turn on boots
You switch the Magnetic boots on.

Your vac suit pings gently to indicate you have expended a unit of air.

>l
Outside the Aft Airlock (vacuum)
You are standing on the hull of the ship, outside the aft airlock, secured by your vac suit's mag boots. Most of the hull is taken up by the protrusions of various machinery, antennae, radio dishes, and heat sinks. There is a clear path to fore among the obstructions. You can also go in to the airlock.

A hook protrudes from the hull next to the airlock door.

Your vac suit pings gently to indicate you have expended a unit of air.

>f
Hull of the Usagi (vacuum)
Here the path runs aft to the aft airlock and starboard to the engineering airlock. Your path to starboard is blocked by a piece of debris lodged in the hull. [Whatever happened, this was part of it. It's fortunate it didn't penetrate further into the hull.] It's going to be tough to get over; it doesn't look magnetic, so your mag boots won't stick to it. You'll need to be careful.

There is a hook set in the hull here.

It looks like you could break off a small piece of debris.

Your vac suit pings gently to indicate you have expended a unit of air.

>take debris
(the small piece of debris)
You break off a piece of the debris.

Your vac suit pings gently to indicate you have expended a unit of air.

>s
You attempt to climb over the debris. Just when you think you're over, your foot catches, and you lose your hold. The result: you're floating about a foot from the hull, unable to make contact with your mag boots to pull yourself down. You're barely moving relative to the hull, but you're stuck here. The bright side? You broke down the debris enough that it's no longer a barrier.

[Okay, stay calm. Don't freak out.]

Hull of the Usagi (vacuum, floating)
Here the path runs aft to the aft airlock and starboard to the engineering airlock. Where there used to be a large embedded chunk of debris blocking the path, now there is a scattering of rubble.

There is a hook set in the hull here.

Your vac suit pings gently to indicate you have expended a unit of air.

>throw debris
(the small piece of debris)
You throw the small piece of debris away from the ship. It propels you just a tiny amount toward the hull, but it's enough. One agonizing minute later, you're attached to the hull again.

[Oh thank god! I thought I was a goner.]

Hull of the Usagi (vacuum)
Here the path runs aft to the aft airlock and starboard to the engineering airlock. Where there used to be a large embedded chunk of debris blocking the path, now there is a scattering of rubble.

There is a hook set in the hull here.

Your vac suit pings gently to indicate you have expended a unit of air.

>s
Outside the Engineering Airlock (vacuum)
You are standing on the hull of the ship, outside the engineering airlock, secured by your vac suit's mag boots. Most of the hull is taken up by the protrusions of various machinery, antennae, radio dishes, and heat sinks. There is a clear path to port among the obstructions. You can also go in to the airlock.

A hook protrudes from the hull next to the airlock door.

A stern voice in your helmet intones "Air levels critical. Seek a pressurized location immediately."

>in
Engineering Airlock
You are in the engineering airlock. Outside, the space to starboard looks so empty and peaceful it's hard to imagine the awful sight astern.

⇒ astern: behind or toward the rear of a ship, spaceship or aircraft.

>in
Engineering Deck
The engineering crew is responsible for keeping the physical ship operating. They are in charge of every physical aspect of the ship, from the engines to hull integrity to the life support system.

The engineering deck consists of a large console giving a comprehensive view of the physical status of the ship. There is an airlock to starboard. The operations deck continues forward from here, and there are other exits to aft and port.

You hear someone speaking to fore.

A device labeled "Suit Recharging Station" is here. It is shaped like a chair with nozzles protruding from either arm.

>sit in sear
You can't see any such thing.

>sit in seat
The nozzles on either side of the chair connect with the suit. After a few moments, the machine emits a pleasant "ping", the nozzles retract, and you stand up.

>x seat
It looks like a person might sit in it.

>x nozzles
This is useful for venting air from the suit.

>x deck
You can't see any such thing.

* * *

>mess with it
I SAID YOU DARE NOT MESS WITH IT!

>touch console
I SAID YOU DARE NOT MESS WITH IT!

>x controls
Without a degree in starship engineering, trying to understand these controls is pointless.

* * *

>x monitors
Without a degree in starship engineering, trying to understand these controls is pointless.

>a
Engine Room
This where the combustion process is controlled. The aft wall is dominated by the operating panel of the fusion engine. Monitoring electronics and controls cover the other two walls. A doorway opens forward to the Engineering Deck.

There is a large screen on the forward wall. It displays nothing right now. There is a large button below the diagram labeled "Test".

>x screen
The diagram screen is black.

>press button
Nothing happens.

>move screen
There's no point to pushing the engine diagram around.

>ask computer about screen
The Delphi Engine Controls Aleph-Null is a fuel injection controller. It controls the process by which different substances are combined to produce the desired fuel. Since many fuels, such as Liquid Copernicium, have short half-lives, they must be produced shortly before use. Hence the necessity of the fuel injection controller.

>x engine
(the fusion engine)
The portion of the engine directly accessible from the engine room is a formidable machine. You wouldn't dare touch any of the various dials, components, hatches, etc. that adorn the surface. At your feet a part of the engine juts out -- it looks broken.

You add an item ("fix the engine") to your to-do list.

>x broken
(the broken sensor)
You can tell it's broken because the connecting prongs are too short.

>x broken engine
This is a wide, low, trapezoidal piece of metal like the one you've seen in the Staging Area, only this one looks scorched. It has the marking JL-758 on the front.

>take it
Don't worry about that for now. Worry about finding a replacement.

>f
Engineering Deck
The engineering crew is responsible for keeping the physical ship operating. They are in charge of every physical aspect of the ship, from the engines to hull integrity to the life support system.

The engineering deck consists of a large console giving a comprehensive view of the physical status of the ship. There is an airlock to starboard. The operations deck continues forward from here, and there are other exits to aft and port.

You hear someone speaking to fore.

A device labeled "Suit Recharging Station" is here. It is shaped like a chair with nozzles protruding from either arm.

>p
Machine Room
The machine room is where the physical work of Engineering takes place; for instance, machining new parts. There is a large counter lined with drawers here, as well as numerous saws, drills, and other pieces of equipment. You can leave to starboard.

There's a hand vac sitting on the counter.

>take vac
(the portable hand-held vacuum cleaner)
Taken.

>open drawers
You open the machine room drawers, revealing a small key, a roll of electrical tape, a hex-shaped tool, and a fresh fuse.

* * *

>take all
small key: Taken.
roll of electrical tape: Taken.
hex-shaped tool: Taken.
fresh fuse: Taken.

>s
Engineering Deck
The engineering crew is responsible for keeping the physical ship operating. They are in charge of every physical aspect of the ship, from the engines to hull integrity to the life support system.

The engineering deck consists of a large console giving a comprehensive view of the physical status of the ship. There is an airlock to starboard. The operations deck continues forward from here, and there are other exits to aft and port.

You hear someone speaking to fore.

A device labeled "Suit Recharging Station" is here. It is shaped like a chair with nozzles protruding from either arm.

>f
Operations Deck
This is where all of the support activity for the bridge occurs. There are large consoles for environmental controls (which include gravity, temperature, and pressure), communications, and power systems here. The bridge continues forward from here, and engineering is aft. There is a door set in the floor with a ladder leading through it. Set in the frame of the door is a blue button.

A large equipment trunk lies on the midship door, blocking it.

A man's voice comes over comms: "SS Usagi, come in! Is anyone there?"

[Finally, another person! I'm saved!]

⇒ By the way... you can get help about speaking to other characters by typing "help speech".

>ask man about chicken
You should say hello first.

>hello
(addressing the caller)
You call out "Yes! I'm here! I'm here! What's going on?"

The caller responds, "Ahoy there, SS Usagi, good to hear from you. Seems like you're a bit out of sorts, and we'd like to help you out. But before we get into that, who am I speaking to? Tell me about yourself."

* * *

>ask computer about deneb ii
Once the jewel of Deneb sector and a paradise of natural splendor, over the last two centuries Deneb II has succumbed to creeping corporatization. The resulting degrading of the ecosphere is a primary reason for the exodus to Deneb IV and the separatist movement which has followed.

>ask computer about new da nang
New Da Nang is a moon of Deneb II. It is the home of famous composer Orenascopol Thrax.

"Yes or no?"

>yes
"Great, great. Now let's get to work.

 "The first thing I need you to do is reboot the system, using the computer. Once you do that, hopefully I'll be able to access ship controls. You'll have to use my access code: say 'compu--"

Master Sergeant R. Mu Arvax's voice breaks up and another voice comes over comms. "SS Usagi, this is Captain Jane Mulgrew, please come in. Repeat, this is Captain Mulgrew of the SS Usagi, Usagi come in."

[Somebody else?]

>ask computer about thrax
I'm unable to give you any information about thrax.

>ask computer about arvax
Classified personnel data on Master Sergeant R. Mu Arvax: Master Sergeant Arvax has had a distinguished career in the Space Marines, but has come under scrutiny in recent years for alleged sympathies with separatist factions on Deneb IV. Military Intelligence has so far declined to move on Arvax, but urges commanding officers to exercise discretion in their dealings with him, and to remain vigilant for any suspicious behavior.

Captain Mulgrew: "We hear you, Usagi, please respond."

>hello
(addressing Captain Jane Mulgrew)
Captain Mulgrew responds, "Hello there, Usagi. That's my ship you've got there. Be careful with her.

"We've been listening in and we've heard your communications with Arvax. He had us jammed for a while, but we managed to break through and here we are. Now it's very important that you understand this: Arvax is not your friend. His allegiances lie with Deneb IV, not with the Space Authority. He would like nothing more than to see this ship wipe out a few neighborhoods on New Da Nang.

"So what we need you to do is deny Arvax by shutting down any access to the ship's controls from the outside by invoking the emergency protocols. That will put the ship in a state where we can board and take control of the ship. What do you say? Do you have any questions?"

Master Sergeant R. Mu Arvax's voice comes back over the radio: "You there still, Usagi? I think I lost you for a second."

[Oh no, who should I trust?]

>ask computer about mulgrew
Captain Mulgrew is one of the most decorated captains in the Deneb sector. She was the second-youngest graduate of the Orion Marine Academy. She received command of the SS Usagi after successfully leading the retaking of the capital of Pollux VI from Irion invaders from the moon of Pollux III.

>ask mulgrew about emergency protocols
"To prevent Arvax from seizing control of the ship remotely, we need to put the ship in a mode where it ignores all data communications. Voice radio will still be able to get through, but communications with the computer from outside will cease. You'll need to use my access code: say 'computer, access code 3'."

>computer, access code 3
Welcome, Captain Jane Mulgrew. Logging you in.

* * *

>computer, emergency protocols
Beginning emergency protocols. Take all appropriate precautions.

Red alert lights flash throughout the ship.

The emergency depressurization siren sounds throughout the ship.
[Nice of Mulgrew to warn me.]

>ask mulgrew about emergency protocols
You can't see any such thing.

>z
Time passes.

Your vac suit pings gently to indicate you have expended a unit of air.

>x communications
The communications console is used for all communications, including long-range subspace and short-range radio communications. A readout displays the connections on each channel: "channel 1 -- Deneb III Marine Command, channel 2 -- Unknown Caller, channel 3 -- No Connection."

Your vac suit pings gently to indicate you have expended a unit of air.

The depressurization siren stops.

>g
The communications console is used for all communications, including long-range subspace and short-range radio communications. A readout displays the connections on each channel: "channel 1 -- Deneb III Marine Command, channel 2 -- Unknown Caller, channel 3 -- No Connection."

Emergency protocols complete.

Approaching New Da Nang. Beginning emergency countdown at 60.

>g
The communications console is used for all communications, including long-range subspace and short-range radio communications. A readout displays the connections on each channel: "channel 1 -- Deneb III Marine Command, channel 2 -- No Connection, channel 3 -- No Connection."

>ask mulgrew about emergency protocols
You can't see any such thing.

>hello
(addressing Master Sergeant R. Mu Arvax)
"Finally! Where've you been? I'm sad to see you invoked Mulgrew's emergency protocols, but that's water under the bridge. Now we need to try to salvage the situation."

>ask arvax about situation
"We don't have time for that!"

"I'm trying to divert the ship from its collision course with New Da Nang, but there are some problems: the helm is not responding to any commands, there is some physical issue with the engine, and the fuel injection specification for the fusion engine is incorrect. 

"To be honest, friend, the readouts I'm seeing about the state of helm control are dire. I'm not sure it can be fixed."

>ask arvax about engine
(the fusion engine)
"It's probably the engine stabilizer that's broken, but that doesn't matter without helm control. Go check on the helm -- the pilot's console."

>f
Bridge
This is where the captain, navigator, and pilot all sit. Large viewscreens give a full view of the space around the ship. To port you can see the blue-white disk of Deneb. Astern you can faintly see the fading embers of what was Space Station Omicron-5.
 
The pilot's and navigator's chairs sit before their respective consoles. The captain's chair, with command console, sits halfway between them and operations further aft.

You hear someone speaking aft of here.

>x command console
The command console displays the red outline of a hand.

⇒ You can "touch command console" to touch your palm to it.

* * *

>touch it
Unauthorized access attempted. This event has been logged by security.

>x chairs
You can't use multiple objects with that verb.

>x chair
Which do you mean, the pilot's chair, the navigator's chair, or the captain's chair?

* * *

>captain
Functional yet comfortable, it is every inch the chair of a commander. On the arm of the captain's chair is the command console, with which the captain commands the shipboard computer.

>ask computer about ship
(the ss usagi)

The SS Usagi is a light frigate in the Deneb system, with a crew of five including the captain. It is currently helmed by Captain Jane Mulgrew. The ship's main drive is a Luna Spacewerks Parsec VI.

>ask computer about bridge
A gangway is an inflatable bridge used to transfer people and equipment to and from space vessels.

>x console
Which do you mean, the command console, the pilot's console, or the navigator's console?

>pilot's
The pilot's console is a sloped table covered with cryptic readouts and touch controls. In the back is an access panel which is closed. A hex-shaped aperture is probably the locking mechanism.

>open access panel with tool
You can't use multiple objects with that verb.

>open pilot's access panel with tool
Which do you mean, the hex-shaped tool or the toolbox?

>hex
You unlock the pilot's access panel.

>open it
Opening the pilot's access panel reveals a fused mass of wiring and circuit boards. It's ruined beyond repair.

>x wiring
It's ruined.

>x circuit
It's ruined.

>a
Operations Deck
This is where all of the support activity for the bridge occurs. There are large consoles for environmental controls (which include gravity, temperature, and pressure), communications, and power systems here. The bridge continues forward from here, and engineering is aft. There is a door set in the floor with a ladder leading through it. Set in the frame of the door is a blue button.

A large equipment trunk lies on the midship door, blocking it.

Master Sergeant R. Mu Arvax: "You there, Usagi? We don't have much time."

>ask arvax about ship
(the ss usagi)
"I'm sorry, I don't think the helm can be fixed -- not with the time you have left. You're going to have to destroy the ship."
[Oh god, this is it.]

>ask arvax about helm
"We don't have time for that!

"I'm sorry, I don't think the helm can be fixed -- not with the time you have left. You're going to have to destroy the ship."
[Oh god, this is it.]

>ask about destroying the ship
I don't know much about it, but I imagine it can be done by setting the fuel mix right... well, wrong, I guess.

>a
Engineering Deck
The engineering crew is responsible for keeping the physical ship operating. They are in charge of every physical aspect of the ship, from the engines to hull integrity to the life support system.

The engineering deck consists of a large console giving a comprehensive view of the physical status of the ship. There is an airlock to starboard. The operations deck continues forward from here, and there are other exits to aft and port.

You hear someone speaking to fore.

A device labeled "Suit Recharging Station" is here. It is shaped like a chair with nozzles protruding from either arm.

* * *

>a
Engine Room
This where the combustion process is controlled. The aft wall is dominated by the operating panel of the fusion engine. Monitoring electronics and controls cover the other two walls. A doorway opens forward to the Engineering Deck.

There is a large diagram of the fuel injection process on the forward wall. There is a large button below the diagram labeled "Test".

>f
Engineering Deck
The engineering crew is responsible for keeping the physical ship operating. They are in charge of every physical aspect of the ship, from the engines to hull integrity to the life support system.

The engineering deck consists of a large console giving a comprehensive view of the physical status of the ship. There is an airlock to starboard. The operations deck continues forward from here, and there are other exits to aft and port.

You hear someone speaking to fore.

A device labeled "Suit Recharging Station" is here. It is shaped like a chair with nozzles protruding from either arm.

* * *

>f
Operations Deck
This is where all of the support activity for the bridge occurs. There are large consoles for environmental controls (which include gravity, temperature, and pressure), communications, and power systems here. The bridge continues forward from here, and engineering is aft. There is a door set in the floor with a ladder leading through it. Set in the frame of the door is a blue button.

A large equipment trunk lies on the midship door, blocking it.

Master Sergeant R. Mu Arvax: "You there, Usagi? We don't have much time."

>d
There's an equipment trunk blocking the door.

>push trunk
You push the trunk clear of the door.

Master Sergeant R. Mu Arvax: "You there, Usagi? We don't have much time."

>push button
The door slides open.

* * *

>a
Junction
This is a busy place when the ship is populated. To port and starboard are the crew quarters, aft is the closed door to the captain's private quarters, and fore is the galley. A ladder leads down to the staging area.

>s
Starboard-Side Crew Quarters
All crew members who aren't the captain sleep in this or the opposite-side bunk room. This one sleeps two in a bunk bed, done up with military precision. There is a large cabinet here, stretching almost to the ceiling. It is closed. Mounted in the wall is a crew personal storage unit. The sole exit is to port.

You can see a cardboard box (empty), some wrapping paper, and a sticky note here.

>get on bed
You get onto the top bunk.

>x bunk
A fairly typical military bunk bed.

>x top bunk
This bunk is, like the other, made up with regulation precision.

>x door
It's a simple black-painted steel door.

>x cabinet
A simple black-painted steel cabinet, it is closed.

>d
You get off the top bunk.

Starboard-Side Crew Quarters
All crew members who aren't the captain sleep in this or the opposite-side bunk room. This one sleeps two in a bunk bed, done up with military precision. There is a large cabinet here, stretching almost to the ceiling. It is closed. Mounted in the wall is a crew personal storage unit. The sole exit is to port.

You can see a cardboard box (empty), some wrapping paper, and a sticky note here.

>open cabinet
You open the starboard-side equipment cabinet, revealing a beacon.

* * *

>p
Junction
This is a busy place when the ship is populated. To port and starboard are the crew quarters, aft is the closed door to the captain's private quarters, and fore is the galley. A ladder leads down to the staging area.

>f
Galley
This narrow space is barely enough room for two Marines to prepare and eat a meal. There is a counter with a drawer, and two stools, a microwave oven, and a large closet here. Pots and pans hang from hooks in the ceiling. A ladder leads up through the midship door, and you can leave aft.

On the starboard wall is a panel on which is a blue button. Tacked to the panel is the operator's manual for the midship door.

You hear someone speaking above.

>u
Operations Deck
This is where all of the support activity for the bridge occurs. There are large consoles for environmental controls (which include gravity, temperature, and pressure), communications, and power systems here. The bridge continues forward from here, and engineering is aft. There is a door set in the floor with a ladder leading through it. Set in the frame of the door is a blue button.

You can see an equipment trunk (closed) here.

>a
Engineering Deck
The engineering crew is responsible for keeping the physical ship operating. They are in charge of every physical aspect of the ship, from the engines to hull integrity to the life support system.

The engineering deck consists of a large console giving a comprehensive view of the physical status of the ship. There is an airlock to starboard. The operations deck continues forward from here, and there are other exits to aft and port.

You hear someone speaking to fore.

A device labeled "Suit Recharging Station" is here. It is shaped like a chair with nozzles protruding from either arm.

* * *

>a
Engine Room
This where the combustion process is controlled. The aft wall is dominated by the operating panel of the fusion engine. Monitoring electronics and controls cover the other two walls. A doorway opens forward to the Engineering Deck.

There is a large diagram of the fuel injection process on the forward wall. There is a large button below the diagram labeled "Test".

>x diagram
This is a diagram of the fuel injection process for the fusion engine. Printed above it is the label "Delphi Engine Controls Aleph-Null". Below that is a representation of the various inputs and the products created during the fuel injection process. Each input has a touch-sensitive surface which can be used to alter the diagram's settings.

       Input: 2 --  3 --  4 --
                ||    ||    ||
             ===vv====vv====vv===
Input 1:     -- >> -- >> -- >> --  Output
             ====================

        FUEL INJECTION SPECIFICATION INCOMPLETE

Key:    --   empty input or output
        AH   Anti-Helium
        LC   Liquid Copernicium*
        Og   Oganesson
        RM   Red Matter            
        TC   Tachyon Crystals
        Un   Unobtainium
        VM   Void Matter*

        * this substance can only be produced, not input.

⇒ Use "substance > input" to set each input. For instance, "Un > 3" sets input 3 to Unobtainium. You may also use "set <input> to <substance>" for the same effect. Use "disconnect <input>" to disconnect an input.

* * *

>ask computer about vm
Void Matter is essentially vacuum condensed into matter, according to the most comprehensible description we could find. It is an extremely unstable substance, and tends to explode catastrophically in the presence of high levels of energy. It can be created by injecting one source of tachyon crystals into another source of tachyon crystals.

>tc > 4
This is a diagram of the fuel injection process for the fusion engine. Printed above it is the label "Delphi Engine Controls Aleph-Null". Below that is a representation of the various inputs and the products created during the fuel injection process. Each input has a touch-sensitive surface which can be used to alter the diagram's settings.

       Input: 2 --  3 --  4 TC
                ||    ||    ||
             ===vv====vv====vv===
Input 1:     -- >> -- >> -- >> --  Output
             ====================

        FUEL INJECTION SPECIFICATION INCOMPLETE

Key:    --   empty input or output
        AH   Anti-Helium
        LC   Liquid Copernicium*
        Og   Oganesson
        RM   Red Matter            
        TC   Tachyon Crystals
        Un   Unobtainium
        VM   Void Matter*

        * this substance can only be produced, not input.

>ask computer about tc
Rather than containing or being formed of tachyons, tachyon crystals get their name from their use in detecting tachyons, due to their negative refractive index. The typical method of creating tachyon crystals is injecting Anti-Helium into Red Matter. Tachyon Crystals can be used in the creation of Void Matter.

* * *

>ask computer about rm
Red Matter is an unstable, possibly impossible substance created by injecting Tachyon Crystals into Unobtainium.

>tc > 2
This is a diagram of the fuel injection process for the fusion engine. Printed above it is the label "Delphi Engine Controls Aleph-Null". Below that is a representation of the various inputs and the products created during the fuel injection process. Each input has a touch-sensitive surface which can be used to alter the diagram's settings.

       Input: 2 TC  3 AH  4 TC
                ||    ||    ||
             ===vv====vv====vv===
Input 1:     -- >> -- >> -- >> --  Output
             ====================

        FUEL INJECTION SPECIFICATION INCOMPLETE

Key:    --   empty input or output
        AH   Anti-Helium
        LC   Liquid Copernicium*
        Og   Oganesson
        RM   Red Matter            
        TC   Tachyon Crystals
        Un   Unobtainium
        VM   Void Matter*

        * this substance can only be produced, not input.

>un > 1
This is a diagram of the fuel injection process for the fusion engine. Printed above it is the label "Delphi Engine Controls Aleph-Null". Below that is a representation of the various inputs and the products created during the fuel injection process. Each input has a touch-sensitive surface which can be used to alter the diagram's settings.

       Input: 2 TC  3 AH  4 TC
                ||    ||    ||
             ===vv====vv====vv===
Input 1:     Un >> RM >> TC >> VM  Output
             ====================

        WARNING: DANGEROUS INJECTION PRODUCT

Key:    --   empty input or output
        AH   Anti-Helium
        LC   Liquid Copernicium*
        Og   Oganesson
        RM   Red Matter            
        TC   Tachyon Crystals
        Un   Unobtainium
        VM   Void Matter*

        * this substance can only be produced, not input.

"Impact in 10."

>press test
A voice says "Fuel test sequence beginning..."

"Impact in 9."

"10"

>f
Engineering Deck
The engineering crew is responsible for keeping the physical ship operating. They are in charge of every physical aspect of the ship, from the engines to hull integrity to the life support system.

The engineering deck consists of a large console giving a comprehensive view of the physical status of the ship. There is an airlock to starboard. The operations deck continues forward from here, and there are other exits to aft and port.

You hear someone speaking to fore.

A device labeled "Suit Recharging Station" is here. It is shaped like a chair with nozzles protruding from either arm.

"Impact in 8."

"9"

>out
Engineering Airlock
You are in the engineering airlock. Outside, the space to starboard looks so empty and peaceful it's hard to imagine the awful sight astern.

"Impact in 7."

"8"

>out
Outside the Engineering Airlock (vacuum)
You are standing on the hull of the ship, outside the engineering airlock, secured by your vac suit's mag boots. Most of the hull is taken up by the protrusions of various machinery, antennae, radio dishes, and heat sinks. There is a clear path to port among the obstructions. You can also go in to the airlock.

A hook protrudes from the hull next to the airlock door.

"Impact in 6."

Your vac suit pings gently to indicate you have expended a unit of air.

"7"

>jump
You can't even begin to jump in these mag boots.

"Impact in 5."

Your vac suit pings gently to indicate you have expended a unit of air.

"6"

>turn off boots
You switch the Magnetic boots off.

"Impact in 4."

Your vac suit pings gently to indicate you have expended a unit of air.

"5"

>out
You propel yourself away from the ship, away from the explosion that follows moments later. You switch on your beacon. Hours later, after you'd given up hope, a ship of the Space Marines finds you and brings you home. You are sorry you couldn't save the SS Usagi, but for your part in saving the people of New Da Nang, you receive a medal for meritorious service and are promoted to Lance Corporal.

    *** You saved New Da Nang, but lost the ship. ***

In that game you scored 4 out of a possible 10, in 316 turns.

Hooray for saving New Da Nang! The Space Marine leadership is less happy about losing the SS Usagi. But here's your score breakdown. You get one point each for:
- fixing the equipment cabinet in the starboard-side crew quarters
- fixing the aft airlock door

You also get a point for saving yourself, and a point for saving New Da Nang! Congratulations!

Would you like to RESTART, RESTORE a saved game, QUIT, or UNDO the last command?

* * *

>f
You enter the ship from the airlock. The inner door closes behind you.

Staging Area
This is the staging area of the ship, where marines prepare for missions. It is adjacent to the aft airlock. It houses a number of vac suits in an open locker, and various munitions in locked compartments set into the walls. A ladder leads up into the rest of the ship. 
Through the airlock windows you can see the gangway to Space Station Omicron-5.

What looks like part of an engine is stowed in a corner.

>u
You climb the la--

***BOOM***

Press any key...

A gigantic force grabs the ship, knocking you off the ladder and sending you flying against an aft bulkhead. The inertial dampers are probably all that saved you from being smashed to jelly rather than just banged up. 

Press any key...

Some time later you find yourself lying on the floor of the staging area with a throbbing headache. Gingerly you push yourself to your knees and stand up. The vac suit locker has detached from its mounting and slammed into the airlock door.

[Thank god I wasn't in the way of that.]

Looking outside --

[Holy -- ]

[Where's the station?].

Where Space Station Omicron-5 was, is now an expanding sphere of rubble, dimly lit by the blue light of far-off Deneb. The rubble is clearly receding behind the ship. [We're moving!]

[How am I going to get off this ship?]

Press any key...

Staging Area
This is the staging area of the ship, where marines prepare for missions. It is adjacent to the aft airlock. Locked compartments set into the walls hold various munitions. A ladder leads up into the rest of the ship. 

An equipment locker is sprawled across the room, with its door to the ground.
 
Through the airlock windows you see the blank space left by the destruction of Space Station Omicron-5.

What looks like part of an engine is stowed in a corner.

A vac suit is here, lying prone as if it were some malformed yellow person knocked unconscious by the shaking of the ship. It has chewing gum stuck to it.

[What now?]

[I think I spit out my gum.]

Crash
An Interactive Disaster by Phil Riley
Release 6 / Serial number 220815 / Inform 7 build 6M62 (I6/v6.34 lib 6/12N) SD

* * *

Would you like to turn on accessibility features like no ASCII art and no special characters? (enter "A" to turn on accessibility features, "N" to turn them off)

>n
Accessibility off.

The Second Law of Thermodynamics, in one formulation, states that disorganization always increases in the absence of some outside force. A corollary is that things will always break down in the absence of someone to fix them. As a member of the repair corps of Space Station Omicron-5, you're that someone.

Your last assignment of the day, on the SS Usagi, a Space Marines fighting ship, looks routine enough. Fix the microwave and a jammed locker door, and then you're off for the day.

Space Station Gangway
This is the pressurized bridge from Space Station Omicron-5 to the SS Usagi. Behind you is the familiar bulk of the huge station, largest outpost of the Space Authority in Deneb Sector. Before you is the aft airlock of the Usagi, beckoning you in.

[Better get a move on], you think.

⇒ Tip: Type "help" to learn about this game, and interactive fiction in general.

* * *

>f
You enter the ship from the airlock. The inner door closes behind you.

Staging Area
This is the staging area of the ship, where marines prepare for missions. It is adjacent to the aft airlock. It houses a number of vac suits in an open locker, and various munitions in locked compartments set into the walls. A ladder leads up into the rest of the ship. 
Through the airlock windows you can see the gangway to Space Station Omicron-5.

What looks like part of an engine is stowed in a corner.

>u
Staging Area
This is the staging area of the ship, where marines prepare for missions. It is adjacent to the aft airlock. Locked compartments set into the walls hold various munitions. A ladder leads up into the rest of the ship. 

An equipment locker is sprawled across the room, with its door to the ground.
 
Through the airlock windows you see the blank space left by the destruction of Space Station Omicron-5.

What looks like part of an engine is stowed in a corner.

A vac suit is here, lying prone as if it were some malformed yellow person knocked unconscious by the shaking of the ship. It has chewing gum stuck to it.

[What now?]

[I think I spit out my gum.]

Crash
An Interactive Disaster by Phil Riley
Release 6 / Serial number 220815 / Inform 7 build 6M62 (I6/v6.34 lib 6/12N) SD

>x suit
A puffy yellow suit with an attached helmet and magnetic boots. The gloves are misshapen things, optimized for carrying weaponry, not precision work. There is a nozzle on the front through which air can be recharged or vented. Lights indicate the boots are currently off. A gauge indicates the suit has 15 units of air left.
[I always wanted one of these.]

There is some chewing gum stuck to the vac suit.
⇒ You can vent air by using "vent suit."

* * *

>x suit
A puffy yellow suit with an attached helmet and magnetic boots. The gloves are misshapen things, optimized for carrying weaponry, not precision work. There is a nozzle on the front through which air can be recharged or vented. Lights indicate the boots are currently off. A gauge indicates the suit has 15 units of air left.
There is some chewing gum stuck to the vac suit.
[I always wanted one of these.]

⇒ You can vent air by using "vent suit."

* * *

>x vac suit
A puffy yellow suit with an attached helmet and magnetic boots. The gloves are misshapen things, optimized for carrying weaponry, not precision work. There is a nozzle on the front through which air can be recharged or vented. Lights indicate the boots are currently off. A gauge indicates the suit has 15 units of air left.
[I always wanted one of these.]

⇒ You can vent air by using "vent suit."