Crash
An Interactive Disaster by Phil Riley
Release 5 / Serial number 220724 / Inform 7 build 6M62 (I6/v6.34 lib 6/12N) SD

Space Station Gangway
This is the pressurized bridge from Space Station Omicron-5 to the SS Usagi. Behind you is the familiar bulk of the huge station, largest outpost of the Space Authority in Deneb Sector. Before you is the aft airlock of the Usagi, beckoning you in.

[Better get a move on], you think.

>f
You pass into the aft airlock, the outer door closing behind you.

The Second Law of Thermodynamics, in one formulation, states that disorganization always increases in the absence of some outside force. A corollary is that things will always break down in the absence of someone to fix them. As a member of the repair corps of Space Station Omicron-5, you're that someone.

Your last assignment of the day, on the SS Usagi, a Space Marines fighting ship, looks routine enough. Fix the microwave and a jammed locker door, and then you're off for the day.

Aft Airlock
You are in the aft airlock. Outside is the gangway back to Space Station Omicron-5. Forward leads into the ship.

A pleasant androgynous voice says, "Welcome to the SS Usagi. This is the shipboard computer. Please feel free to call upon me for any information you may need. Use the command 'computer, help' for more information."

* * *

>f
You enter the ship from the airlock. The inner door closes behind you.

Staging Area
This is the staging area of the ship, where marines prepare for missions. It is adjacent to the aft airlock. It houses a number of vac suits in an open locker, and various munitions in locked compartments set into the walls. A ladder leads up into the rest of the ship. 
Through the airlock windows you can see the gangway to Space Station Omicron-5.

What looks like part of an engine is stowed in a corner.

>ask computer about engine status
The SS Usagi employs a Luna Spacewerks Parsec VI. The shipboard engine is functioning normally.

>u
You climb the la--

***BOOM***

Press any key...

A gigantic force grabs the ship, knocking you off the ladder and sending you flying against an aft bulkhead. The inertial dampers are probably all that saved you from being smashed to jelly rather than just banged up. 

Press any key...

Some time later you find yourself lying on the floor of the staging area with a throbbing headache. Gingerly you push yourself to your knees and stand up. The vac suit locker has detached from its mounting and slammed into the airlock door.

[Thank god I wasn't in the way of that.]

Looking outside --

[Holy -- ]

[Where's the station?].

Where Space Station Omicron-5 was, is now an expanding sphere of rubble, dimly lit by the blue light of far-off Deneb. The rubble is clearly receding behind the ship. [We're moving!]

[How am I going to get off this ship?]

Press any key...

Staging Area
This is the staging area of the ship, where marines prepare for missions. It is adjacent to the aft airlock. Locked compartments set into the walls hold various munitions. A ladder leads up into the rest of the ship. 

An equipment locker is sprawled across the room, with its door to the ground.
 
Through the airlock windows you see the blank space left by the destruction of Space Station Omicron-5.

What looks like part of an engine is stowed in a corner.

A vac suit is here, lying prone as if it were some malformed yellow person knocked unconscious by the shaking of the ship.

[What now?]

[I think I spit out my gum.]

Crash
An Interactive Disaster by Phil Riley
Release 5 / Serial number 220724 / Inform 7 build 6M62 (I6/v6.34 lib 6/12N) SD

>ask computer about engine status
The SS Usagi employs a Luna Spacewerks Parsec VI. The shipboard engine is currently non-functional. It needs a replacement JL-758 engine stabilizer.

* * *

>f
You enter the ship from the airlock. The inner door closes behind you.

Staging Area
This is the staging area of the ship, where marines prepare for missions. It is adjacent to the aft airlock. It houses a number of vac suits in an open locker, and various munitions in locked compartments set into the walls. A ladder leads up into the rest of the ship. 
Through the airlock windows you can see the gangway to Space Station Omicron-5.

What looks like part of an engine is stowed in a corner.

>computer, access code 2
Welcome, caller. Logging you in.

>computer, help
Helpful commands: 

 - ask computer about <subject>
 - computer, emergency protocols: activates the ship's emergency protocols (needs authorization)
 - computer, reboot: restarts all ship functions (needs authorization)
 - computer, access code <code>: authorizes user

* * *

>f
You enter the ship from the airlock. The inner door closes behind you.

Staging Area
This is the staging area of the ship, where marines prepare for missions. It is adjacent to the aft airlock. It houses a number of vac suits in an open locker, and various munitions in locked compartments set into the walls. A ladder leads up into the rest of the ship. 
Through the airlock windows you can see the gangway to Space Station Omicron-5.

What looks like part of an engine is stowed in a corner.

>u
You climb the la--

***BOOM***

Press any key...

A gigantic force grabs the ship, knocking you off the ladder and sending you flying against an aft bulkhead. The inertial dampers are probably all that saved you from being smashed to jelly rather than just banged up. 

Press any key...

Some time later you find yourself lying on the floor of the staging area with a throbbing headache. Gingerly you push yourself to your knees and stand up. The vac suit locker has detached from its mounting and slammed into the airlock door.

[Thank god I wasn't in the way of that.]

Looking outside --

[Holy -- ]

[Where's the station?].

Where Space Station Omicron-5 was, is now an expanding sphere of rubble, dimly lit by the blue light of far-off Deneb. The rubble is clearly receding behind the ship. [We're moving!]

[How am I going to get off this ship?]

Press any key...

Staging Area
This is the staging area of the ship, where marines prepare for missions. It is adjacent to the aft airlock. Locked compartments set into the walls hold various munitions. A ladder leads up into the rest of the ship. 

An equipment locker is sprawled across the room, with its door to the ground.
 
Through the airlock windows you see the blank space left by the destruction of Space Station Omicron-5.

What looks like part of an engine is stowed in a corner.

A vac suit is here, lying prone as if it were some malformed yellow person knocked unconscious by the shaking of the ship.

[What now?]

[I think I spit out my gum.]

Crash
An Interactive Disaster by Phil Riley
Release 5 / Serial number 220724 / Inform 7 build 6M62 (I6/v6.34 lib 6/12N) SD

>f
The obvious exits are aft (to aft airlock), up and outside (to aft airlock).

>f
The obvious exits are aft (to aft airlock), up and outside (to aft airlock).

>u
Junction
This is a busy place when the ship is populated. To port and starboard are the crew quarters, aft is the closed door to the captain's private quarters, and fore is the galley. A ladder leads down to the staging area.

⇒ You can enter "hints" at any time for help in progressing in the game.

* * *

>open closet
You open the closet, revealing ten MREs and a microwavable dinner.

>x MREs
You can't use multiple objects with that verb.

>purloin hand
There seems to be no such object anywhere in the model world.

>purloin hand vac
[Purloined.]

>unplug microwave
(the microwave oven)
You unplug the microwave oven.

You faintly hear someone speaking above.

>vacuum socket
You vacuum the dust out of the socket.

>plug in microwave
(the microwave oven)
You plug in the microwave oven. It beeps three times and displays "Press Start".

You cross out an item ("fix the microwave") on your to-do list.

You faintly hear someone speaking above.

[Your score has just gone up by one point.]

>open microwave
(the microwave oven)
You open the microwave oven.

>take dinner
Taken.

You faintly hear someone speaking above.

>put it in microwave
(the microwavable dinner)
You can't put something inside itself.

>x microwave
(the microwavable dinner)
Spiced ham in some kind of sauce. Ugh.

You faintly hear someone speaking above.

* * *

>u
Junction
This is a busy place when the ship is populated. To port and starboard are the crew quarters, aft is the closed door to the captain's private quarters, and fore is the galley. A ladder leads down to the staging area.

⇒ You can enter "hints" at any time for help in progressing in the game.

* * *

>take dinner
Taken.

You faintly hear someone speaking above.

>open oven
You open the microwave oven.

>put dinner in microwave
(the microwave oven)
You put the microwavable dinner into the microwave oven.

You faintly hear someone speaking above.

* * *

>s
Starboard-Side Crew Quarters
All crew members who aren't the captain sleep in this or the opposite-side bunk room. This one sleeps two in a bunk bed, done up with military precision. There is a large cabinet here, stretching almost to the ceiling. It is closed. Mounted in the wall is a crew personal storage unit. The sole exit is to port.

In a shocking lapse of military precision, there is a sticky note attached to the bed post.

A pair of slippers peeks out from under the bed.

>open cabinet
The door is stuck one-quarter open. You try to open the cabinet the rest of the way, but the door is jammed.

>take all from cabinet
The starboard-side equipment cabinet isn't open.

>fix cabinet
This is a hard one. You'll have to be more specific about how you do that.

>fix door
This is a hard one. You'll have to be more specific about how you do that.

>replace screw
I'm not sure what you're referring to.

>look under bed
You find a black trunk and move it out from under the bottom bunk.

Starboard-Side Crew Quarters
All crew members who aren't the captain sleep in this or the opposite-side bunk room. This one sleeps two in a bunk bed, done up with military precision. There is a large cabinet here, stretching almost to the ceiling. It is closed. Mounted in the wall is a crew personal storage unit. The sole exit is to port.

In a shocking lapse of military precision, there is a sticky note attached to the bed post.

A pair of slippers peeks out from under the bed.

You can also see a black trunk (closed) here.

>stand on trunk
You get onto the black trunk.

>x door
You can see the problem from up here: the top hinge of the cabinet door has a crooked screw, probably from the door being slammed too many times. You'll have to replace it.

>replace screw
You unscrew the old screw and replace it with a new one.

You cross out an item ("fix the cabinet") on your to-do list.

[Your score has just gone up by one point.]

* * *

>take all from cabinet
The starboard-side equipment cabinet isn't open.

>get on bunk
You get onto the top bunk.

>x cabinet door
You can see the problem from up here: the top hinge of the cabinet door has a crooked screw, probably from the door being slammed too many times. You'll have to replace it.

>fix cabinet
You unscrew the old screw and replace it with a new one.

You cross out an item ("fix the cabinet") on your to-do list.

[Your score has just gone up by one point.]

>replace screw
I'm not sure what you're referring to.

>x door
It's a simple black-painted steel door.

>x cabinet
A simple black-painted steel cabinet, closed.

>d
You get off the top bunk.

Starboard-Side Crew Quarters
All crew members who aren't the captain sleep in this or the opposite-side bunk room. This one sleeps two in a bunk bed, done up with military precision. There is a large cabinet here, stretching almost to the ceiling. It is closed. Mounted in the wall is a crew personal storage unit. The sole exit is to port.

In a shocking lapse of military precision, there is a sticky note attached to the bed post.

A pair of slippers peeks out from under the bed.

>open door
You open the starboard-side equipment cabinet, revealing a beacon.

>restore
Restore failed.

>restart
Are you sure you want to restart?

>y
Crash
An Interactive Fiction by Philip Riley
Release 1 / Serial number 220718 / Inform 7 build 6M62 (I6/v6.34 lib 6/12N) SD

Space Station Gangway
This is the pressurized bridge from Space Station Omicron-5 to the SS Usagi. Behind you is the familiar bulk of the huge station, largest outpost of the Space Authority in Deneb Sector. Before you is the aft airlock of the Usagi, beckoning you in.

[Better get a move on], you think.

>u
The only obvious exit is fore.

* * *

>x cabinet door
You can see the problem from up here: the top hinge of the cabinet door has a crooked screw, probably from the door being slammed too many times. You'll have to replace it.

>get down
You get off the top bunk.

Starboard-Side Crew Quarters
All crew members who aren't the captain sleep in this or the opposite-side bunk room. This one sleeps two in a bunk bed, done up with military precision. There is a large cabinet here, stretching almost to the ceiling. It is closed. Mounted in the wall is a crew personal storage unit. The sole exit is to port.

In a shocking lapse of military precision, there is a sticky note attached to the bed post.

A pair of slippers peeks out from under the bed.

>x cabinet door
You look closely, but you can't see anything from here that would stop the door from opening all the way.

* * *

>take slippers
As you lean to take the slippers, you notice something under the bed.

>look under bed
You find a black trunk and move it out from under the bottom bunk.

Starboard-Side Crew Quarters
All crew members who aren't the captain sleep in this or the opposite-side bunk room. This one sleeps two in a bunk bed, done up with military precision. There is a large cabinet here, stretching almost to the ceiling. It is closed. Mounted in the wall is a crew personal storage unit. The sole exit is to port.

In a shocking lapse of military precision, there is a sticky note attached to the bed post.

You can also see a black trunk (closed) here.

>take trunk
Taken.

>open it
You open the black trunk, revealing a present.

>take present
Taken.

>open it
[I'll go to hell for this, but here goes...]

You rip off the wrapping paper and open the box. Inside is a stuffed bear you recognize as Bertie the Bear™. You discard the paper and box.

>take sensor
You can't see any such thing.

>take sensors
[Am I really going to do this? Yes, yes, I am, apparently.]

You grasp one of the eyes and give it a tug, first softly then harder. Eventually it gives and you extract the eye from the bear. Upon examination you discover that the eye is in fact an optical sensor in camouflage. It looks like you didn't pull it carefully enough, however, because the connector at the end has been damaged.

You try again more carefully with the second eye, and manage to produce an undamaged optical sensor.

>read note
Written on the note is "Mail package to Mitchell ASAP".

>l
Starboard-Side Crew Quarters
All crew members who aren't the captain sleep in this or the opposite-side bunk room. This one sleeps two in a bunk bed, done up with military precision. There is a large cabinet here, stretching almost to the ceiling. It is closed. Mounted in the wall is a crew personal storage unit. The sole exit is to port.

In a shocking lapse of military precision, there is a sticky note attached to the bed post.

You can also see a cardboard box (empty) and some wrapping paper here.

>p
Junction
This is a busy place when the ship is populated. To port and starboard are the crew quarters, aft is the closed door to the captain's private quarters, and fore is the galley. A ladder leads down to the staging area.

>d
Staging Area
This is the staging area of the ship, where marines prepare for missions. It is adjacent to the aft airlock. Locked compartments set into the walls hold various munitions. A ladder leads up into the rest of the ship. 

An equipment locker is sprawled across the room, with its door to the ground.
 
Through the airlock windows you see the blank space left by the destruction of Space Station Omicron-5.

What looks like part of an engine is stowed in a corner.

A vac suit is here, lying prone as if it were some malformed yellow person knocked unconscious by the shaking of the ship.

>s
The obvious exits are aft (to aft airlock), up (to junction) and outside (to aft airlock).

>a
You try to enter the airlock, but the automatic door fails to open for you.
[It's always just opened in the past.]

You add an item ("fix the airlock door") to your to-do list.

>x door
The airlock door is an imposing solid barrier between vacuum and safety. It is colored yellow with red warning symbols on it. Above the door is a panel of electronic components.

>drop chest
Dropped.

>stand on it
(first closing the black trunk)
You get onto the black trunk.

>x panel
The prominent features of the panel are two optical sensors. One of them has become partially detached and looks broken.

>remove broken
You aren't wearing the broken sensor.

>remove broken from panel
You remove the broken sensor from the panel.

>put optical sensor in panel
You insert the fresh sensor into the empty socket.
[There. That should do it.]

You cross out an item ("fix the airlock door") on your to-do list.

[Your score has just gone up by one point.]

>d
You get off the black trunk.

Staging Area
This is the staging area of the ship, where marines prepare for missions. It is adjacent to the aft airlock. Locked compartments set into the walls hold various munitions. A ladder leads up into the rest of the ship. 

An equipment locker is sprawled across the room, with its door to the ground.
 
Through the airlock windows you see the blank space left by the destruction of Space Station Omicron-5.

What looks like part of an engine is stowed in a corner.

A vac suit is here, lying prone as if it were some malformed yellow person knocked unconscious by the shaking of the ship.

You can also see a black trunk (closed) here.

>wear suit
(first taking the vac suit)
You put on the vac suit.

>a
Aft Airlock
You are in the aft airlock. Outside is the blackness of space, speckled with the dying embers of what was once Space Station Omicron-5. Forward leads into the ship.

>a
It's dangerous out there. I recommend saving the game first...
⇒ Use "save" to save the game, or go "out" again to continue without saving.

>a
You take a step on the hull of the ship, and keep going, and going... Should have turned those mag boots on.
[Oops.]

    *** You float forever in the vastness of space ***

In that game you scored 1 out of a possible 10, in 30 turns.

Your death was completely pointless and preventable. All the same we grudgingly award you one point each for what you did accomplish, which was:
- fixing the aft airlock door

Would you like to RESTART, RESTORE a saved game, QUIT, or UNDO the last command?

>undo
Aft Airlock
[Previous turn undone.]

* * *

>out
Outside the Aft Airlock (vacuum)
You are standing on the hull of the ship, outside the aft airlock, secured by your vac suit's mag boots. Most of the hull is taken up by the protrusions of various machinery, antennae, radio dishes, and heat sinks. There is a clear path to fore among the obstructions. You can also go in to the airlock.

A hook protrudes from the hull next to the airlock door.

Your vac suit pings gently to indicate you have expended a unit of air.

>out
The mag boots keep you firmly attached to the hull.

Your vac suit pings gently to indicate you have expended a unit of air.

>f
Hull of the Usagi (vacuum)
Here the path runs aft to the aft airlock and starboard to the engineering airlock. Your path to starboard is blocked by a piece of debris lodged in the hull. [Whatever happened, this was part of it. It's fortunate it didn't penetrate further into the hull.] It's going to be tough to get over; it doesn't look magnetic, so you're mag boots won't stick to it. You'll need to be careful.

There is a hook set in the hull here.

It looks like you could break off a small piece of debris.

Your vac suit pings gently to indicate you have expended a unit of air.

>s
You attempt to climb over the debris. Just when you think you're over, your foot catches, and you lose your hold. The result: you're floating about a foot from the hull, unable to make contact with your mag boots to pull yourself down. You're barely moving relative to the hull, but you're stuck here. The bright side? You broke down the debris enough that it's no longer a barrier.

[Okay, stay calm. Don't freak out.]

Hull of the Usagi (vacuum, floating)
Here the path runs aft to the aft airlock and starboard to the engineering airlock. Where there used to be a large embedded chunk of debris blocking the path, now there is a scattering of rubble.

There is a hook set in the hull here.

Your vac suit pings gently to indicate you have expended a unit of air.

>vent air
You vent a bit of air from your suit. It propels you just a tiny amount toward the hull, but it's enough. One agonizing minute later, you're attached to the hull again.

[Oh thank god! I thought I was a goner.]

Hull of the Usagi (vacuum)
Here the path runs aft to the aft airlock and starboard to the engineering airlock. Where there used to be a large embedded chunk of debris blocking the path, now there is a scattering of rubble.

There is a hook set in the hull here.

Your vac suit pings gently to indicate you have expended a unit of air.

* * *

>in
Engineering Deck
The engineering crew is responsible for keeping the physical ship operating. They are in charge of every physical aspect of the ship, from the engines to hull integrity to the life support system.

The engineering deck consists of a large console giving a comprehensive view of the physical status of the ship. There is an airlock to starboard. The operations deck continues forward from here, and there are other exits to aft and port.

A device labeled "Suit Recharging Station" is here. It is shaped like a chair with nozzles protruding from either arm.

>hint
Some players may find the temptation to rely on hints overwhelming, and you may prefer to remove temptation by disabling hints for the rest of this game. If you do so, however, you will not be able to access the hints unless you restart. Do you wish to disable hints? >

>no
Engineering Deck
The engineering crew is responsible for keeping the physical ship operating. They are in charge of every physical aspect of the ship, from the engines to hull integrity to the life support system.

The engineering deck consists of a large console giving a comprehensive view of the physical status of the ship. There is an airlock to starboard. The operations deck continues forward from here, and there are other exits to aft and port.

A device labeled "Suit Recharging Station" is here. It is shaped like a chair with nozzles protruding from either arm.

>sit in chair
The nozzles on either side of the chair connect with the suit. After a few moments, the machine emits a pleasant "ping", the nozzles retract, and you stand up.

You hear someone speaking forward of here.

>hint
Engineering Deck
The engineering crew is responsible for keeping the physical ship operating. They are in charge of every physical aspect of the ship, from the engines to hull integrity to the life support system.

The engineering deck consists of a large console giving a comprehensive view of the physical status of the ship. There is an airlock to starboard. The operations deck continues forward from here, and there are other exits to aft and port.

A device labeled "Suit Recharging Station" is here. It is shaped like a chair with nozzles protruding from either arm.

* * *

>in
Engineering Deck
The engineering crew is responsible for keeping the physical ship operating. They are in charge of every physical aspect of the ship, from the engines to hull integrity to the life support system.

The engineering deck consists of a large console giving a comprehensive view of the physical status of the ship. There is an airlock to starboard. The operations deck continues forward from here, and there are other exits to aft and port.

A device labeled "Suit Recharging Station" is here. It is shaped like a chair with nozzles protruding from either arm.

>sit in chair
The nozzles on either side of the chair connect with the suit. After a few moments, the machine emits a pleasant "ping", the nozzles retract, and you stand up.

You hear someone speaking forward of here.

>x console
The engineering console is huge, boasting an incomprehensible array of controls and monitors of the physical state of the ship. You dare not mess with it.

>mess with it
I SAID YOU DARE NOT MESS WITH IT!

You hear someone speaking forward of here.

>x controls
Without a degree in starship engineering, trying to understand these controls is pointless.

>ask computer about engines
I'm unable to give you any information about engines.

You hear someone speaking forward of here.

>ask computer about hull integrity
Despite the recent battering from the destruction of Space Station Omicron-5, hull integrity remains at 90%.

>ask computer about engine
Which do you mean, the JL-758 or Engine status?

>a
(the JL-758)

The JL-758 is a widely-used model of engine stabilizer produced by Luna Spacewerks.

You hear someone speaking forward of here.

>ask computer about engine
Which do you mean, the JL-758 or Engine status?

>status
The SS Usagi employs a Luna Spacewerks Parsec VI. The shipboard engine is currently non-functional. It needs a replacement JL-758 engine stabilizer.

>x electronics
Without a degree in starship engineering, trying to understand these controls is pointless.

You hear someone speaking forward of here.

>x panel
You can't see any such thing.

>x walls
You really don't need to worry about the wall.

>x screen
You can't see any such thing.

>p
Machine Room
The machine room is where the physical work of Engineering takes place; for instance, machining new parts. There is a large counter lined with drawers here, as well as numerous saws, drills, and other pieces of equipment. You can leave to starboard.

There's a hand vac sitting on the counter.

>take all
portable hand-held vacuum cleaner: Taken.

>open drawer
You open the machine room drawers, revealing a small key, a roll of electrical tape, a hex-shaped tool, and a fresh fuse.

* * *

>take all
small key: Taken.
roll of electrical tape: Taken.
hex-shaped tool: Taken.
fresh fuse: Taken.

>i
You are carrying:
  a fresh fuse
  a hex-shaped tool
  a roll of electrical tape
  a small key
  a portable hand-held vacuum cleaner
  a vac suit (being worn)
  a broken sensor
  Bertie the Bear™
  a pair of slippers
  a To-Do list
  a repair corps uniform (being worn) with chewing gum stuck to it
  a toolbox

>s
Engineering Deck
The engineering crew is responsible for keeping the physical ship operating. They are in charge of every physical aspect of the ship, from the engines to hull integrity to the life support system.

The engineering deck consists of a large console giving a comprehensive view of the physical status of the ship. There is an airlock to starboard. The operations deck continues forward from here, and there are other exits to aft and port.

A device labeled "Suit Recharging Station" is here. It is shaped like a chair with nozzles protruding from either arm.

>f
Operations Deck
This is where all of the support activity for the bridge occurs. There are large consoles for environmental controls, communications, and power systems here. The bridge continues forward from here, and engineering is aft. There is a door set in the floor with a ladder leading through it. Set in the frame of the door is a blue button.

A large equipment trunk lies on the midship door, blocking it.

A man's voice comes over comms: "Usagi, are you there?"

[Finally, another person! I'm saved!]

⇒ By the way... you can get help about speaking to other characters by typing "help speech".

>hello
(addressing the caller)
You call out "Yes! I'm here! I'm here! What's going on?"

The caller responds, "Ahoy there, SS Usagi, good to hear from you. Seems like you're a bit out of sorts, and we'd like to help you out. But before we get into that, who am I speaking to? Tell me about yourself."

>tell caller about me
You tell the caller that you're from the repair corps.

"Alright then, Sergeant Screwdriver, I'll fill you in. Space Station Omicron-5 was bombed by separatists from Deneb IV. By some miracle the Usagi was spared the worst of the blast; you were thrown clear of the station. Only problem is now you're hurtling towards New Da Nang, a heavily-populated moon of Deneb II. An impact there would kill not only you but potentially thousands of people more.

 "So we've got some work to do. I'm Master Sergeant R. Mu Arvax. I'm going to try and help you get this ship under control again. First we have to establish, though, what the ship is currently doing. Normally, I'd be able to tap into the ship diagnostics and controls from here on Deneb III, but something seems to have gone wrong. So I'm going to need your help. Are you up to the task?"

[Sergeant Screwdriver, guy thinks he's funny.]

>z
Time passes.

>z
Time passes.

"Yes or no?"

>z
Time passes.

>z
Time passes.

"C'mon, you can do this."
⇒ Master Sergeant R. Mu Arvax wants to know if you're up to the task.

>yes
"Great, great. Now let's get to work.

 "The first thing I need you to do is reboot the system, using the computer. Once you do that, hopefully I'll be able to access ship controls. You'll have to use my access code: say 'compu--"

Master Sergeant R. Mu Arvax's voice breaks up and another voice comes over comms. "SS Usagi, this is Captain Jane Mulgrew, please come in. Repeat, this is Captain Mulgrew of the SS Usagi, Usagi come in."

[Somebody else?]

>z
Time passes.

>z
Time passes.

Captain Mulgrew: "We hear you, Usagi, please respond."

>z
Time passes.

>z
Time passes.

Captain Mulgrew: "Hello, Usagi!"

⇒ Captain Mulgrew is waiting for you to respond.

>hello
(addressing Captain Jane Mulgrew)
Captain Mulgrew responds, "Hello there, Usagi. That's my ship you've got there. Be careful with her.

"We've been listening in and we've heard your communications with Arvax. He had us jammed for a while, but we managed to break through and here we are. Now it's very important that you understand this: Arvax is not your friend. His allegiances lie with Deneb IV, not with the Space Authority. He would like nothing more than to see this ship wipe out a few neighborhoods on New Da Nang.

"So what we need you to do is deny Arvax by shutting down any access to the ship's controls from the outside by invoking the emergency protocols. That will put the ship in a state where we can board and take control of the ship. What do you say? Do you have any questions?"

Master Sergeant R. Mu Arvax's voice comes back over the radio: "You there still, Usagi? I think I lost you for a second."

[Oh no, who should I trust?]

>z
Time passes.

>z
Time passes.

Captain Mulgrew: "Any questions?"

>z
Time passes.

>z
Time passes.

Master Sergeant R. Mu Arvax: ""Hey, friend, we need to reboot the computer soon before it's too late."

>ask mulgrew about ship
(the SS Usagi)
"Finest fighting ship in the system. Proud to captain her."

>ask mulgrew about irion
"I'm afraid I don't have anything to say about that."

>ask mulgrew about mulgrew
"I'm Captain Jane Mulgrew of the SS Usagi. I've been around the Deneb system for a long time, and I know it like the back of my hand. I've dealt with the separatists before, and I've seen enough to know just how cutthroat they are. I won't hesitate to protect the people of the Space Authority from such terrorists."

>ask mulgrew about arvax
"Arvax is a traitor pure and simple. If you haven't yet, consult his file through through the ship computer."

>ask mulgrew about reboot
"Don't be too hasty to reboot the computer. Once that's done, Arvax can get control of the ship and we won't be able to get it back. We need to activate the ship's emergency protocols. The computer will reboot itself if necessary."

>ask mulgrew about emergency protocols
"To prevent Arvax from seizing control of the ship remotely, we need to put the ship in a mode where it ignores all data communications. Voice radio will still be able to get through, but communications with the computer from outside will cease. You'll need to use my access code: say 'computer, access code 3'."

>x arvax about access code
I only understood you as far as wanting to examine Master Sergeant R. Mu Arvax.

>ask arvax about access code
"Just say 'Computer, access code 2'."

>push trunk
You push the trunk clear of the door.

>f
Bridge
This is where the captain, navigator, and pilot all sit. Large viewscreens give a full view of the space around the ship. To port you can see the huge blue-white disk of Deneb. Astern you can faintly see the fading embers of what was Space Station Omicron-5.

 The pilot's and navigator's chairs sit before their respective consoles. The captain's chair, with command console, sits halfway between them and operations further aft.

You hear someone speaking aft of here.

>x console
Which do you mean, the command console, the pilot's console, or the navigator's console?

>command
The command console displays the red outline of a hand.

⇒ You can "touch command console" to touch your palm to it.

>x chair
Which do you mean, the pilot's chair, the navigator's chair, or the captain's chair?

>pilot
An ergonomically-countoured swivel chair designed for hours of stressful work.
[Nice chair.]

You hear someone speaking aft of here.

>x captain's chair
Functional yet comfortable, it is every inch the chair of a commander. On the arm of the captain's chair is the command console, with which the captain commands the shipboard computer.

>a
Operations Deck
This is where all of the support activity for the bridge occurs. There are large consoles for environmental controls, communications, and power systems here. The bridge continues forward from here, and engineering is aft. There is a door set in the floor with a ladder leading through it. Set in the frame of the door is a blue button.

You can see an equipment trunk (closed) here.

Captain Mulgrew: "Any questions?"

>x power systems console
The power systems console controls the power for the entire craft allowing, for instance, for power to be rerouted away from non-essential systems and to more essential systems such as life support or defensive systems.

>f
Bridge
This is where the captain, navigator, and pilot all sit. Large viewscreens give a full view of the space around the ship. To port you can see the huge blue-white disk of Deneb. Astern you can faintly see the fading embers of what was Space Station Omicron-5.

 The pilot's and navigator's chairs sit before their respective consoles. The captain's chair, with command console, sits halfway between them and operations further aft.

You hear someone speaking aft of here.

>a
Operations Deck
This is where all of the support activity for the bridge occurs. There are large consoles for environmental controls, communications, and power systems here. The bridge continues forward from here, and engineering is aft. There is a door set in the floor with a ladder leading through it. Set in the frame of the door is a blue button.

You can see an equipment trunk (closed) here.

>d
(first opening Midship Door)
You can't open that with your bare hands.

Captain Mulgrew: "What'll it be, Usagi?"

>push button
The door slides open.

>d
Galley
This narrow space is barely enough room for two Marines to prepare and eat a meal. There is a counter with a drawer, and two stools, a microwave oven, and a large closet here. Pots and pans hang from hooks in the ceiling. A ladder leads up through the midship door, and you can leave aft.

On the starboard wall is a panel on which is a blue button. Tacked to the panel is the operator's manual for the midship door.

You hear someone speaking above.

>pull plug
You unplug the microwave oven.

>x plug
It's an ordinary grounded plug.

You hear someone speaking above.

>plug in plug
You plug in the microwave oven, but nothing happens .

>unplug it
You unplug the microwave oven.

You hear someone speaking above.

>x socket
It's an ordinary grounded wall socket. Upon close inspection, you notice that it's clogged up with dust.

>vacuum outlet
You vacuum the dust out of the socket.

You hear someone speaking above.

>i
You are carrying:
  a fresh fuse
  a hex-shaped tool
  a roll of electrical tape
  a small key
  a portable hand-held vacuum cleaner
  a vac suit (being worn)
  a broken sensor
  Bertie the Bear™
  a pair of slippers
  a To-Do list
  a repair corps uniform (being worn) with chewing gum stuck to it
  a toolbox

>u
Operations Deck
This is where all of the support activity for the bridge occurs. There are large consoles for environmental controls, communications, and power systems here. The bridge continues forward from here, and engineering is aft. There is a door set in the floor with a ladder leading through it. Set in the frame of the door is a blue button.

You can see an equipment trunk (closed) here.

Master Sergeant R. Mu Arvax: ""Hey, friend, we need to reboot the computer soon before it's too late."

>a
Engineering Deck
The engineering crew is responsible for keeping the physical ship operating. They are in charge of every physical aspect of the ship, from the engines to hull integrity to the life support system.

The engineering deck consists of a large console giving a comprehensive view of the physical status of the ship. There is an airlock to starboard. The operations deck continues forward from here, and there are other exits to aft and port.

A device labeled "Suit Recharging Station" is here. It is shaped like a chair with nozzles protruding from either arm.

>p
Machine Room
The machine room is where the physical work of Engineering takes place; for instance, machining new parts. There is a large counter lined with drawers here, as well as numerous saws, drills, and other pieces of equipment. You can leave to starboard.

>take all
But you don't see anything.

>s
Engineering Deck
The engineering crew is responsible for keeping the physical ship operating. They are in charge of every physical aspect of the ship, from the engines to hull integrity to the life support system.

The engineering deck consists of a large console giving a comprehensive view of the physical status of the ship. There is an airlock to starboard. The operations deck continues forward from here, and there are other exits to aft and port.

A device labeled "Suit Recharging Station" is here. It is shaped like a chair with nozzles protruding from either arm.

>f
Operations Deck
This is where all of the support activity for the bridge occurs. There are large consoles for environmental controls, communications, and power systems here. The bridge continues forward from here, and engineering is aft. There is a door set in the floor with a ladder leading through it. Set in the frame of the door is a blue button.

You can see an equipment trunk (closed) here.

Master Sergeant R. Mu Arvax: ""Hey, friend, we need to reboot the computer soon before it's too late."

>d
Galley
This narrow space is barely enough room for two Marines to prepare and eat a meal. There is a counter with a drawer, and two stools, a microwave oven, and a large closet here. Pots and pans hang from hooks in the ceiling. A ladder leads up through the midship door, and you can leave aft.

On the starboard wall is a panel on which is a blue button. Tacked to the panel is the operator's manual for the midship door.

>vacuum outlet
You vacuum the socket some more, but there's no more dust.

You hear someone speaking above.

>plug in oven
You plug in the microwave oven. It beeps three times and displays "Press Start".

You cross out an item ("fix the microwave") on your to-do list.

[Your score has just gone up by one point.]

>open closet
You open the closet, revealing ten MREs and a microwavable dinner.

You hear someone speaking above.

>take dinner
Taken.

>open oven
You open the microwave oven.

You hear someone speaking above.

>put dinner in oven
You put the microwavable dinner into the microwave oven.

>press start
(first closing the microwave oven)
The oven runs for a minute, beeps twice, and is quiet.

You hear someone speaking above.

>open oven
You open the microwave oven, revealing a cooked dinner.

>take dinner
Taken.

You hear someone speaking above.

>eat it
You eat the cooked dinner. It's as uninspiring as you imagined.

>f
The obvious exits are aft (to junction) and up (to operations deck).

You hear someone speaking above.

>a
Junction
This is a busy place when the ship is populated. To port and starboard are the crew quarters, aft is the closed door to the captain's private quarters, and fore is the galley. A ladder leads down to the staging area.

* * *

>s
Starboard-Side Crew Quarters
All crew members who aren't the captain sleep in this or the opposite-side bunk room. This one sleeps two in a bunk bed, done up with military precision. There is a large cabinet here, stretching almost to the ceiling. It is closed. Mounted in the wall is a crew personal storage unit. The sole exit is to port.

In a shocking lapse of military precision, there is a sticky note attached to the bed post.

You can also see a cardboard box (empty) and some wrapping paper here.

>open cabinet
The door is stuck one-quarter open. You try to open the cabinet the rest of the way, but the door is jammed.

>p
Junction
This is a busy place when the ship is populated. To port and starboard are the crew quarters, aft is the closed door to the captain's private quarters, and fore is the galley. A ladder leads down to the staging area.

* * *

>p
Port-Side Crew Quarters
All crew members who aren't the captain sleep in this or the opposite-side bunk room. This one sleeps two in a bunk bed, done up with military precision. There is a large cabinet here, stretching almost to the ceiling. It is closed. Mounted in the wall is a crew personal storage unit. The sole exit is to starboard.

>open cabinet
You open the port-side equipment cabinet, revealing an engineering uniform.

>x uniform
(the repair corps uniform)
The repair corps uniform is a smart hunter green color, with a patch featuring a hammer and a wrench, crossed. It would look impressive if it weren't for the chewing gum stuck to it.

>x engineering uniform
Colored the traditional mustard yellow of Engineering, it's really a remarkably ugly uniform.

In the engineering uniform is a piece of note paper.

>read paper
Scribbled on the paper is the number 9467.

>type 9467 on keypad
As you press a key, the storage unit starts buzzing continuously. The display lights up with random characters, and you smell the distinct odor of burning wires. The bottom storage drawer pops out a centimeter or two.

You add an item ("fix the storage unit") to your to-do list.

>s
Junction
This is a busy place when the ship is populated. To port and starboard are the crew quarters, aft is the closed door to the captain's private quarters, and fore is the galley. A ladder leads down to the staging area.

* * *

>f
Galley
This narrow space is barely enough room for two Marines to prepare and eat a meal. There is a counter with a drawer, and two stools, a microwave oven, and a large closet here. Pots and pans hang from hooks in the ceiling. A ladder leads up through the midship door, and you can leave aft.

On the starboard wall is a panel on which is a blue button. Tacked to the panel is the operator's manual for the midship door.

You hear someone speaking above.

>open drawer
You open the kitchen drawer, revealing a knife, a fork, and a spoon.

>take knife
Taken.

You hear someone speaking above.

>a
Junction
This is a busy place when the ship is populated. To port and starboard are the crew quarters, aft is the closed door to the captain's private quarters, and fore is the galley. A ladder leads down to the staging area.

>p
Port-Side Crew Quarters
All crew members who aren't the captain sleep in this or the opposite-side bunk room. This one sleeps two in a bunk bed, done up with military precision. There is a large cabinet here, stretching almost to the ceiling. It is open and contains an engineering uniform. Mounted in the wall is a crew personal storage unit. The sole exit is to starboard.

>pry open bottom drawer with knife
You wedge the knife into the seam and lever the drawer open.

The bottom drawer is labeled "Khotpanya". It is open and contains the red access card.

>take card
Taken.

>close drawer
Which do you mean, the top drawer or the bottom drawer?

>top
That's already closed.

I beg your pardon?

>close bottom drawer
You close the bottom drawer.

>undo
Port-Side Crew Quarters
[Previous turn undone.]

>x display
The display is blank.

>open keypad with key
You open the front panel of the keypad, revealing a bundle of wiring. You can see the problem immediately -- two wires with worn insulation are in contact, causing a short-circuit.

>i
You are carrying:
  the red access card
  a knife
  a fresh fuse
  a hex-shaped tool
  a roll of electrical tape
  a small key
  a portable hand-held vacuum cleaner
  a vac suit (being worn)
  a broken sensor
  Bertie the Bear™
  a pair of slippers
  a To-Do list
  a repair corps uniform (being worn) with chewing gum stuck to it
  a toolbox

>s
Junction
This is a busy place when the ship is populated. To port and starboard are the crew quarters, aft is the closed door to the captain's private quarters, and fore is the galley. A ladder leads down to the staging area.

>a
The door stays shut as you try to go through it.
[Almost bumped my head.]

>f
Galley
This narrow space is barely enough room for two Marines to prepare and eat a meal. There is a counter with a drawer, and two stools, a microwave oven, and a large closet here. Pots and pans hang from hooks in the ceiling. A ladder leads up through the midship door, and you can leave aft.

On the starboard wall is a panel on which is a blue button. Tacked to the panel is the operator's manual for the midship door.

>u
Operations Deck
This is where all of the support activity for the bridge occurs. There are large consoles for environmental controls, communications, and power systems here. The bridge continues forward from here, and engineering is aft. There is a door set in the floor with a ladder leading through it. Set in the frame of the door is a blue button.

You can see an equipment trunk (closed) here.

Captain Mulgrew: "Did I lose you, Usagi?"

>a
Engineering Deck
The engineering crew is responsible for keeping the physical ship operating. They are in charge of every physical aspect of the ship, from the engines to hull integrity to the life support system.

The engineering deck consists of a large console giving a comprehensive view of the physical status of the ship. There is an airlock to starboard. The operations deck continues forward from here, and there are other exits to aft and port.

A device labeled "Suit Recharging Station" is here. It is shaped like a chair with nozzles protruding from either arm.

* * *

>p
Machine Room
The machine room is where the physical work of Engineering takes place; for instance, machining new parts. There is a large counter lined with drawers here, as well as numerous saws, drills, and other pieces of equipment. You can leave to starboard.

>open drawer
That's already open.

>take all
But you don't see anything.

>f
The only obvious exit is starboard (to engineering deck).

>s
Engineering Deck
The engineering crew is responsible for keeping the physical ship operating. They are in charge of every physical aspect of the ship, from the engines to hull integrity to the life support system.

The engineering deck consists of a large console giving a comprehensive view of the physical status of the ship. There is an airlock to starboard. The operations deck continues forward from here, and there are other exits to aft and port.

A device labeled "Suit Recharging Station" is here. It is shaped like a chair with nozzles protruding from either arm.

>d
The obvious exits are fore (to operations deck), aft, port (to machine room), starboard (to engineering airlock) and outside (to engineering airlock).

You hear someone speaking forward of here.

>f
Operations Deck
This is where all of the support activity for the bridge occurs. There are large consoles for environmental controls, communications, and power systems here. The bridge continues forward from here, and engineering is aft. There is a door set in the floor with a ladder leading through it. Set in the frame of the door is a blue button.

You can see an equipment trunk (closed) here.

>d
Galley
This narrow space is barely enough room for two Marines to prepare and eat a meal. There is a counter with a drawer, and two stools, a microwave oven, and a large closet here. Pots and pans hang from hooks in the ceiling. A ladder leads up through the midship door, and you can leave aft.

On the starboard wall is a panel on which is a blue button. Tacked to the panel is the operator's manual for the midship door.

You hear someone speaking above.

* * *

>p
Port-Side Crew Quarters
All crew members who aren't the captain sleep in this or the opposite-side bunk room. This one sleeps two in a bunk bed, done up with military precision. There is a large cabinet here, stretching almost to the ceiling. It is open and contains an engineering uniform. Mounted in the wall is a crew personal storage unit. The sole exit is to starboard.

>open keypad with key
That's unlocked at the moment.

>wrap wires
What do you want to wrap the wires around?

>wrap wires with tape
You wrap the wires in electrical tape and close the keypad.

You cross out an item ("fix the storage unit") on your to-do list.

[Your score has just gone up by one point.]

>press 9467 on keypad
The display flashes "Close Drawer".

>x unit
The storage unit consists of top and bottom drawers, with an attached keypad and display. There is a keyhole under the keypad. The top drawer is closed, but the bottom drawer is open and empty.

>x planetfall
You can't see any such thing.

>x keypad
A standard 0-9 keypad with a "*" and "#". Below the keys is a small keyhole.

>x display
The display says "Close Drawer".

>close drawer
Which do you mean, the top drawer or the bottom drawer?

* * *

>bottom
You close the bottom drawer.

>press 9467 on keypad
The top drawer slides open, revealing a copy of Planetfall.

>x unit
The storage unit consists of top and bottom drawers, with an attached keypad and display. There is a keyhole under the keypad. The top drawer is open and contains a copy of Planetfall, but the bottom drawer is closed.

>x top drawer
The top drawer is labeled "Franck". It is open and contains a copy of Planetfall.

In the top drawer is a copy of Planetfall.

>put all in top drawer
red access card: Done.
knife: Done.
fresh fuse: Done.
hex-shaped tool: Done.
roll of electrical tape: Done.
small key: Done.
portable hand-held vacuum cleaner: Done.
broken sensor: Done.
Bertie the Bear™: Done.
pair of slippers: Done.
To-Do list: You need that to write on.

toolbox: [No. That's my life right there.]

>i
You are carrying:
  a vac suit (being worn)
  a To-Do list
  a repair corps uniform (being worn) with chewing gum stuck to it
  a toolbox

>x unit
The storage unit consists of top and bottom drawers, with an attached keypad and display. There is a keyhole under the keypad. The top drawer is open and contains a pair of slippers, Bertie the Bear™, a broken sensor, a portable hand-held vacuum cleaner, a small key, a roll of electrical tape, a hex-shaped tool, a fresh fuse, a knife, the red access card, and a copy of Planetfall, but the bottom drawer is closed.

>take all from unit
That can't contain things.

>take all from bottom drawer
The bottom drawer isn't open.

>take all from top drawer
pair of slippers: Taken.
Bertie the Bear™: Taken.
broken sensor: Taken.
portable hand-held vacuum cleaner: Taken.
small key: Taken.
roll of electrical tape: Taken.
hex-shaped tool: Taken.
fresh fuse: Taken.
knife: Taken.
red access card: Taken.
copy of Planetfall: Taken.

>s
Junction
This is a busy place when the ship is populated. To port and starboard are the crew quarters, aft is the closed door to the captain's private quarters, and fore is the galley. A ladder leads down to the staging area.

>open door with card
You slide the red access card through the slot. Nothing happens.
[That's weird. It should at least make a buzz.]

You add an item ("fix the captain's door") to your to-do list.

>open panel
You open the panel, hanging on to the blue screw that held it shut.

The access panel opens to reveal a row of fuses, one of which is blown.

>take blown fuse
Taken.

>put fresh fuse in panel
You put the fresh fuse into the access panel.

>close panel
When you try to close the access panel, the blue screw slips from your grasp, bounces once, rolls, and falls down the ladder well. At the bottom of the ladder, it bounces once more, right through the grill of an air scrubber intake. That screw's long gone.

>open door with card
The door won't function until the panel is closed.
[Who designed this thing?]

>x panel
The access panel is set in the bulkhead to the left of the door. It is open, leaving an empty hole where the screw was.

The panel holds a row of fresh fuses.

>x hole
The little hole you put the screw in.

>put gum in screw
You can't see any such thing.

>put gum in hole
You push the gum into the hole.
[I hope this works.]

>close panel
You drive a screw into the gum and it holds. The panel is now closed.

You hear a series of beeps, and a voice says "Door now operational."

You cross out an item ("fix the captain's door") on your to-do list.

[Your score has just gone up by one point.]

>open door with card
You slide the red access card through the slot. The Captain's Door slides smoothly open. A pleasant ping indicates it now recognizes you as authorized.

>a
The Captain's Door closes silently behind you.

Captain's Quarters
Neat and spartan, this cabin is the very model of a small fighting ship's captain's quarters. An impeccably organized desk is against one wall, while a typically spotless bed sits beneath a portrait of this very ship. You can exit to fore.

>l
Captain's Quarters
Neat and spartan, this cabin is the very model of a small fighting ship's captain's quarters. An impeccably organized desk is against one wall, while a typically spotless bed sits beneath a portrait of this very ship. You can exit to fore.

>f
The Captain's Door opens as you approach, and closes silently behind you.

Junction
This is a busy place when the ship is populated. To port and starboard are the crew quarters, aft is the closed door to the captain's private quarters, and fore is the galley. A ladder leads down to the staging area.

>a
The Captain's Door opens as you approach, and closes silently behind you.

Captain's Quarters
Neat and spartan, this cabin is the very model of a small fighting ship's captain's quarters. An impeccably organized desk is against one wall, while a typically spotless bed sits beneath a portrait of this very ship. You can exit to fore.

>x desk
(the captain's desk)
The Captain's desk is a simple institutional metal desk with a single drawer,  which is closed. On the desk are two framed photos, one of a dog, who by his tag must be named "Pluto", and another of an astronaut planting a flag on Earth's moon.

>x drawer
The Captain's desk is a simple institutional metal desk with a single drawer,  which is closed. On the desk are two framed photos, one of a dog, who by his tag must be named "Pluto", and another of an astronaut planting a flag on Earth's moon.

>open drawer
You open the desk drawer, revealing the captain's journal.

* * *

>take journal
Taken.

>x it
The captain's journal is an electronic diary which requires a password to open.
⇒ For example, say "journal, password walrus" to unlock the journal with the password "walrus".

>x photos
You can't see any such thing.

>x dog
Pluto is a beagle with a wise, knowing look on his face.
[Cute dog.]

>x dog
Pluto is a beagle with a wise, knowing look on his face.

>x moon
The iconic photo of Neil Armstrong standing next to the American flag.

>x astronaut
The iconic photo of Neil Armstrong standing next to the American flag.

>x list
You have the following items on your to-do list: fix the cabinet. You have finished the following: fix the airlock door, fix the microwave, fix the storage unit, and fix the captain's door.

>journal, hello
You can't ask a journal to do just anything.

>journal, give me the card
(the captain's journal first taking the red access card)
You can't ask a journal to do just anything.

>i
You are carrying:
  the captain's journal
  a blown fuse
  a copy of Planetfall
  the red access card
  a knife
  a hex-shaped tool
  a roll of electrical tape
  a small key
  a portable hand-held vacuum cleaner
  a broken sensor
  Bertie the Bear™
  a pair of slippers
  a vac suit (being worn)
  a To-Do list
  a repair corps uniform (being worn) with chewing gum stuck to it
  a toolbox

>journal, password alksjdfasd
The journal beeps once to indicate an invalid login.

>journal, charon
The journal isn't actually a sentient being listening to you. It only accepts a voice login.

>journal, asdf
The journal isn't actually a sentient being listening to you. It only accepts a voice login.

>journal, charon
The journal isn't actually a sentient being listening to you. It only accepts a voice login.

>ask journal about alkjsdf
Talking to the captain's journal is unlikely to prove rewarding.

>ask journal about card
Talking to the captain's journal is unlikely to prove rewarding.

>journal, password charon
The journal chimes pleasantly and the screen fills with text.

>read it
[I never thought it would come to this, eavesdropping on someone's personal thoughts.]

You page through the journal, skimming over the boring parts detailing the running of the ship. Eventually you come across something more interesting:

"I screwed up last night. I let them spend the night and I think someone noticed. If this got out my career would be over."

A few pages later:

"I'm being blackmailed. I don't know who, but someone messaged me telling me all they know. They know a lot. They made it clear they expect my 'cooperation'."

Numerous later passages detail this cooperation, ranging from simple intelligence gathering to actively working to harm the Space Authority.

[My god...]

>f
The Captain's Door opens as you approach, and closes silently behind you.

Junction
This is a busy place when the ship is populated. To port and starboard are the crew quarters, aft is the closed door to the captain's private quarters, and fore is the galley. A ladder leads down to the staging area.

* * *

>replace screw
You unscrew the old screw and replace it with a new one.

You cross out an item ("fix the cabinet") on your to-do list.

[Your score has just gone up by one point.]

>get down
You get off the top bunk.

Starboard-Side Crew Quarters
All crew members who aren't the captain sleep in this or the opposite-side bunk room. This one sleeps two in a bunk bed, done up with military precision. There is a large cabinet here, stretching almost to the ceiling. It is closed. Mounted in the wall is a crew personal storage unit. The sole exit is to port.

In a shocking lapse of military precision, there is a sticky note attached to the bed post.

You can also see a cardboard box (empty) and some wrapping paper here.

>open door
You open the starboard-side equipment cabinet, revealing a beacon.

>take beacon
Taken.

>read list
You have finished the following: fix the airlock door, fix the microwave, fix the storage unit, fix the captain's door, and fix the cabinet.

>s
The only obvious exit is port (to junction).

>p
Junction
This is a busy place when the ship is populated. To port and starboard are the crew quarters, aft is the closed door to the captain's private quarters, and fore is the galley. A ladder leads down to the staging area.

>d
Staging Area
This is the staging area of the ship, where marines prepare for missions. It is adjacent to the aft airlock. Locked compartments set into the walls hold various munitions. A ladder leads up into the rest of the ship. 

An equipment locker is sprawled across the room, with its door to the ground.
 
Through the airlock windows you see the blank space left by the destruction of Space Station Omicron-5.

What looks like part of an engine is stowed in a corner.

There is an air scrubber intake in the wall here.

You can also see a black trunk (closed) here.

>u
Junction
This is a busy place when the ship is populated. To port and starboard are the crew quarters, aft is the closed door to the captain's private quarters, and fore is the galley. A ladder leads down to the staging area.

>f
Galley
This narrow space is barely enough room for two Marines to prepare and eat a meal. There is a counter with a drawer, and two stools, a microwave oven, and a large closet here. Pots and pans hang from hooks in the ceiling. A ladder leads up through the midship door, and you can leave aft.

On the starboard wall is a panel on which is a blue button. Tacked to the panel is the operator's manual for the midship door.

>u
Operations Deck
This is where all of the support activity for the bridge occurs. There are large consoles for environmental controls, communications, and power systems here. The bridge continues forward from here, and engineering is aft. There is a door set in the floor with a ladder leading through it. Set in the frame of the door is a blue button.

You can see an equipment trunk (closed) here.

Captain Mulgrew: "What'll it be, Usagi?"

>x environmental
The environmental console contains the controls that deal with the comfort of the occupants, including temperature, pressure, and gravity. The gravity dial can be set from 1 to 10. It is set to 5.

>set gravity dial to 1
You dial the gravity to 1.

Master Sergeant R. Mu Arvax: ""Hey, friend, we need to reboot the computer soon before it's too late."

>d
Galley
This narrow space is barely enough room for two Marines to prepare and eat a meal. There is a counter with a drawer, and two stools, a microwave oven, and a large closet here. Pots and pans hang from hooks in the ceiling. A ladder leads up through the midship door, and you can leave aft.

On the starboard wall is a panel on which is a blue button. Tacked to the panel is the operator's manual for the midship door.

>a
Junction
This is a busy place when the ship is populated. To port and starboard are the crew quarters, aft is the closed door to the captain's private quarters, and fore is the galley. A ladder leads down to the staging area.

* * *

>d
Staging Area
This is the staging area of the ship, where marines prepare for missions. It is adjacent to the aft airlock. Locked compartments set into the walls hold various munitions. A ladder leads up into the rest of the ship. 

An equipment locker is sprawled across the room, with its door to the ground.
 
Through the airlock windows you see the blank space left by the destruction of Space Station Omicron-5.

What looks like part of an engine is stowed in a corner.

There is an air scrubber intake in the wall here.

You can also see a black trunk (closed) here.

>turn over locker
You turn over the locker. Now it's door-side-up.

>open it
You open the locker.

You search through the contents of the locker. It's mostly broken vac suits, but you discover something interesting: a tether, used for securing people or objects during extravehicular activity.

>a
Aft Airlock
You are in the aft airlock. Outside is the blackness of space, speckled with the dying embers of what was once Space Station Omicron-5. Forward leads into the ship.

>a
Outside the Aft Airlock (vacuum)
You are standing on the hull of the ship, outside the aft airlock, secured by your vac suit's mag boots. Most of the hull is taken up by the protrusions of various machinery, antennae, radio dishes, and heat sinks. There is a clear path to fore among the obstructions. You can also go in to the airlock.

A hook protrudes from the hull next to the airlock door.

Your vac suit pings gently to indicate you have expended a unit of air.

>tie tether to hook
You attach the tether to the hook.
[One...]

Your vac suit pings gently to indicate you have expended a unit of air.

>x hook
A post extends from the hull here, with a heavyweight snap hook on the end. The tether is attached to the hook.

Your vac suit pings gently to indicate you have expended a unit of air.

>l
Outside the Aft Airlock (vacuum)
You are standing on the hull of the ship, outside the aft airlock, secured by your vac suit's mag boots. Most of the hull is taken up by the protrusions of various machinery, antennae, radio dishes, and heat sinks. There is a clear path to fore among the obstructions. You can also go in to the airlock.

A hook protrudes from the hull next to the airlock door.

The tether is attached to the hook. You hold the other end in a loose coil.

Your vac suit pings gently to indicate you have expended a unit of air.

>f
Hull of the Usagi (vacuum)
Here the path runs aft to the aft airlock and starboard to the engineering airlock. Where there used to be a large embedded chunk of debris blocking the path, now there is a scattering of rubble.

There is a hook set in the hull here.

You are holding one end of the tether, which runs aft from here.

Your vac suit pings gently to indicate you have expended a unit of air.

>attach hook to tether
You attach the tether to the hook.
[Two...]

Your vac suit pings gently to indicate you have expended a unit of air.

>attach tether to hook
The tether is already attached to the hook.

Your vac suit pings gently to indicate you have expended a unit of air.

* * *

>attach tether to hook
You make the final attachment, letting go of the tether.
[Three! That was a bit of work. Hope it's useful.]

Your vac suit pings gently to indicate you have expended a unit of air.

>out
The mag boots keep you firmly attached to the hull.

Your vac suit pings gently to indicate you have expended a unit of air.

* * *

>turn off boots
You switch the Magnetic boots off.

Your vac suit pings gently to indicate you have expended a unit of air.

>out
You propel yourself away from the ship. Some hours later a ship, following your beacon, finds you and rescues you. By that time, however, the SS Usagi has slammed into New Da Nang, killing thousands. You can't help but think you might have saved them if you had stayed on the ship.

    *** You have saved yourself in a disgraceful act of cowardice. ***

In that game you scored 0 out of a possible 10, in 236 turns.

You get nothing! You lose! Good day, sir!

Would you like to RESTART, RESTORE a saved game, QUIT, or UNDO the last command?

>undo
Outside the Engineering Airlock (vacuum)
[Previous turn undone.]

>x boots
Big boots with a thick sole. Lights indicate these boots are currently on.

Your vac suit pings gently to indicate you have expended a unit of air.

>p
Hull of the Usagi (vacuum)
Here the path runs aft to the aft airlock and starboard to the engineering airlock. Where there used to be a large embedded chunk of debris blocking the path, now there is a scattering of rubble.

There is a hook set in the hull here.

The tether is attached to the hook, and extends aft and starboard from here.

Your vac suit pings gently to indicate you have expended a unit of air.

* * *

>a
Outside the Aft Airlock (vacuum)
You are standing on the hull of the ship, outside the aft airlock, secured by your vac suit's mag boots. Most of the hull is taken up by the protrusions of various machinery, antennae, radio dishes, and heat sinks. There is a clear path to fore among the obstructions. You can also go in to the airlock.

A hook protrudes from the hull next to the airlock door.

The tether is attached to the hook, and from there runs forward.

Your vac suit pings gently to indicate you have expended a unit of air.

>in
Aft Airlock
You are in the aft airlock. Outside is the blackness of space, speckled with the dying embers of what was once Space Station Omicron-5. Forward leads into the ship.

>f
Staging Area
This is the staging area of the ship, where marines prepare for missions. It is adjacent to the aft airlock. Locked compartments set into the walls hold various munitions. A ladder leads up into the rest of the ship. 

An equipment locker is sprawled across the room. It has been turned door-side up. It is open and contains four banged-up vac suits.
 
Through the airlock windows you see the blank space left by the destruction of Space Station Omicron-5.

What looks like part of an engine is stowed in a corner.

There is an air scrubber intake in the wall here.

You can also see a black trunk (closed) here.

>push engine a
You push the JL-758 to Aft Airlock.

Aft Airlock
You are in the aft airlock. Outside is the blackness of space, speckled with the dying embers of what was once Space Station Omicron-5. Forward leads into the ship.

You can see a JL-758 here.

>push engine a
You clip the JL-758 to the tether.

You push the JL-758 to Outside the Aft Airlock (vacuum).

Outside the Aft Airlock (vacuum)
You are standing on the hull of the ship, outside the aft airlock, secured by your vac suit's mag boots. Most of the hull is taken up by the protrusions of various machinery, antennae, radio dishes, and heat sinks. There is a clear path to fore among the obstructions. You can also go in to the airlock.

A hook protrudes from the hull next to the airlock door.

The JL-758 is floating here, clipped to the tether.

The tether is attached to the hook, and from there runs forward.

Your vac suit pings gently to indicate you have expended a unit of air.

>push it f
You push the JL-758 to Hull of the Usagi (vacuum).

Hull of the Usagi (vacuum)
Here the path runs aft to the aft airlock and starboard to the engineering airlock. Where there used to be a large embedded chunk of debris blocking the path, now there is a scattering of rubble.

There is a hook set in the hull here.

The JL-758 is floating here, clipped to the tether.

The tether is attached to the hook, and extends aft and starboard from here.

Your vac suit pings gently to indicate you have expended a unit of air.

>push it s
You push the JL-758 to Outside the Engineering Airlock (vacuum).

Outside the Engineering Airlock (vacuum)
You are standing on the hull of the ship, outside the engineering airlock, secured by your vac suit's mag boots. Most of the hull is taken up by the protrusions of various machinery, antennae, radio dishes, and heat sinks. There is a clear path to port among the obstructions. You can also go in to the airlock.

A hook protrudes from the hull next to the airlock door.

The JL-758 is floating here, clipped to the tether.

The tether is attached to the hook, and from there runs to port.

Your vac suit pings gently to indicate you have expended a unit of air.

>push it in
You unclip the JL-758 from the tether.

You push the JL-758 to Engineering Airlock.

Engineering Airlock
You are in the engineering airlock. Outside, the space to starboard looks so empty and peaceful it's hard to imagine the awful sight astern.

You can see a JL-758 here.

>push it in
You push the JL-758 to Engineering Deck.

Engineering Deck
The engineering crew is responsible for keeping the physical ship operating. They are in charge of every physical aspect of the ship, from the engines to hull integrity to the life support system.

The engineering deck consists of a large console giving a comprehensive view of the physical status of the ship. There is an airlock to starboard. The operations deck continues forward from here, and there are other exits to aft and port.

A device labeled "Suit Recharging Station" is here. It is shaped like a chair with nozzles protruding from either arm.

You can also see a JL-758 here.

>push it aft
The suit recharging station cannot be pushed from place to place.

You hear someone speaking forward of here.

>put engine aft
You can't see any such thing.

>push engine aft
You push the JL-758 to Engine Room.

You slide the old part out from the engine, and slide the new JL-758 in its place.

Engine Room
This where the combustion process is controlled. The aft wall is dominated by the operating panel of the fusion engine. Monitoring electronics and controls cover the other two walls. A doorway opens forward to the Engineering Deck.

There is a large screen on the forward wall. It displays nothing right now. There is a large button below the diagram labeled "Test".

You can see a broken JL-758 here.

It seems you completed something ("fix the engine") that wasn't on your to-do list. You note it down.

[Your score has just gone up by one point.]

>x diagram
The diagram screen is black.

>computer, reboot
Authorization required.

>computer, access code 3
Welcome, Captain Jane Mulgrew. Logging you in.

>computer, access code 2
Welcome, Master Sergeant R. Mu Arvax. Logging you in.

>computer, reboot
Beginning reboot. Take all appropriate precautions.

Red alert lights flash throughout the ship.

>x diagram
The diagram screen is black.

>z
Time passes.

>l
Engine Room
This where the combustion process is controlled. The aft wall is dominated by the operating panel of the fusion engine. Monitoring electronics and controls cover the other two walls. A doorway opens forward to the Engineering Deck.

There is a large screen on the forward wall. It displays nothing right now. There is a large button below the diagram labeled "Test".

You can see a broken JL-758 here.

Reboot complete.

>l
Engine Room
This where the combustion process is controlled. The aft wall is dominated by the operating panel of the fusion engine. Monitoring electronics and controls cover the other two walls. A doorway opens forward to the Engineering Deck.

There is a large diagram of the fuel injection process on the forward wall. There is a large button below the diagram labeled "Test".

You can see a broken JL-758 here.

>x diagram
This is a diagram of the fuel injection process for the fusion engine. Printed above it is the label "Delphi Engine Controls Aleph-Null". Below that is a representation of the various inputs and the products created during the fuel injection process. Each input has a touch-sensitive surface which can be used to alter the diagram's settings.

       Input: 2 --  3 --  4 --
                ||    ||    ||
             ===vv====vv====vv===
Input 1:     -- >> -- >> -- >> --  Output
             ====================

        FUEL INJECTION SPECIFICATION INCOMPLETE

Key:    --   empty input or output
        AH   Anti-Helium
        LC   Liquid Copernicium*
        Og   Oganesson
        RM   Red Matter            
        TC   Tachyon Crystals
        Un   Unobtainium
        VM   Void Matter*

        * this substance can only be produced, not input.

⇒ Use "substance > input" to set each input. For instance, "Un > 3" sets input 3 to Unobtainium. You may also use "set <input> to <substance>" for the same effect. Use "disconnect <input>" to disconnect an input.

>accessible on
Accessibility on.

>l
Engine Room
This where the combustion process is controlled. The aft wall is dominated by the operating panel of the fusion engine. Monitoring electronics and controls cover the other two walls. A doorway opens forward to the Engineering Deck.

There is a large diagram of the fuel injection process on the forward wall. There is a large button below the diagram labeled "Test".

You can see a broken JL-758 here.

>x diagram
This is a diagram of the fuel injection process for the fusion engine. Printed above it is the label "Delphi Engine Controls Aleph-Null". Below that is a representation of the various inputs and the products created during the fuel injection process. Each input has a touch-sensitive surface which can be used to alter the diagram's settings.

Input 1 is unset. Neither is Input 2 set. Input 3 isn't set. Input 4 isn't set.
The possible inputs are Anti-Helium, Oganesson, Red Matter, Tachyon Crystals, and Unobtainium. There are two additional possible outputs: Liquid Copernicium and Void Matter.

>ask computer about aleph-null
The Aleph-Null, by Delphi Engine Controls LLC, is a starship engine fuel injection process controller. It allows the mixture of up to five fuel components to create an energized product suitable for powering a starship drive. The Aleph-Null works by the method of substance injection.

>ask computer about engine
Which do you mean, the JL-758, Delphi Engine Controls Aleph-Null, Delphi Engine Controls LLC, Engine status, the engine diagram, or the fusion engine?

>the fusion engine
The SS Usagi employs a Luna Spacewerks Parsec VI. The shipboard engine is functioning normally.

>ask computer about drive
Which do you mean, Luna Spacewerks Parsec VI or Engine status?

>ask computer about ship
(the SS Usagi)

The SS Usagi is a light frigate in the Deneb system, with a crew of five including the captain. It is currently helmed by Captain Jane Mulgrew. The ship's main drive is a Luna Spacewerks Parsec VI.

>ask computer about drive
Which do you mean, Luna Spacewerks Parsec VI or Engine status?

>engine status
The SS Usagi employs a Luna Spacewerks Parsec VI. The shipboard engine is functioning normally.

>ask computer about luna
Which do you mean, Luna Spacewerks Parsec VI or the moon?

>ask computer about luna spacewerks
The Luna Spacewerks Parsec VI is a starship engine used mainly by the Space Authority to drive light frigate class vessels. It is powered by Liquid Copernicium.

>ask computer about liquid copernicium
Liquid Copernicium is the liquid form of the element Copernicium. It is a common starship fuel. It can be created by injecting Oganesson into Red Matter.

>set input 4 to oganesson
This is a diagram of the fuel injection process for the fusion engine. Printed above it is the label "Delphi Engine Controls Aleph-Null". Below that is a representation of the various inputs and the products created during the fuel injection process. Each input has a touch-sensitive surface which can be used to alter the diagram's settings.

Input 1 is unset. Neither is Input 2 set. Input 3 isn't set. Input 4 is Oganesson.
The possible inputs are Anti-Helium, Oganesson, Red Matter, Tachyon Crystals, and Unobtainium. There are two additional possible outputs: Liquid Copernicium and Void Matter.

>ask computer about red matter
Red Matter is an unstable, possibly impossible substance created by injecting Tachyon Crystals into Unobtainium.

>set input 3 to tachyon crystals
This is a diagram of the fuel injection process for the fusion engine. Printed above it is the label "Delphi Engine Controls Aleph-Null". Below that is a representation of the various inputs and the products created during the fuel injection process. Each input has a touch-sensitive surface which can be used to alter the diagram's settings.

Input 1 is unset. Neither is Input 2 set. Input 3 is Tachyon Crystals. Input 4 is Oganesson.
The possible inputs are Anti-Helium, Oganesson, Red Matter, Tachyon Crystals, and Unobtainium. There are two additional possible outputs: Liquid Copernicium and Void Matter.

>ask computer about unobtainium
Unobtanium can only be acquired by the injection of Anti-Helium into Oganesson, hence its legendary reputation for being difficult to obtain.

>set input 2 to anti-helium
This is a diagram of the fuel injection process for the fusion engine. Printed above it is the label "Delphi Engine Controls Aleph-Null". Below that is a representation of the various inputs and the products created during the fuel injection process. Each input has a touch-sensitive surface which can be used to alter the diagram's settings.

Input 1 is unset. Input 2 is Anti-Helium. Input 3 is Tachyon Crystals. Input 4 is Oganesson.
The possible inputs are Anti-Helium, Oganesson, Red Matter, Tachyon Crystals, and Unobtainium. There are two additional possible outputs: Liquid Copernicium and Void Matter.

>set input 1 to oganesson
This is a diagram of the fuel injection process for the fusion engine. Printed above it is the label "Delphi Engine Controls Aleph-Null". Below that is a representation of the various inputs and the products created during the fuel injection process. Each input has a touch-sensitive surface which can be used to alter the diagram's settings.

Input 1 is Oganesson. Input 2 is Anti-Helium, which is injected into the first input, producing Unobtainium. Input 3 is Tachyon Crystals, which is injected into the Unobtainium, producing Red Matter. Input 3 is Oganesson, which is injected into the Red Matter, producing Liquid Copernicium. The final product of the injection process is Liquid Copernicium.
The possible inputs are Anti-Helium, Oganesson, Red Matter, Tachyon Crystals, and Unobtainium. There are two additional possible outputs: Liquid Copernicium and Void Matter.

It seems you completed something ("adjust fuel injection specification") that wasn't on your to-do list. You note it down.

[Your score has just gone up by one point.]

>f
Engineering Deck
The engineering crew is responsible for keeping the physical ship operating. They are in charge of every physical aspect of the ship, from the engines to hull integrity to the life support system.

The engineering deck consists of a large console giving a comprehensive view of the physical status of the ship. There is an airlock to starboard. The operations deck continues forward from here, and there are other exits to aft and port.

A device labeled "Suit Recharging Station" is here. It is shaped like a chair with nozzles protruding from either arm.

You hear someone speaking forward of here.

* * *

>f
Operations Deck
This is where all of the support activity for the bridge occurs. There are large consoles for environmental controls, communications, and power systems here. The bridge continues forward from here, and engineering is aft. There is a door set in the floor with a ladder leading through it. Set in the frame of the door is a blue button.

You can see an equipment trunk (closed) here.

>talke
I'm not sure what you're trying to say. I might just not recognize the words you're using.

>talk
What do you want to talk about?

>hello
(addressing Master Sergeant R. Mu Arvax)
"You're back! Great job rebooting the computer -- I'm getting telemetry now.

>ask arvax about computer
"Invaluable resource. Take advantage of it."

>ask arvax about ship
(the SS Usagi)
"Looks like the ship is ready to fly! Quick! Get to the bridge and use the command console! Say 'computer, execute'"
You think, "Not much time!"
"Impact in 9."

>accessible off
Accessibility off.

>unfo
I'm not sure what you're trying to say. I might just not recognize the words you're using.

>undo
Operations Deck
[Previous turn undone.]

>accessible off
Accessibility off.

>ask arvax about ship
(the SS Usagi)
"Looks like the ship is ready to fly! Quick! Get to the bridge and use the command console! Say 'computer, execute'"
[Not much time!]

"Impact in 9."

>f
Bridge
This is where the captain, navigator, and pilot all sit. Large viewscreens give a full view of the space around the ship. To port you can see the huge blue-white disk of Deneb. Ahead, the moon New Da Nang looms steadily larger and larger before you.

 The pilot's and navigator's chairs sit before their respective consoles. The captain's chair, with command console, sits halfway between them and operations further aft.

"Impact in 8."

The moon of New Da Nang looms ever larger on the forward viewscreen.

>touch command console
Welcome, Captain. What are your orders?
"Impact in 7."

The moon of New Da Nang looms ever larger on the forward viewscreen.

>computer, execute
Yes, Captain. Executing evasive maneuvers.

The ship pulls out of its dive toward New Da Nang, delivering a g-force that forces the breath out of you despite the intertial dampers. Soon you are turned around and headed for open space.

Diverting communications to the bridge.

Arvax comes over comms: "Diverting SS Usagi to Deneb III. Rendezvous with retrieval crew in approximately twenty-eight minutes.

"Sergeant Screwdriver, this couldn't have happened without you. You deserve to be a hero on New Da Nang, but unfortunately we need to keep this incident secret, as will no doubt be emphasized at your debriefing.

"You are to be especially commended for your judgment in determining the correct course of action when presented with a difficult choice. We have determined that Captain Mulgrew has been working with the separatists and was involved in the Omicron-5 bombing. She has been apprehended and will face the most severe justice permitted by the Space Authority.

"Now, soldier, time to relax. The crew will be there soon to pick you up."

You relax in the captain's chair and reflect on your accomplishment. When you get to the Deneb III space platform, you are whisked off for a series of debriefings and meetings.

At the end of the day, you can barely sleep, as the newest member of the 95th Mechanical Division Special Maintenance Force. Adventure at last!

    *** You have saved New Da Nang, the SS Usagi, and yourself! ***

In that game you scored 10 out of a possible 10, in 281 turns.

For your heroism in the face of almost certain death, we award you one point each for:
- fixing the aft airlock door
- fixing the microwave oven
- fixing the storage unit in the port-side crew quarters
- fixing the captain's door
- fixing the equipment cabinet in the starboard-side crew quarters
- fixing the fusion engine
- adjusting the fuel injection specification correctly

Additionally! We hereby award you one point for saving the SS Usagi, another point for saving yourself, and finally one more point for saving the moon New Da Nang! Congratulations!

Would you like to RESTART, RESTORE a saved game, QUIT, or UNDO the last command?

* * *

>rules
Rules tracing now switched on. Type "rules off" to switch it off again, or "rules all" to include even rules which do not apply.

[Rule "reset report text rule" applies.]

* * *

Crash
An Interactive Disaster by Phil Riley
Release 5 / Serial number 220724 / Inform 7 build 6M62 (I6/v6.34 lib 6/12N) SD

Space Station Gangway
This is the pressurized bridge from Space Station Omicron-5 to the SS Usagi. Behind you is the familiar bulk of the huge station, largest outpost of the Space Authority in Deneb Sector. Before you is the aft airlock of the Usagi, beckoning you in.

[Better get a move on], you think.

>gonear brig
The Second Law of Thermodynamics, in one formulation, states that disorganization always increases in the absence of some outside force. A corollary is that things will always break down in the absence of someone to fix them. As a member of the repair corps of Space Station Omicron-5, you're that someone.

Your last assignment of the day, on the SS Usagi, a Space Marines fighting ship, looks routine enough. Fix the microwave and a jammed locker door, and then you're off for the day.

Brig
You are in the Feinstein's brig. Graffiti cover the walls. The cell door to the south is locked.

>read graffiti
All the graffiti seem to be about Blather. One of the least obscene items reads:

There once was a krip, name of Blather
 Who told a young Ensign named Smather
 "I'll make you inherit
 A trotting demerit
 And ship you off to those stinking fawg-infested tar-pools of Krather."

It's not a very good limerick, is it?

>s
The only obvious exit is starboard.

>go s
The only obvious exit is starboard.

* * *

Crash
An Interactive Disaster by Phil Riley
Release 5 / Serial number 220724 / Inform 7 build 6M62 (I6/v6.34 lib 6/12N) SD

Space Station Gangway
This is the pressurized bridge from Space Station Omicron-5 to the SS Usagi. Behind you is the familiar bulk of the huge station, largest outpost of the Space Authority in Deneb Sector. Before you is the aft airlock of the Usagi, beckoning you in.

[Better get a move on], you think.

>gonear starboard-side crew
The Second Law of Thermodynamics, in one formulation, states that disorganization always increases in the absence of some outside force. A corollary is that things will always break down in the absence of someone to fix them. As a member of the repair corps of Space Station Omicron-5, you're that someone.

Your last assignment of the day, on the SS Usagi, a Space Marines fighting ship, looks routine enough. Fix the microwave and a jammed locker door, and then you're off for the day.

Starboard-Side Crew Quarters
All crew members who aren't the captain sleep in this or the opposite-side bunk room. This one sleeps two in a bunk bed, done up with military precision. There is a large cabinet here, stretching almost to the ceiling. It is closed. Mounted in the wall is a crew personal storage unit. The sole exit is to port.

In a shocking lapse of military precision, there is a sticky note attached to the bed post.

A pair of slippers peeks out from under the bed.

>purloin small key
[Purloined.]

>insert key into keyhole
You open the front panel of the keypad, revealing a bundle of wiring.

>close it
It isn't something you can close.

>close keypad
You close the keypad.

>x unit
The storage unit consists of top and bottom drawers, with an attached keypad and display. There is a keyhole under the keypad. Both drawers are closed.

>insert key into keyhole
You open the front panel of the keypad, revealing a bundle of wiring.

>x unit
The storage unit consists of top and bottom drawers, with an attached keypad and display. There is a keyhole under the keypad. Both drawers are closed.

>x keypad
Inside the keypad is a bundle of wiring.

* * *

Crash
An Interactive Disaster by Phil Riley
Release 5 / Serial number 220724 / Inform 7 build 6M62 (I6/v6.34 lib 6/12N) SD

Space Station Gangway
This is the pressurized bridge from Space Station Omicron-5 to the SS Usagi. Behind you is the familiar bulk of the huge station, largest outpost of the Space Authority in Deneb Sector. Before you is the aft airlock of the Usagi, beckoning you in.

[Better get a move on], you think.

>help commands
Here are some verbs available in this game that might come in handy: 

 - clean
 - chew
 - disconnect
 - fix/repair
 - plug in
 - slide/swipe (through/in a slot)
 - spit out
 - stick (something) to
 - type
 - unbolt
 - unplug
 - vacuum
 - vent

A note on fixing: you don't need to fiddle with screwdrivers and screws. Instead, say what you mean.

* * *

Crash
An Interactive Disaster by Phil Riley
Release 5 / Serial number 220724 / Inform 7 build 6M62 (I6/v6.34 lib 6/12N) SD

Space Station Gangway
This is the pressurized bridge from Space Station Omicron-5 to the SS Usagi. Behind you is the familiar bulk of the huge station, largest outpost of the Space Authority in Deneb Sector. Before you is the aft airlock of the Usagi, beckoning you in.

[Better get a move on], you think.

>n
Accessibility off.

The Second Law of Thermodynamics, in one formulation, states that disorganization always increases in the absence of some outside force. A corollary is that things will always break down in the absence of someone to fix them. As a member of the repair corps of Space Station Omicron-5, you're that someone.

Your last assignment of the day, on the SS Usagi, a Space Marines fighting ship, looks routine enough. Fix the microwave and a jammed locker door, and then you're off for the day.

Space Station Gangway
This is the pressurized bridge from Space Station Omicron-5 to the SS Usagi. Behind you is the familiar bulk of the huge station, largest outpost of the Space Authority in Deneb Sector. Before you is the aft airlock of the Usagi, beckoning you in.

[Better get a move on], you think.

⇒ Tip: Type "help" to learn about this game, and interactive fiction in general.

>gonear deck nine
Deck Nine
This is a featureless corridor similar to every other corridor on the ship. It curves away to starboard, and a gangway leads up. To port is the entrance to one of the ship's primary escape pods. The pod bulkhead is closed.

>s
Ensign Blather, his uniform immaculate, enters and notices you are away from your post. "Twenty demerits, Ensign Seventh Class!" bellows Blather. "Forty if you're not back on Deck Nine in five seconds!" He curls his face into a hideous mask of disgust at your unbelievable negligence.

>rules
Rules tracing now switched on. Type "rules off" to switch it off again, or "rules all" to include even rules which do not apply.

[Rule "reset report text rule" applies.]

* * *

>s
Ensign Blather, his uniform immaculate, enters and notices you are away from your post. "Twenty demerits, Ensign Seventh Class!" bellows Blather. "Forty if you're not back on Deck Nine in five seconds!" He curls his face into a hideous mask of disgust at your unbelievable negligence.

>z
Time passes.

"I said to return to your post, Ensign Seventh Class!" bellows Blather, turning a deepening shade of crimson.

>p
Deck Nine
This is a featureless corridor similar to every other corridor on the ship. It curves away to starboard, and a gangway leads up. To port is the entrance to one of the ship's primary escape pods. The pod bulkhead is closed.

* * *

>z
Time passes.

"I said to return to your post, Ensign Seventh Class!" bellows Blather, turning a deepening shade of crimson.

>z
Time passes.

"I said to return to your post, Ensign Seventh Class!" bellows Blather, turning a deepening shade of crimson.

>z
Time passes.

Blather loses his last vestige of patience and drags you to the Feinstein's brig. He throws you in, and the door clangs shut behind you.

Brig

>l
Brig

>restart
Are you sure you want to restart?

>y
Would you like to turn on accessibility features like no ASCII art and no special characters? (enter "A" to turn on accessibility features, "N" to turn them off)

>n
Accessibility off.

The Second Law of Thermodynamics, in one formulation, states that disorganization always increases in the absence of some outside force. A corollary is that things will always break down in the absence of someone to fix them. As a member of the repair corps of Space Station Omicron-5, you're that someone.

Your last assignment of the day, on the SS Usagi, a Space Marines fighting ship, looks routine enough. Fix the microwave and a jammed locker door, and then you're off for the day.

Space Station Gangway
This is the pressurized bridge from Space Station Omicron-5 to the SS Usagi. Behind you is the familiar bulk of the huge station, largest outpost of the Space Authority in Deneb Sector. Before you is the aft airlock of the Usagi, beckoning you in.

[Better get a move on], you think.

⇒ Tip: Type "help" to learn about this game, and interactive fiction in general.

* * *

>u
Ensign Blather, his uniform immaculate, enters and notices you are away from your post. "Twenty demerits, Ensign Seventh Class!" bellows Blather. "Forty if you're not back on Deck Nine in five seconds!" He curls his face into a hideous mask of disgust at your unbelievable negligence.

>z
Time passes.

"I said to return to your post, Ensign Seventh Class!" bellows Blather, turning a deepening shade of crimson.

* * *

>z
Time passes.

Blather loses his last vestige of patience and drags you to the Feinstein's brig. He throws you in, and the door clangs shut behind you.

Brig

>restart
Are you sure you want to restart?

>u
Please answer yes or no.

>y
Would you like to turn on accessibility features like no ASCII art and no special characters? (enter "A" to turn on accessibility features, "N" to turn them off)

* * *

>gonear deck nine
Deck Nine
This is a featureless corridor similar to every other corridor on the ship. It curves away to starboard, and a gangway leads up. To port is the entrance to one of the ship's primary escape pods. The pod bulkhead is closed.

>sb
I'm not sure what you're trying to say. I might just not recognize the words you're using.

>s
Ensign Blather, his uniform immaculate, enters and notices you are away from your post. "Twenty demerits, Ensign Seventh Class!" bellows Blather. "Forty if you're not back on Deck Nine in five seconds!" He curls his face into a hideous mask of disgust at your unbelievable negligence.

* * *

>sb
I'm not sure what you're trying to say. I might just not recognize the words you're using.

>s
Ensign Blather, his uniform immaculate, enters and notices you are away from your post. "Twenty demerits, Ensign Seventh Class!" bellows Blather. "Forty if you're not back on Deck Nine in five seconds!" He curls his face into a hideous mask of disgust at your unbelievable negligence.

Reactor Lobby
The corridor widens here as it nears the main drive area. To starboard is the Ion Reactor that powers the vessel, and aft of here is the Auxiliary Control Room. The corridor continues to port.

You can see Ensign First Class Blather here.

* * *

>gonear deck nine
Deck Nine
This is a featureless corridor similar to every other corridor on the ship. It curves away to starboard, and a gangway leads up. To port is the entrance to one of the ship's primary escape pods. The pod bulkhead is closed.

>scenes
Scene 'Entire Game' playing (for 1 mins now)
Scene 'Playing Planetfall' playing (for 1 mins now)
Scene 'Boarding the Ship' playing (for 1 mins now)
(Scene monitoring now switched on. Type "scenes off" to switch it off again.)

>u
Gangway

>quit
You stop playing Planetfall. Time to save the ship.

Space Station Gangway
This is the pressurized bridge from Space Station Omicron-5 to the SS Usagi. Behind you is the familiar bulk of the huge station, largest outpost of the Space Authority in Deneb Sector. Before you is the aft airlock of the Usagi, beckoning you in.

[Scene 'Playing Planetfall' ends]

>quit
Are you sure you want to quit?

* * *

>gonear deck nine
Deck Nine
This is a featureless corridor similar to every other corridor on the ship. It curves away to starboard, and a gangway leads up. To port is the entrance to one of the ship's primary escape pods. The pod bulkhead is closed.

>u
Gangway
This is a steep metal gangway connecting Deck Eight, above, and Deck Nine, below.

>u
Deck Eight
This is a steep metal gangway connecting Deck Eight, above, and Deck Nine, below.

Ensign Blather, his uniform immaculate, enters and notices you are away from your post. "Twenty demerits, Ensign Seventh Class!" bellows Blather. "Forty if you're not back on Deck Nine in five seconds!" He curls his face into a hideous mask of disgust at your unbelievable negligence.

>d
Gangway

>u
Deck Eight
You can see Ensign First Class Blather here.

"I said to return to your post, Ensign Seventh Class!" bellows Blather, turning a deepening shade of crimson.

>d
Gangway

>d
Deck Nine
This is a featureless corridor similar to every other corridor on the ship. It curves away to starboard, and a gangway leads up. To port is the entrance to one of the ship's primary escape pods. The pod bulkhead is closed.

>s
Reactor Lobby
The corridor widens here as it nears the main drive area. To starboard is the Ion Reactor that powers the vessel, and aft of here is the Auxiliary Control Room. The corridor continues to port.

Ensign Blather, his uniform immaculate, enters and notices you are away from your post. "Twenty demerits, Ensign Seventh Class!" bellows Blather. "Forty if you're not back on Deck Nine in five seconds!" He curls his face into a hideous mask of disgust at your unbelievable negligence.

>z
Time passes.

"I said to return to your post, Ensign Seventh Class!" bellows Blather, turning a deepening shade of crimson.

* * *

>p
Deck Nine
This is a featureless corridor similar to every other corridor on the ship. It curves away to starboard, and a gangway leads up. To port is the entrance to one of the ship's primary escape pods. The pod bulkhead is closed.

>l
Deck Nine
This is a featureless corridor similar to every other corridor on the ship. It curves away to starboard, and a gangway leads up. To port is the entrance to one of the ship's primary escape pods. The pod bulkhead is closed.

* * *

>u
Deck Eight
This is a steep metal gangway connecting Deck Eight, above, and Deck Nine, below.

Ensign Blather, his uniform immaculate, enters and notices you are away from your post. "Twenty demerits, Ensign Seventh Class!" bellows Blather. "Forty if you're not back on Deck Nine in five seconds!" He curls his face into a hideous mask of disgust at your unbelievable negligence.

>l
Deck Eight
You can see Ensign First Class Blather here.

Ensign Blather, his uniform immaculate, enters and notices you are away from your post. "Twenty demerits, Ensign Seventh Class!" bellows Blather. "Forty if you're not back on Deck Nine in five seconds!" He curls his face into a hideous mask of disgust at your unbelievable negligence.

* * *

>u
Deck Eight
This is a steep metal gangway connecting Deck Eight, above, and Deck Nine, below.

Ensign Blather, his uniform immaculate, enters and notices you are away from your post. "Twenty demerits, Ensign Seventh Class!" bellows Blather. "Forty if you're not back on Deck Nine in five seconds!" He curls his face into a hideous mask of disgust at your unbelievable negligence.

>z
Time passes.

"I said to return to your post, Ensign Seventh Class!" bellows Blather, turning a deepening shade of crimson.

>d
Gangway

* * *

>d
Deck Nine
This is a featureless corridor similar to every other corridor on the ship. It curves away to starboard, and a gangway leads up. To port is the entrance to one of the ship's primary escape pods. The pod bulkhead is closed.

>s
Reactor Lobby
The corridor widens here as it nears the main drive area. To starboard is the Ion Reactor that powers the vessel, and aft of here is the Auxiliary Control Room. The corridor continues to port.

You can see Ensign First Class Blather here.

Ensign Blather, his uniform immaculate, enters and notices you are away from your post. "Twenty demerits, Ensign Seventh Class!" bellows Blather. "Forty if you're not back on Deck Nine in five seconds!" He curls his face into a hideous mask of disgust at your unbelievable negligence.

* * *

>z
Time passes.

"I said to return to your post, Ensign Seventh Class!" bellows Blather, turning a deepening shade of crimson.

>s
The only obvious exit is down (to gangway).

"I said to return to your post, Ensign Seventh Class!" bellows Blather, turning a deepening shade of crimson.

>s
The only obvious exit is down (to gangway).

"I said to return to your post, Ensign Seventh Class!" bellows Blather, turning a deepening shade of crimson.

>d
Gangway

* * *

>d
Deck Nine
This is a featureless corridor similar to every other corridor on the ship. It curves away to starboard, and a gangway leads up. To port is the entrance to one of the ship's primary escape pods. The pod bulkhead is closed.

>w
I'm not sure what you're trying to say. I might just not recognize the words you're using.

>s
Reactor Lobby
The corridor widens here as it nears the main drive area. To starboard is the Ion Reactor that powers the vessel, and aft of here is the Auxiliary Control Room. The corridor continues to port.

Ensign Blather, his uniform immaculate, enters and notices you are away from your post. "Twenty demerits, Ensign Seventh Class!" bellows Blather. "Forty if you're not back on Deck Nine in five seconds!" He curls his face into a hideous mask of disgust at your unbelievable negligence.

* * *

>z
Time passes.

"I said to return to your post, Ensign Seventh Class!" bellows Blather, turning a deepening shade of crimson.

>z
Time passes.

Blather loses his last vestige of patience and drags you to the Feinstein's brig. He throws you in, and the door clangs shut behind you.

Brig
You are in the Feinstein's brig. Graffiti cover the walls. The cell door to the south is locked.

* * *

>gonear deck nine
Deck Nine
This is a featureless corridor similar to every other corridor on the ship. It curves away to starboard, and a gangway leads up. To port is the entrance to one of the ship's primary escape pods. The pod bulkhead is closed.

>z
Time passes.

>zz
I'm not sure what you're trying to say. I might just not recognize the words you're using.

>l
Deck Nine
This is a featureless corridor similar to every other corridor on the ship. It curves away to starboard, and a gangway leads up. To port is the entrance to one of the ship's primary escape pods. The pod bulkhead is closed.

You can see Ensign First Class Blather here.

* * *

>gonear gangway
(Space Station Gangway)
Space Station Gangway
This is the pressurized bridge from Space Station Omicron-5 to the SS Usagi. Behind you is the familiar bulk of the huge station, largest outpost of the Space Authority in Deneb Sector. Before you is the aft airlock of the Usagi, beckoning you in.

>gonear planetfall gangway
Gangway

>u
Deck Eight

>d
Gangway

* * *

>gonear planetfall
Which do you mean, the copy of Planetfall or Gangway?

>gangwaay
There seems to be no such object anywhere in the model world.

>gonear planetfall gangway
Gangway

>d
Deck Nine
This is a featureless corridor similar to every other corridor on the ship. It curves away to starboard, and a gangway leads up. To port is the entrance to one of the ship's primary escape pods. The pod bulkhead is closed.

>sb
I'm not sure what you're trying to say. I might just not recognize the words you're using.

>s
Reactor Lobby
The corridor widens here as it nears the main drive area. To starboard is the Ion Reactor that powers the vessel, and aft of here is the Auxiliary Control Room. The corridor continues to port.

>s
The only obvious exit is port (to deck nine).

>a
The only obvious exit is port (to deck nine).

>p
Deck Nine
This is a featureless corridor similar to every other corridor on the ship. It curves away to starboard, and a gangway leads up. To port is the entrance to one of the ship's primary escape pods. The pod bulkhead is closed.

* * *

>n
I'm not sure what you're trying to say. I might just not recognize the words you're using.

>pf
PLANETFALL Infocom interactive fiction - a science fiction story Copyright (c) 1983 by Infocom, Inc. All rights reserved. PLANETFALL is a registered trademark of Infocom, Inc. Release 39 / Serial number 880501
Another routine day of drudgery aboard the Stellar Patrol Ship Feinstein. This morning's assignment for a certain lowly Ensign Seventh Class: scrubbing the filthy metal deck at the port end of Level Nine. With your Patrol-issue self-contained multi-purpose all-weather scrub brush you shine the floor with a diligence born of the knowledge that at any moment dreaded Ensign First Class Blather, the bane of your shipboard existence, could appear.

Deck Nine
This is a featureless corridor similar to every other corridor on the ship. It curves away to starboard, and a gangway leads up. To port is the entrance to one of the ship's primary escape pods. The pod bulkhead is closed.

* * *

>pf
PLANETFALL
Infocom interactive fiction - a science fiction story
Copyright (c) 1983 by Infocom, Inc. All rights reserved.
PLANETFALL is a registered trademark of Infocom, Inc.
Release 39 / Serial number 880501

Another routine day of drudgery aboard the Stellar Patrol Ship Feinstein. This morning's assignment for a certain lowly Ensign Seventh Class: scrubbing the filthy metal deck at the port end of Level Nine. With your Patrol-issue self-contained multi-purpose all-weather scrub brush you shine the floor with a diligence born of the knowledge that at any moment dreaded Ensign First Class Blather, the bane of your shipboard existence, could appear.

>i
You are carrying:
  a Patrol uniform (being worn)
    an ID card
  a chronometer (being worn)
  a Patrol-issue self-contained multi-purpose scrub brush

>quit
You stop playing Planetfall. Time to save the ship.

>i
You are carrying:
  some chewing gum (being chewed)
  a To-Do list
  a repair corps uniform (being worn)
  a toolbox

>l
Space Station Gangway
This is the pressurized bridge from Space Station Omicron-5 to the SS Usagi. Behind you is the familiar bulk of the huge station, largest outpost of the Space Authority in Deneb Sector. Before you is the aft airlock of the Usagi, beckoning you in.

>pf
PLANETFALL
 Infocom interactive fiction - a science fiction story
 Copyright (c) 1983 by Infocom, Inc. All rights reserved.
 PLANETFALL is a registered trademark of Infocom, Inc.
 Release 39 / Serial number 880501

Another routine day of drudgery aboard the Stellar Patrol Ship Feinstein. This morning's assignment for a certain lowly Ensign Seventh Class: scrubbing the filthy metal deck at the port end of Level Nine. With your Patrol-issue self-contained multi-purpose all-weather scrub brush you shine the floor with a diligence born of the knowledge that at any moment dreaded Ensign First Class Blather, the bane of your shipboard existence, could appear.

* * *

>quit
You stop playing Planetfall. Time to save the ship.

>l
Space Station Gangway
This is the pressurized bridge from Space Station Omicron-5 to the SS Usagi. Behind you is the familiar bulk of the huge station, largest outpost of the Space Authority in Deneb Sector. Before you is the aft airlock of the Usagi, beckoning you in.

You can see your former self with chewing gum stuck to him floating here.

>i
You are carrying:
  a Patrol uniform (being worn)
    an ID card
  a chronometer (being worn)
  a Patrol-issue self-contained multi-purpose scrub brush

* * *

>n
I'm not sure what you're trying to say. I might just not recognize the words you're using.

>z
Time passes.

>z
Time passes.

The alien ambassador from the planet Blow'k-bibben-Gordo ambles toward you from down the corridor. He is munching on something resembling an enormous stalk of celery, and he leaves a trail of green slime on the deck. He stops nearby, and you wince as a pool of slime begins forming beneath him on your newly-polished deck. The ambassador wheezes loudly and hands you a brochure outlining his planet's major exports.

The ambassador asks where Admiral Smithers can be found.

* * *

>p
The escape pod bulkhead is closed.

>open pod
Why open the door to the emergency escape pod if there's no emergency?

>close it
That's already closed.

The alien ambassador from the planet Blow'k-bibben-Gordo ambles toward you from down the corridor. He is munching on something resembling an enormous stalk of celery, and he leaves a trail of green slime on the deck. He stops nearby, and you wince as a pool of slime begins forming beneath him on your newly-polished deck. The ambassador wheezes loudly and hands you a brochure outlining his planet's major exports.

>read brochure
"The leading export of Blow'k-bibben-Gordo is the adventure game

          *** PLANETFALL ***

written by S. Eric Meretzky.
Buy one today. Better yet, buy a thousand."

The ambassador asks if you are performing some sort of religious ceremony.

>drop it
Dropped.

The ambassador introduces himself as Br'gun-te'elkner-ipg'nun.

>l
Deck Nine
This is a featureless corridor similar to every other corridor on the ship. It curves away to starboard, and a gangway leads up. To port is the entrance to one of the ship's primary escape pods. The pod bulkhead is closed.

You can see a brochure and an alien ambassador here.

The ambassador asks where Admiral Smithers can be found.

* * *

>quit
You stop playing Planetfall. Time to save the ship.

Space Station Gangway
This is the pressurized bridge from Space Station Omicron-5 to the SS Usagi. Behind you is the familiar bulk of the huge station, largest outpost of the Space Authority in Deneb Sector. Before you is the aft airlock of the Usagi, beckoning you in.

>i
You are carrying:
  some chewing gum (being chewed)
  a To-Do list
  a repair corps uniform (being worn)
  a toolbox

* * *

>i
You are carrying:
  a Patrol uniform (being worn)
    an ID card
  a chronometer (being worn)
  a Patrol-issue self-contained multi-purpose scrub brush

* * *

>s
Reactor Lobby
The corridor widens here as it nears the main drive area. To starboard is the Ion Reactor that powers the vessel, and aft of here is the Auxiliary Control Room. The corridor continues to port.

Ensign Blather, his uniform immaculate, enters and notices you are away from your post. "Twenty demerits, Ensign Seventh Class!" bellows Blather. "Forty if you're not back on Deck Nine in five seconds!" He curls his face into a hideous mask of disgust at your unbelievable negligence.

>l
Reactor Lobby
The corridor widens here as it nears the main drive area. To starboard is the Ion Reactor that powers the vessel, and aft of here is the Auxiliary Control Room. The corridor continues to port.

"I said to return to your post, Ensign Seventh Class!" bellows Blather, turning a deepening shade of crimson.

>p
Deck Nine
This is a featureless corridor similar to every other corridor on the ship. It curves away to starboard, and a gangway leads up. To port is the entrance to one of the ship's primary escape pods. The pod bulkhead is closed.

>p
The escape pod bulkhead is closed.

* * *

>s
Reactor Lobby
The corridor widens here as it nears the main drive area. To starboard is the Ion Reactor that powers the vessel, and aft of here is the Auxiliary Control Room. The corridor continues to port.

Ensign Blather, his uniform immaculate, enters and notices you are away from your post. "Twenty demerits, Ensign Seventh Class!" bellows Blather. "Forty if you're not back on Deck Nine in five seconds!" He curls his face into a hideous mask of disgust at your unbelievable negligence.

>p
Deck Nine
This is a featureless corridor similar to every other corridor on the ship. It curves away to starboard, and a gangway leads up. To port is the entrance to one of the ship's primary escape pods. The pod bulkhead is closed.

* * *

>p
The escape pod bulkhead is closed.

>open it
I'm not sure what 'it' refers to.

>open pod
You open the escape pod bulkhead.

The alien ambassador from the planet Blow'k-bibben-Gordo ambles toward you from down the corridor. He is munching on something resembling an enormous stalk of celery, and he leaves a trail of green slime on the deck. He stops nearby, and you wince as a pool of slime begins forming beneath him on your newly-polished deck. The ambassador wheezes loudly and hands you a brochure outlining his planet's major exports.

* * *

>u
Gangway
This is a steep metal gangway connecting Deck Eight, above, and Deck Nine, below.

* * *

>u
Deck Eight
This is a steep metal gangway connecting Deck Eight, above, and Deck Nine, below.

Ensign Blather, his uniform immaculate, enters and notices you are away from your post. "Twenty demerits, Ensign Seventh Class!" bellows Blather. "Forty if you're not back on Deck Nine in five seconds!" He curls his face into a hideous mask of disgust at your unbelievable negligence.

>d
Gangway
This is a steep metal gangway connecting Deck Eight, above, and Deck Nine, below.

>d
Deck Nine
This is a featureless corridor similar to every other corridor on the ship. It curves away to starboard, and a gangway leads up. To port is the entrance to one of the ship's primary escape pods. The pod bulkhead is closed.

>z
Time passes.

>z
Time passes.

The alien ambassador from the planet Blow'k-bibben-Gordo ambles toward you from down the corridor. He is munching on something resembling an enormous stalk of celery, and he leaves a trail of green slime on the deck. He stops nearby, and you wince as a pool of slime begins forming beneath him on your newly-polished deck. The ambassador wheezes loudly and hands you a brochure outlining his planet's major exports.

* * *

>x chronometer
It is a standard wrist chronometer with a digital display. According to the chronometer, the current time is 4478. The back is engraved with the message "Good luck in the Patrol! Love, Mom and Dad."

>x chronometer
It is a standard wrist chronometer with a digital display. According to the chronometer, the current time is 8956. The back is engraved with the message "Good luck in the Patrol! Love, Mom and Dad."

>x chronometer
It is a standard wrist chronometer with a digital display. According to the chronometer, the current time is 13434. The back is engraved with the message "Good luck in the Patrol! Love, Mom and Dad."

The alien ambassador from the planet Blow'k-bibben-Gordo ambles toward you from down the corridor. He is munching on something resembling an enormous stalk of celery, and he leaves a trail of green slime on the deck. He stops nearby, and you wince as a pool of slime begins forming beneath him on your newly-polished deck. The ambassador wheezes loudly and hands you a brochure outlining his planet's major exports.

>x chronometer
It is a standard wrist chronometer with a digital display. According to the chronometer, the current time is 17912. The back is engraved with the message "Good luck in the Patrol! Love, Mom and Dad."

* * *

>x me
You're wearing nothing but your underwear. Aren't you cold?

* * *

>x watch
You can't see any such thing.

>x chronometer
It is a standard wrist chronometer with a digital display. According to the chronometer, the current time is 4478. The back is engraved with the message "Good luck in the Patrol! Love, Mom and Dad."

>x chronometer
It is a standard wrist chronometer with a digital display. According to the chronometer, the current time is 4481. The back is engraved with the message "Good luck in the Patrol! Love, Mom and Dad."

>x chronometer
It is a standard wrist chronometer with a digital display. According to the chronometer, the current time is 4484. The back is engraved with the message "Good luck in the Patrol! Love, Mom and Dad."

The alien ambassador from the planet Blow'k-bibben-Gordo ambles toward you from down the corridor. He is munching on something resembling an enormous stalk of celery, and he leaves a trail of green slime on the deck. He stops nearby, and you wince as a pool of slime begins forming beneath him on your newly-polished deck. The ambassador wheezes loudly and hands you a brochure outlining his planet's major exports.

>p
(first opening the escape pod bulkhead)

Escape Pod

>s
Deck Nine
This is a featureless corridor similar to every other corridor on the ship. It curves away to starboard, and a gangway leads up. To port is the entrance to one of the ship's primary escape pods. The pod bulkhead is closed.

You can see an alien ambassador here.

>s
Reactor Lobby
The corridor widens here as it nears the main drive area. To starboard is the Ion Reactor that powers the vessel, and aft of here is the Auxiliary Control Room. The corridor continues to port.

Ensign Blather, his uniform immaculate, enters and notices you are away from your post. "Twenty demerits, Ensign Seventh Class!" bellows Blather. "Forty if you're not back on Deck Nine in five seconds!" He curls his face into a hideous mask of disgust at your unbelievable negligence.

>p
Deck Nine
This is a featureless corridor similar to every other corridor on the ship. It curves away to starboard, and a gangway leads up. To port is the entrance to one of the ship's primary escape pods. The pod bulkhead is closed.

You can see an alien ambassador here.

>z
Time passes.

>z
Time passes.

The ambassador grunts a polite farewell, and disappears up the gangway, leaving a trail of dripping slime.

>z
Time passes.

* * *

>z
Time passes.

>x me
That's difficult unless your eyes are prehensile.

>i
You are carrying:
  a Patrol uniform (being worn)
    an ID card
  a chronometer (being worn)
  a Patrol-issue self-contained multi-purpose scrub brush

The alien ambassador from the planet Blow'k-bibben-Gordo ambles toward you from down the corridor. He is munching on something resembling an enormous stalk of celery, and he leaves a trail of green slime on the deck. He stops nearby, and you wince as a pool of slime begins forming beneath him on your newly-polished deck. The ambassador wheezes loudly and hands you a brochure outlining his planet's major exports.

>x brush
You see nothing special about the Patrol-issue self-contained multi-purpose scrub brush.

The ambassador offers you a bit of celery.

* * *

>z
Time passes.

>read chronometer
There is nothing to read on the chronometer.

The alien ambassador from the planet Blow'k-bibben-Gordo ambles toward you from down the corridor. He is munching on something resembling an enormous stalk of celery, and he leaves a trail of green slime on the deck. He stops nearby, and you wince as a pool of slime begins forming beneath him on your newly-polished deck. The ambassador wheezes loudly and hands you a brochure outlining his planet's major exports.

>x chronometer
It is a standard wrist chronometer with a digital display. According to the chronometer, the current time is 4487. The back is engraved with the message "Good luck in the Patrol! Love, Mom and Dad."

The ambassador asks if you are performing some sort of religious ceremony.

* * *

>z
Time passes.

The alien ambassador from the planet Blow'k-bibben-Gordo ambles toward you from down the corridor. He is munching on something resembling an enormous stalk of celery, and he leaves a trail of green slime on the deck. He stops nearby, and you wince as a pool of slime begins forming beneath him on your newly-polished deck. The ambassador wheezes loudly and hands you a brochure outlining his planet's major exports.

>l
Deck Nine
This is a featureless corridor similar to every other corridor on the ship. It curves away to starboard, and a gangway leads up. To port is the entrance to one of the ship's primary escape pods. The pod bulkhead is closed.

The ambassador offers you a bit of celery.

>l
Deck Nine
This is a featureless corridor similar to every other corridor on the ship. It curves away to starboard, and a gangway leads up. To port is the entrance to one of the ship's primary escape pods. The pod bulkhead is closed.

The ambassador asks where Admiral Smithers can be found.

>sb
I'm not sure what you're trying to say. I might just not recognize the words you're using.

>s
Reactor Lobby
The corridor widens here as it nears the main drive area. To starboard is the Ion Reactor that powers the vessel, and aft of here is the Auxiliary Control Room. The corridor continues to port.

Ensign Blather, his uniform immaculate, enters and notices you are away from your post. "Twenty demerits, Ensign Seventh Class!" bellows Blather. "Forty if you're not back on Deck Nine in five seconds!" He curls his face into a hideous mask of disgust at your unbelievable negligence.

>l
Reactor Lobby
The corridor widens here as it nears the main drive area. To starboard is the Ion Reactor that powers the vessel, and aft of here is the Auxiliary Control Room. The corridor continues to port.

You can see Ensign First Class Blather here.

"I said to return to your post, Ensign Seventh Class!" bellows Blather, turning a deepening shade of crimson.

* * *

>z
Time passes.

The alien ambassador from the planet Blow'k-bibben-Gordo ambles toward you from down the corridor. He is munching on something resembling an enormous stalk of celery, and he leaves a trail of green slime on the deck. He stops nearby, and you wince as a pool of slime begins forming beneath him on your newly-polished deck. The ambassador wheezes loudly and hands you a brochure outlining his planet's major exports.

>read brochure
"The leading export of Blow'k-bibben-Gordo is the adventure game

          *** PLANETFALL ***

written by S. Eric Meretzky.
Buy one today. Better yet, buy a thousand."

The ambassador inquires whether you are interested in a game of Bocci.

* * *

>z
Time passes.

The alien ambassador from the planet Blow'k-bibben-Gordo ambles toward you from down the corridor. He is munching on something resembling an enormous stalk of celery, and he leaves a trail of green slime on the deck. He stops nearby, and you wince as a pool of slime begins forming beneath him on your newly-polished deck. The ambassador wheezes loudly and hands you a brochure outlining his planet's major exports.

>z
Time passes.

The ambassador introduces himself as Br'gun-te'elkner-ipg'nun.

>z
Time passes.

The ambassador asks if you are performing some sort of religious ceremony.

>z
Time passes.

The ambassador remarks that all humans look alike to him.

>z
Time passes.

The ambassador grunts a polite farewell, and disappears up the gangway, leaving a trail of dripping slime.

>read brochure
You can't see any such thing.

* * *

>z
Time passes.

>z
Time passes.

A massive explosion rocks the ship. Echoes from the explosion resound deafeningly down the halls. The door to port slides open.

[No, no, no. This is hitting too close to home. Better quit and focus on saving the ship.]

Space Station Gangway
This is the pressurized bridge from Space Station Omicron-5 to the SS Usagi. Behind you is the familiar bulk of the huge station, largest outpost of the Space Authority in Deneb Sector. Before you is the aft airlock of the Usagi, beckoning you in.

>l
Space Station Gangway
This is the pressurized bridge from Space Station Omicron-5 to the SS Usagi. Behind you is the familiar bulk of the huge station, largest outpost of the Space Authority in Deneb Sector. Before you is the aft airlock of the Usagi, beckoning you in.

A massive explosion rocks the ship. Echoes from the explosion resound deafeningly down the halls. The door to port slides open. The ambassador squawks frantically, evacuates a massive load of gooey slime, and rushes away.

No, no, no. This is hitting too close to home. Better quit and focus on saving the ship.

* * *

>sb
I'm not sure what you're trying to say. I might just not recognize the words you're using.

>s
The only obvious exit is fore.

>pf
PLANETFALL
Infocom interactive fiction - a science fiction story
Copyright (c) 1983 by Infocom, Inc. All rights reserved.
PLANETFALL is a registered trademark of Infocom, Inc.
Release 39 / Serial number 880501

Another routine day of drudgery aboard the Stellar Patrol Ship Feinstein. This morning's assignment for a certain lowly Ensign Seventh Class: scrubbing the filthy metal deck at the port end of Level Nine. With your Patrol-issue self-contained multi-purpose all-weather scrub brush you shine the floor with a diligence born of the knowledge that at any moment dreaded Ensign First Class Blather, the bane of your shipboard existence, could appear.

* * *

>s
Reactor Lobby
The corridor widens here as it nears the main drive area. To starboard is the Ion Reactor that powers the vessel, and aft of here is the Auxiliary Control Room. The corridor continues to port.

Ensign Blather, his uniform immaculate, enters and notices you are away from your post. "Twenty demerits, Ensign Seventh Class!" bellows Blather. "Forty if you're not back on Deck Nine in five seconds!" He curls his face into a hideous mask of disgust at your unbelievable negligence.

>a
Ensign Blather pushes you roughly back toward your post.

"I said to return to your post, Ensign Seventh Class!" bellows Blather, turning a deepening shade of crimson.

>f
Blather throws you to the deck and makes you do 20 push-ups.

"I said to return to your post, Ensign Seventh Class!" bellows Blather, turning a deepening shade of crimson.

>p
Deck Nine
This is a featureless corridor similar to every other corridor on the ship. It curves away to starboard, and a gangway leads up. To port is the entrance to one of the ship's primary escape pods. The pod bulkhead is closed.

>u
Gangway
This is a steep metal gangway connecting Deck Eight, above, and Deck Nine, below.

* * *

>u
Deck Eight
This is a steep metal gangway connecting Deck Eight, above, and Deck Nine, below.

Ensign Blather, his uniform immaculate, enters and notices you are away from your post. "Twenty demerits, Ensign Seventh Class!" bellows Blather. "Forty if you're not back on Deck Nine in five seconds!" He curls his face into a hideous mask of disgust at your unbelievable negligence.

>f
Ensign Blather pushes you roughly back toward your post.

"I said to return to your post, Ensign Seventh Class!" bellows Blather, turning a deepening shade of crimson.

>s
Ensign Blather pushes you roughly back toward your post.

"I said to return to your post, Ensign Seventh Class!" bellows Blather, turning a deepening shade of crimson.

>d
Gangway
This is a steep metal gangway connecting Deck Eight, above, and Deck Nine, below.

* * *

>d
Deck Nine
This is a featureless corridor similar to every other corridor on the ship. It curves away to starboard, and a gangway leads up. To port is the entrance to one of the ship's primary escape pods. The pod bulkhead is closed.

>port
(first opening the escape pod bulkhead)

Escape Pod

* * *

>scenes
Scene 'Entire Game' playing (for 0 mins now)
Scene 'Boarding the Ship' playing (for 0 mins now)
(Scene monitoring now switched on. Type "scenes off" to switch it off again.)

>gonear deck nine
Deck Nine
This is a featureless corridor similar to every other corridor on the ship. It curves away to starboard, and a gangway leads up. To port is the entrance to one of the ship's primary escape pods. The pod bulkhead is closed.

[Scene 'Playing Planetfall' begins]

>quit
You stop playing Planetfall. Time to save the ship.

Space Station Gangway
This is the pressurized bridge from Space Station Omicron-5 to the SS Usagi. Behind you is the familiar bulk of the huge station, largest outpost of the Space Authority in Deneb Sector. Before you is the aft airlock of the Usagi, beckoning you in.

Are you sure you want to quit?

>n
[Scene 'Playing Planetfall' ends]

* * *

>z
Time passes.

>pf
PLANETFALL
Infocom interactive fiction - a science fiction story
Copyright (c) 1983 by Infocom, Inc. All rights reserved.
PLANETFALL is a registered trademark of Infocom, Inc.
Release 39 / Serial number 880501

Another routine day of drudgery aboard the Stellar Patrol Ship Feinstein. This morning's assignment for a certain lowly Ensign Seventh Class: scrubbing the filthy metal deck at the port end of Level Nine. With your Patrol-issue self-contained multi-purpose all-weather scrub brush you shine the floor with a diligence born of the knowledge that at any moment dreaded Ensign First Class Blather, the bane of your shipboard existence, could appear.

>z
Time passes.

The alien ambassador from the planet Blow'k-bibben-Gordo ambles toward you from down the corridor. He is munching on something resembling an enormous stalk of celery, and he leaves a trail of green slime on the deck. He stops nearby, and you wince as a pool of slime begins forming beneath him on your newly-polished deck. The ambassador wheezes loudly and hands you a brochure outlining his planet's major exports.

>z
Time passes.

The ambassador inquires whether you are interested in a game of Bocci.

>z
Time passes.

The ambassador introduces himself as Br'gun-te'elkner-ipg'nun.

* * *

>z
Time passes.

The ambassador asks if you are performing some sort of religious ceremony.

>z
Time passes.

The ambassador grunts a polite farewell, and disappears up the gangway, leaving a trail of dripping slime.

* * *

>z
Time passes.

>z
Time passes.

A massive explosion rocks the ship. Echoes from the explosion resound deafeningly down the halls. The door to port slides open.

No, no, no. This is hitting too close to home. Better quit and focus on saving the ship.

Space Station Gangway
This is the pressurized bridge from Space Station Omicron-5 to the SS Usagi. Behind you is the familiar bulk of the huge station, largest outpost of the Space Authority in Deneb Sector. Before you is the aft airlock of the Usagi, beckoning you in.

* * *

>z
Time passes.

>z
Time passes.

The ambassador asks if you are performing some sort of religious ceremony.

* * *

Crash
An Interactive Disaster by Phil Riley
Release 5 / Serial number 220724 / Inform 7 build 6M62 (I6/v6.34 lib 6/12N) SD

Space Station Gangway
This is the pressurized bridge from Space Station Omicron-5 to the SS Usagi. Behind you is the familiar bulk of the huge station, largest outpost of the Space Authority in Deneb Sector. Before you is the aft airlock of the Usagi, beckoning you in.

[Better get a move on], you think.

>open toolbox
You'll open it if you need it.

* * *

Crash
An Interactive Disaster by Phil Riley
Release 5 / Serial number 220724 / Inform 7 build 6M62 (I6/v6.34 lib 6/12N) SD

Space Station Gangway
This is the pressurized bridge from Space Station Omicron-5 to the SS Usagi. Behind you is the familiar bulk of the huge station, largest outpost of the Space Authority in Deneb Sector. Before you is the aft airlock of the Usagi, beckoning you in.

[Better get a move on], you think.

>pf
PLANETFALL
Infocom interactive fiction - a science fiction story
Copyright (c) 1983 by Infocom, Inc. All rights reserved.
PLANETFALL is a registered trademark of Infocom, Inc.
Release 39 / Serial number 880501

Another routine day of drudgery aboard the Stellar Patrol Ship Feinstein. This morning's assignment for a certain lowly Ensign Seventh Class: scrubbing the filthy metal deck at the port end of Level Nine. With your Patrol-issue self-contained multi-purpose all-weather scrub brush you shine the floor with a diligence born of the knowledge that at any moment dreaded Ensign First Class Blather, the bane of your shipboard existence, could appear.

>polish floor
You can't see any such thing.

>quit
You stop playing Planetfall. Time to save the ship.

The Second Law of Thermodynamics, in one formulation, states that disorganization always increases in the absence of some outside force. A corollary is that things will always break down in the absence of someone to fix them. As a member of the repair corps of Space Station Omicron-5, you're that someone.

Your last assignment of the day, on the SS Usagi, a Space Marines fighting ship, looks routine enough. Fix the microwave and a jammed locker door, and then you're off for the day.

Space Station Gangway
This is the pressurized bridge from Space Station Omicron-5 to the SS Usagi. Behind you is the familiar bulk of the huge station, largest outpost of the Space Authority in Deneb Sector. Before you is the aft airlock of the Usagi, beckoning you in.

⇒ Tip: Type "help" to learn about this game, and interactive fiction in general.

>pf
PLANETFALL
Infocom interactive fiction - a science fiction story
Copyright (c) 1983 by Infocom, Inc. All rights reserved.
PLANETFALL is a registered trademark of Infocom, Inc.
Release 39 / Serial number 880501

Another routine day of drudgery aboard the Stellar Patrol Ship Feinstein. This morning's assignment for a certain lowly Ensign Seventh Class: scrubbing the filthy metal deck at the port end of Level Nine. With your Patrol-issue self-contained multi-purpose all-weather scrub brush you shine the floor with a diligence born of the knowledge that at any moment dreaded Ensign First Class Blather, the bane of your shipboard existence, could appear.

* * *

>quit
You stop playing Planetfall. Time to save the ship.

Space Station Gangway
This is the pressurized bridge from Space Station Omicron-5 to the SS Usagi. Behind you is the familiar bulk of the huge station, largest outpost of the Space Authority in Deneb Sector. Before you is the aft airlock of the Usagi, beckoning you in.

>polish
What do you want to polish?

>bridge
You rub the gangway.

* * *

>quit
You stop playing Planetfall. Time to save the ship.

The Second Law of Thermodynamics, in one formulation, states that disorganization always increases in the absence of some outside force. A corollary is that things will always break down in the absence of someone to fix them. As a member of the repair corps of Space Station Omicron-5, you're that someone.

Your last assignment of the day, on the SS Usagi, a Space Marines fighting ship, looks routine enough. Fix the microwave and a jammed locker door, and then you're off for the day.

Space Station Gangway
This is the pressurized bridge from Space Station Omicron-5 to the SS Usagi. Behind you is the familiar bulk of the huge station, largest outpost of the Space Authority in Deneb Sector. Before you is the aft airlock of the Usagi, beckoning you in.

⇒ Tip: Type "help" to learn about this game, and interactive fiction in general.

* * *

>s
Reactor Lobby
The corridor widens here as it nears the main drive area. To starboard is the Ion Reactor that powers the vessel, and aft of here is the Auxiliary Control Room. The corridor continues to port.

Ensign Blather, his uniform immaculate, enters and notices you are away from your post. "Twenty demerits, Ensign Seventh Class!" bellows Blather. "Forty if you're not back on Deck Nine in five seconds!" He curls his face into a hideous mask of disgust at your unbelievable negligence.

>hit blather
Blather removes several of your appendages and internal organs.

    ****  You have died  ****

[Ouch. I hope that's not prescient.]

You stop playing Planetfall. Time to save the ship.

The Second Law of Thermodynamics, in one formulation, states that disorganization always increases in the absence of some outside force. A corollary is that things will always break down in the absence of someone to fix them. As a member of the repair corps of Space Station Omicron-5, you're that someone.

Your last assignment of the day, on the SS Usagi, a Space Marines fighting ship, looks routine enough. Fix the microwave and a jammed locker door, and then you're off for the day.

Space Station Gangway
This is the pressurized bridge from Space Station Omicron-5 to the SS Usagi. Behind you is the familiar bulk of the huge station, largest outpost of the Space Authority in Deneb Sector. Before you is the aft airlock of the Usagi, beckoning you in.

⇒ Tip: Type "help" to learn about this game, and interactive fiction in general.

* * *

>sb
I'm not sure what you're trying to say. I might just not recognize the words you're using.

* * *

>z
Time passes.

"I said to return to your post, Ensign Seventh Class!" bellows Blather, turning a deepening shade of crimson.

>z
Time passes.

Blather loses his last vestige of patience and drags you to the Feinstein's brig. He throws you in, and the door clangs shut behind you.

The Second Law of Thermodynamics, in one formulation, states that disorganization always increases in the absence of some outside force. A corollary is that things will always break down in the absence of someone to fix them. As a member of the repair corps of Space Station Omicron-5, you're that someone.

Your last assignment of the day, on the SS Usagi, a Space Marines fighting ship, looks routine enough. Fix the microwave and a jammed locker door, and then you're off for the day.

Brig
You are in the Feinstein's brig. Graffiti cover the walls. The cell door to the south is locked.

>x door
You see nothing special about the cell door.

>open it
No way, Jose.

>close door
That's already closed.

>sb
I'm not sure what you're trying to say. I might just not recognize the words you're using.

>s
The only obvious exit is starboard.

A massive explosion rocks the ship. Echoes from the explosion resound deafeningly down the halls.

[No, no, no. This is hitting too close to home. Better quit and focus on saving the ship.]

Space Station Gangway
This is the pressurized bridge from Space Station Omicron-5 to the SS Usagi. Behind you is the familiar bulk of the huge station, largest outpost of the Space Authority in Deneb Sector. Before you is the aft airlock of the Usagi, beckoning you in.

⇒ Tip: Type "help" to learn about this game, and interactive fiction in general.

* * *

>x slime
What slime?

>take slime
What slime?

>clean floor
The floor is a bit shinier now.

The alien ambassador from the planet Blow'k-bibben-Gordo ambles toward you from down the corridor. He is munching on something resembling an enormous stalk of celery, and he leaves a trail of green slime on the deck. He stops nearby, and you wince as a pool of slime begins forming beneath him on your newly-polished deck. The ambassador wheezes loudly and hands you a brochure outlining his planet's major exports.

>smell slime
You smell nothing unexpected.

The ambassador remarks that all humans look alike to him.

>listen to the slime
That's not something you need to do in this game.

The ambassador asks where Admiral Smithers can be found.

>look at the slime
It looks like slime. Aren't you glad you didn't step in it?

The ambassador inquires whether you are interested in a game of Bocci.

>taste slime
You taste nothing unexpected.

The ambassador grunts a polite farewell, and disappears up the gangway, leaving a trail of dripping slime.

>touch slime
It feels like slime. Aren't you glad you didn't step in it?

* * *

>x slime
What slime?

>z
Time passes.

* * *

>z
Time passes.

The alien ambassador from the planet Blow'k-bibben-Gordo ambles toward you from down the corridor. He is munching on something resembling an enormous stalk of celery, and he leaves a trail of green slime on the deck. He stops nearby, and you wince as a pool of slime begins forming beneath him on your newly-polished deck. The ambassador wheezes loudly and hands you a brochure outlining his planet's major exports.

>x slime
You see nothing special about Slime.

The ambassador introduces himself as Br'gun-te'elkner-ipg'nun.

* * *

>z
Time passes.

The alien ambassador from the planet Blow'k-bibben-Gordo ambles toward you from down the corridor. He is munching on something resembling an enormous stalk of celery, and he leaves a trail of green slime on the deck. He stops nearby, and you wince as a pool of slime begins forming beneath him on your newly-polished deck. The ambassador wheezes loudly and hands you a brochure outlining his planet's major exports.

>hit ambassador
The ambassador is startled, and emits an amazing quantity of slime which spreads across the section of the deck you just polished.

The ambassador asks if you are performing some sort of religious ceremony.

>x slime
It looks like slime. Aren't you glad you didn't step in it?

The ambassador asks where Admiral Smithers can be found.

>take it
It feels like slime. Aren't you glad you didn't step in it?

The ambassador inquires whether you are interested in a game of Bocci.

>clean it
Whew. You've cleaned up maybe one ten-thousandth of the slime. If you hurry, it might be all cleaned up before Ensign Blather gets here.

The ambassador grunts a polite farewell, and disappears up the gangway, leaving a trail of dripping slime.

>u
Gangway
This is a steep metal gangway connecting Deck Eight, above, and Deck Nine, below.

* * *

>u
Deck Eight
This is a steep metal gangway connecting Deck Eight, above, and Deck Nine, below.

Ensign Blather, his uniform immaculate, enters and notices you are away from your post. "Twenty demerits, Ensign Seventh Class!" bellows Blather. "Forty if you're not back on Deck Nine in five seconds!" He curls his face into a hideous mask of disgust at your unbelievable negligence.

>u
Blather throws you to the deck and makes you do 20 push-ups.

"I said to return to your post, Ensign Seventh Class!" bellows Blather, turning a deepening shade of crimson.

>u
Ensign Blather pushes you roughly back toward your post.

"I said to return to your post, Ensign Seventh Class!" bellows Blather, turning a deepening shade of crimson.

>u
Ensign Blather pushes you roughly back toward your post.

"I said to return to your post, Ensign Seventh Class!" bellows Blather, turning a deepening shade of crimson.

>u
Ensign Blather pushes you roughly back toward your post.

Blather loses his last vestige of patience and drags you to the Feinstein's brig. He throws you in, and the door clangs shut behind you.

The Second Law of Thermodynamics, in one formulation, states that disorganization always increases in the absence of some outside force. A corollary is that things will always break down in the absence of someone to fix them. As a member of the repair corps of Space Station Omicron-5, you're that someone.

Your last assignment of the day, on the SS Usagi, a Space Marines fighting ship, looks routine enough. Fix the microwave and a jammed locker door, and then you're off for the day.

Brig
You are in the Feinstein's brig. Graffiti cover the walls. The cell door to the south is locked.

>z
Time passes.

>z
Time passes.

A massive explosion rocks the ship. Echoes from the explosion resound deafeningly down the halls. The door to port slides open.

[No, no, no. This is hitting too close to home. Better quit and focus on saving the ship.]

Space Station Gangway
This is the pressurized bridge from Space Station Omicron-5 to the SS Usagi. Behind you is the familiar bulk of the huge station, largest outpost of the Space Authority in Deneb Sector. Before you is the aft airlock of the Usagi, beckoning you in.

⇒ Tip: Type "help" to learn about this game, and interactive fiction in general.

* * *

Crash
An Interactive Disaster by Phil Riley
Release 5 / Serial number 220724 / Inform 7 build 6M62 (I6/v6.34 lib 6/12N) SD

Space Station Gangway
This is the pressurized bridge from Space Station Omicron-5 to the SS Usagi. Behind you is the familiar bulk of the huge station, largest outpost of the Space Authority in Deneb Sector. Before you is the aft airlock of the Usagi, beckoning you in.

[Better get a move on], you think.

>polish floor
You can't see any such thing.

>pf
PLANETFALL
Infocom interactive fiction - a science fiction story
Copyright (c) 1983 by Infocom, Inc. All rights reserved.
PLANETFALL is a registered trademark of Infocom, Inc.
Release 39 / Serial number 880501

Another routine day of drudgery aboard the Stellar Patrol Ship Feinstein. This morning's assignment for a certain lowly Ensign Seventh Class: scrubbing the filthy metal deck at the port end of Level Nine. With your Patrol-issue self-contained multi-purpose all-weather scrub brush you shine the floor with a diligence born of the knowledge that at any moment dreaded Ensign First Class Blather, the bane of your shipboard existence, could appear.

>polish floor
You rub the floor.

* * *

Crash
An Interactive Disaster by Phil Riley
Release 5 / Serial number 220724 / Inform 7 build 6M62 (I6/v6.34 lib 6/12N) SD

Space Station Gangway
This is the pressurized bridge from Space Station Omicron-5 to the SS Usagi. Behind you is the familiar bulk of the huge station, largest outpost of the Space Authority in Deneb Sector. Before you is the aft airlock of the Usagi, beckoning you in.

[Better get a move on], you think.

>replace screw
I'm not sure what you're referring to.

* * *

Crash
An Interactive Disaster by Phil Riley
Release 5 / Serial number 220724 / Inform 7 build 6M62 (I6/v6.34 lib 6/12N) SD

Space Station Gangway
This is the pressurized bridge from Space Station Omicron-5 to the SS Usagi. Behind you is the familiar bulk of the huge station, largest outpost of the Space Authority in Deneb Sector. Before you is the aft airlock of the Usagi, beckoning you in.

[Better get a move on], you think.

>s
The only obvious exit is fore.

* * *

>s
Reactor Lobby
The corridor widens here as it nears the main drive area. To starboard is the Ion Reactor that powers the vessel, and aft of here is the Auxiliary Control Room. The corridor continues to port.

Ensign Blather, his uniform immaculate, enters and notices you are away from your post. "Twenty demerits, Ensign Seventh Class!" bellows Blather. "Forty if you're not back on Deck Nine in five seconds!" He curls his face into a hideous mask of disgust at your unbelievable negligence.

>hit blather
Blather removes several of your appendages and internal organs.

    ****  You have died  ****

You stop playing Planetfall. Time to save the ship.

The Second Law of Thermodynamics, in one formulation, states that disorganization always increases in the absence of some outside force. A corollary is that things will always break down in the absence of someone to fix them. As a member of the repair corps of Space Station Omicron-5, you're that someone.

Your last assignment of the day, on the SS Usagi, a Space Marines fighting ship, looks routine enough. Fix the microwave and a jammed locker door, and then you're off for the day.

Space Station Gangway
This is the pressurized bridge from Space Station Omicron-5 to the SS Usagi. Behind you is the familiar bulk of the huge station, largest outpost of the Space Authority in Deneb Sector. Before you is the aft airlock of the Usagi, beckoning you in.

⇒ Tip: Type "help" to learn about this game, and interactive fiction in general.

* * *

Crash
An Interactive Disaster by Phil Riley
Release 5 / Serial number 220724 / Inform 7 build 6M62 (I6/v6.34 lib 6/12N) SD

Space Station Gangway
This is the pressurized bridge from Space Station Omicron-5 to the SS Usagi. Behind you is the familiar bulk of the huge station, largest outpost of the Space Authority in Deneb Sector. Before you is the aft airlock of the Usagi, beckoning you in.

[Better get a move on], you think.

>scenes
Sorry, I don't understand.

>n
Accessibility off.

The Second Law of Thermodynamics, in one formulation, states that disorganization always increases in the absence of some outside force. A corollary is that things will always break down in the absence of someone to fix them. As a member of the repair corps of Space Station Omicron-5, you're that someone.

Your last assignment of the day, on the SS Usagi, a Space Marines fighting ship, looks routine enough. Fix the microwave and a jammed locker door, and then you're off for the day.

Space Station Gangway
This is the pressurized bridge from Space Station Omicron-5 to the SS Usagi. Behind you is the familiar bulk of the huge station, largest outpost of the Space Authority in Deneb Sector. Before you is the aft airlock of the Usagi, beckoning you in.

[Better get a move on], you think.

⇒ Tip: Type "help" to learn about this game, and interactive fiction in general.

* * *

>scenes
Scene 'Entire Game' playing (for 0 mins now)
Scene 'Boarding the Ship' playing (for 0 mins now)
(Scene monitoring now switched on. Type "scenes off" to switch it off again.)

>pf
PLANETFALL
Infocom interactive fiction - a science fiction story
Copyright (c) 1983 by Infocom, Inc. All rights reserved.
PLANETFALL is a registered trademark of Infocom, Inc.
Release 39 / Serial number 880501

Another routine day of drudgery aboard the Stellar Patrol Ship Feinstein. This morning's assignment for a certain lowly Ensign Seventh Class: scrubbing the filthy metal deck at the port end of Level Nine. With your Patrol-issue self-contained multi-purpose all-weather scrub brush you shine the floor with a diligence born of the knowledge that at any moment dreaded Ensign First Class Blather, the bane of your shipboard existence, could appear.

>z
Time passes.

[Scene 'Playing Planetfall' begins]

* * *

>computer, access code 2
Welcome, Master Sergeant R. Mu Arvax. Logging you in.

* * *

>computer, reboot
Beginning reboot. Take all appropriate precautions.

Red alert lights flash throughout the ship.

>ask arvax about asdf
You can't see any such thing.

>ask arvax about arvax
You can't see any such thing.

>z
Time passes.

* * *

>z
Time passes.

Reboot complete.

>ask arvax about arvax
"You're back! Great job rebooting the computer -- I'm getting telemetry now.

"I'm just an old Marine trying to do his duty."

>ask arvax about arvax
"I'm just an old Marine trying to do his duty."

>ask arvax about asdf
"I'm afraid I don't have anything to say about that."

>rules
Rules tracing now switched on. Type "rules off" to switch it off again, or "rules all" to include even rules which do not apply.

[Rule "reset report text rule" applies.]

* * *

>ask arvax about asdf
You can't see any such thing.

>z
Time passes.

* * *

>z
Time passes.

Reboot complete.

>ask arvax about asdf
"You're back! Great job rebooting the computer -- I'm getting telemetry now.

"We don't have time for that!

"I'm trying to divert the ship from its collision course with New Da Nang, but there's a problem: the fuel injection specification for the fusion engine is incorrect.

You add an item ("adjust fuel injection specification") to your to-do list.

>ask arvax about asdf
We don't have time for that!

"I'm trying to divert the ship from its collision course with New Da Nang, but there's a problem: the fuel injection specification for the fusion engine is incorrect.

* * *

>rules
Rules tracing now switched on. Type "rules off" to switch it off again, or "rules all" to include even rules which do not apply.

[Rule "reset report text rule" applies.]

* * *

>ask arvax about asdf
We don't have time for that!

"I'm trying to divert the ship from its collision course with New Da Nang, but there's a problem: the fuel injection specification for the fusion engine is incorrect.

>ask arvax about card
"I'm afraid I don't have anything to say about that."

>i
You are carrying:
  the captain's journal
  a blown fuse
  a copy of Planetfall
  the red access card
  an Universal Game Emulator
  a piece of note paper
  a beacon
  a microwavable dinner
  a knife
  a hex-shaped tool
  a roll of electrical tape
  a small key
  a portable hand-held vacuum cleaner
  a vac suit (being worn)
  a broken sensor
  Bertie the Bear™
  a pair of slippers
  a To-Do list
  a repair corps uniform (being worn) with chewing gum stuck to it
  a toolbox

* * *

>ask arvax about asdf
"You're back! Great job rebooting the computer -- I'm getting telemetry now.

"We don't have time for that!

"I'm trying to divert the ship from its collision course with New Da Nang, but there's a problem: the fuel injection specification for the fusion engine is incorrect.

You add an item ("adjust fuel injection specification") to your to-do list.

>ask arvax about card
"You're back! Great job rebooting the computer -- I'm getting telemetry now.

"I'm afraid I don't have anything to say about that."

>ask arvax about card
"I'm afraid I don't have anything to say about that."

>ask arvax about asdf
"I'm afraid I don't have anything to say about that."

>actions
Actions listing on.

>ask arvax about asdf
[asking Master Sergeant R. Mu Arvax about "asdf"]
"I'm afraid I don't have anything to say about that."
[asking Master Sergeant R. Mu Arvax about "asdf" - ended without result]

>actions off
Actions listing off.

>rules
Rules tracing now switched on. Type "rules off" to switch it off again, or "rules all" to include even rules which do not apply.

[Rule "reset report text rule" applies.]

>ask arvax about asdf
[Rule "After reading a command" applies.]
[Rule "After deciding the scope of the player when the current stuck thing of the chewing gum is not the player" applies.]
[Rule "After deciding the scope of the player when location is Operations" applies.]
[Rule "computer is everywhere rule" applies.]
[Rule "After deciding the scope of the player when the current stuck thing of the chewing gum is not the player" applies.]
[Rule "After deciding the scope of the player when location is Operations" applies.]
[Rule "computer is everywhere rule" applies.]
[Rule "After deciding the scope of the player when the current stuck thing of the chewing gum is not the player" applies.]
[Rule "After deciding the scope of the player when location is Operations" applies.]
[Rule "computer is everywhere rule" applies.]
[Rule "After deciding the scope of the player when the current stuck thing of the chewing gum is not the player" applies.]
[Rule "After deciding the scope of the player when location is Operations" applies.]
[Rule "computer is everywhere rule" applies.]
[Rule "After deciding the scope of the player when the current stuck thing of the chewing gum is not the player" applies.]
[Rule "After deciding the scope of the player when location is Operations" applies.]
[Rule "computer is everywhere rule" applies.]
[Rule "After deciding the scope of the player when the current stuck thing of the chewing gum is not the player" applies.]
[Rule "After deciding the scope of the player when location is Operations" applies.]
[Rule "computer is everywhere rule" applies.]
[Rule "After deciding the scope of the player when the current stuck thing of the chewing gum is not the player" applies.]
[Rule "After deciding the scope of the player when location is Operations" applies.]
[Rule "computer is everywhere rule" applies.]
[Rule "After deciding the scope of the player when the current stuck thing of the chewing gum is not the player" applies.]
[Rule "After deciding the scope of the player when location is Operations" applies.]
[Rule "computer is everywhere rule" applies.]
[Rule "declare everything initially unmentioned rule" applies.]
[Rule "announce items from multiple object lists rule" applies.]
[Rule "set pronouns from items from multiple object lists rule" applies.]
[Rule "before stage rule" applies.]
[Rule "Before asking someone about a topic" applies.]
"I'm afraid I don't have anything to say about that."

[Rule "A first turn sequence rule" applies.]
[Rule "post-report rule" applies.]
[Rule "every turn stage rule" applies.]
[Rule "Every turn when ( not talking about asking mulgrew questions ) and computer-rebooting is false and protocols-in-progress is false and last-moves is false" applies.]
[Rule "reset protocol rule" applies.]
[Rule "Every turn" applies.]
[Rule "close open doors rule" applies.]
[Rule "A last turn sequence rule" applies.]
[Rule "notify score changes rule" applies.]
[Rule "reset report text rule" applies.]

* * *

>ask arvax about asdf
"You're back! Great job rebooting the computer -- I'm getting telemetry now.

"We don't have time for that!

"I'm trying to divert the ship from its collision course with New Da Nang, but there's a problem: the fuel injection specification for the fusion engine is incorrect.

You add an item ("adjust fuel injection specification") to your to-do list.

>ask arvax about help
"I'm trying to divert the ship from its collision course with New Da Nang, but there's a problem: the fuel injection specification for the fusion engine is incorrect.

* * *

>ask arvax about asdf
"You're back! Great job rebooting the computer -- I'm getting telemetry now.

"We don't have time for that!

"I'm trying to divert the ship from its collision course with New Da Nang, but there's a problem: the fuel injection specification for the fusion engine is incorrect.

You add an item ("adjust fuel injection specification") to your to-do list.

>ask arvax about ship
(the SS Usagi)
"I'm trying to divert the ship from its collision course with New Da Nang, but there's a problem: the fuel injection specification for the fusion engine is incorrect.

>ask arvax about mulgrew
"We don't have time for that!

"I'm trying to divert the ship from its collision course with New Da Nang, but there's a problem: the fuel injection specification for the fusion engine is incorrect.

>restart
Are you sure you want to restart?

>y
Crash
An Interactive Disaster by Phil Riley
Release 5 / Serial number 220724 / Inform 7 build 6M62 (I6/v6.34 lib 6/12N) SD

Space Station Gangway
This is the pressurized bridge from Space Station Omicron-5 to the SS Usagi. Behind you is the familiar bulk of the huge station, largest outpost of the Space Authority in Deneb Sector. Before you is the aft airlock of the Usagi, beckoning you in.

[Better get a move on], you think.

* * *

>hello
There's no one here but you.

Your vac suit pings gently to indicate you have expended a unit of air.

>z
Time passes.

Your vac suit pings gently to indicate you have expended a unit of air.

The depressurization siren stops.

>z
Time passes.

Emergency protocols complete.

Approaching New Da Nang. Beginning emergency countdown at 60.

>ask arvax about lima beans
"Finally! Where've you been? I'm sad to see you invoked Mulgrew's emergency protocols, but that's water under the bridge. Now we need to try to salvage the situation.

"I'm trying to divert the ship from its collision course with New Da Nang, but there are some problems: the helm is not responding to any commands and the fuel injection specification for the fusion engine is incorrect. 

"To be honest, friend, the readouts I'm seeing about the state of helm control are dire. I'm not sure it can be fixed."

"We don't have time for that!

"I'm trying to divert the ship from its collision course with New Da Nang, but there are some problems: the helm is not responding to any commands and the fuel injection specification for the fusion engine is incorrect. 

"To be honest, friend, the readouts I'm seeing about the state of helm control are dire. I'm not sure it can be fixed."

* * *

>ask arvax about asdf
"You're back! Great job rebooting the computer -- I'm getting telemetry now.

"We don't have time for that!

"I'm trying to divert the ship from its collision course with New Da Nang, but there's a problem: the fuel injection specification for the fusion engine is incorrect.

You add an item ("adjust fuel injection specification") to your to-do list.

>rules
Rules tracing now switched on. Type "rules off" to switch it off again, or "rules all" to include even rules which do not apply.

[Rule "reset report text rule" applies.]

>scenes
[Rule "After reading a command" applies.]
[Rule "declare everything initially unmentioned rule" applies.]
Scene 'Entire Game' playing (for 143 mins now)
Scene 'End Game' playing (for 1 mins now)
Scene 'Playing Planetfall' ended
Scene 'Boarding the Ship' ended
(Scene monitoring now switched on. Type "scenes off" to switch it off again.)

[Rule "reset report text rule" applies.]

>ask arvax about asdf
[Rule "After reading a command" applies.]
[Rule "After deciding the scope of the player when the current stuck thing of the chewing gum is not the player" applies.]
[Rule "After deciding the scope of the player when location is Operations" applies.]
[Rule "computer is everywhere rule" applies.]
[Rule "After deciding the scope of the player when the current stuck thing of the chewing gum is not the player" applies.]
[Rule "After deciding the scope of the player when location is Operations" applies.]
[Rule "computer is everywhere rule" applies.]
[Rule "After deciding the scope of the player when the current stuck thing of the chewing gum is not the player" applies.]
[Rule "After deciding the scope of the player when location is Operations" applies.]
[Rule "computer is everywhere rule" applies.]
[Rule "After deciding the scope of the player when the current stuck thing of the chewing gum is not the player" applies.]
[Rule "After deciding the scope of the player when location is Operations" applies.]
[Rule "computer is everywhere rule" applies.]
[Rule "After deciding the scope of the player when the current stuck thing of the chewing gum is not the player" applies.]
[Rule "After deciding the scope of the player when location is Operations" applies.]
[Rule "computer is everywhere rule" applies.]
[Rule "After deciding the scope of the player when the current stuck thing of the chewing gum is not the player" applies.]
[Rule "After deciding the scope of the player when location is Operations" applies.]
[Rule "computer is everywhere rule" applies.]
[Rule "After deciding the scope of the player when the current stuck thing of the chewing gum is not the player" applies.]
[Rule "After deciding the scope of the player when location is Operations" applies.]
[Rule "computer is everywhere rule" applies.]
[Rule "After deciding the scope of the player when the current stuck thing of the chewing gum is not the player" applies.]
[Rule "After deciding the scope of the player when location is Operations" applies.]
[Rule "computer is everywhere rule" applies.]
[Rule "declare everything initially unmentioned rule" applies.]
[Rule "announce items from multiple object lists rule" applies.]
[Rule "set pronouns from items from multiple object lists rule" applies.]
[Rule "before stage rule" applies.]
[Rule "Before asking someone about a topic" applies.]
"I'm afraid I don't have anything to say about that."

[Rule "A first turn sequence rule" applies.]
[Rule "post-report rule" applies.]
[Rule "every turn stage rule" applies.]
[Rule "Every turn when ( not talking about asking mulgrew questions ) and computer-rebooting is false and protocols-in-progress is false and last-moves is false" applies.]
[Rule "reset protocol rule" applies.]
[Rule "Every turn" applies.]
[Rule "close open doors rule" applies.]
[Rule "A last turn sequence rule" applies.]
[Rule "notify score changes rule" applies.]
[Rule "reset report text rule" applies.]

* * *

>d
You get off the top bunk.

Starboard-Side Crew Quarters
All crew members who aren't the captain sleep in this or the opposite-side bunk room. This one sleeps two in a bunk bed, done up with military precision. There is a large cabinet here, stretching almost to the ceiling. It is closed. Mounted in the wall is a crew personal storage unit. The sole exit is to port.

In a shocking lapse of military precision, there is a sticky note attached to the bed post.

You can also see a cardboard box (empty) and some wrapping paper here.

>i
You are carrying:
  a knife
  a fresh fuse
  a hex-shaped tool
  a roll of electrical tape
  a small key
  a portable hand-held vacuum cleaner
  a vac suit (being worn)
  a broken sensor
  Bertie the Bear™
  a pair of slippers
  a To-Do list
  a repair corps uniform (being worn) with chewing gum stuck to it
  a toolbox

>p
Junction
This is a busy place when the ship is populated. To port and starboard are the crew quarters, aft is the closed door to the captain's private quarters, and fore is the galley. A ladder leads down to the staging area.

* * *

>open cabinet
You open the port-side equipment cabinet, revealing an engineering uniform and an Universal Game Emulator.

>take universal
Taken.

>x universal
This device, the Universal Game Emulator, or "UGE", can play any game ever produced for any system.

>uge, zork
You can't talk to the Universal Game Emulator.

>x unit
The storage unit consists of top and bottom drawers, with an attached keypad and display. There is a keyhole under the keypad. Both drawers are closed.

>i
You are carrying:
  an Universal Game Emulator
  a knife
  a fresh fuse
  a hex-shaped tool
  a roll of electrical tape
  a small key
  a portable hand-held vacuum cleaner
  a vac suit (being worn)
  a broken sensor
  Bertie the Bear™
  a pair of slippers
  a To-Do list
  a repair corps uniform (being worn) with chewing gum stuck to it
  a toolbox

>open unit
That can only be opened by typing the correct code on the keypad.

>x keypad
A standard 0-9 keypad with a "*" and "#". Below the keys is a small keyhole.

>open keyhole
You can't see any such thing.

>put key in keyhole
You can't see any such thing.

>unlock keypad with key
You open the front panel of the keypad, revealing a bundle of wiring.

>x wiring
You can't see any such thing.

>type on keypad
You need to close the keypad before you can type on it.

>close keypad
You close the keypad.

>x keypad
A standard 0-9 keypad with a "*" and "#". Below the keys is a small keyhole.

>type 0000 on keypad
As you press a key, the storage unit starts buzzing continuously. The display lights up with random characters, and you smell the distinct odor of burning wires. The bottom storage drawer pops out a centimeter or two.

You add an item ("fix the storage unit") to your to-do list.

>put fork in drawer
You can't see any such thing.

>open drawer with knife
Which do you mean, the top drawer or the bottom drawer?

>bottom
You wedge the knife into the seam and lever the drawer open.

The bottom drawer is labeled "Khotpanya". It is open and contains the red access card.

>take card
Taken.

>ask computer about khotpanya
I'm unable to give you any information about khotpanya.

>close drawer
Which do you mean, the top drawer or the bottom drawer?

>bototm
You can't see any such thing.

>close bototm
You can't see any such thing.

>close bottom
You close the bottom drawer.

>i
You are carrying:
  the red access card
  an Universal Game Emulator
  a knife
  a fresh fuse
  a hex-shaped tool
  a roll of electrical tape
  a small key
  a portable hand-held vacuum cleaner
  a vac suit (being worn)
  a broken sensor
  Bertie the Bear™
  a pair of slippers
  a To-Do list
  a repair corps uniform (being worn) with chewing gum stuck to it
  a toolbox

>open cabinet
That's already open.

>x cabinet
A simple black-painted steel cabinet, open and contains an engineering uniform.

In the port-side equipment cabinet is an engineering uniform.

>take uniform
(the repair corps uniform)
You already have that.

>take engineering uniform
Taken.

>x uniform
Which do you mean, the engineering uniform or the repair corps uniform?

>engineering
Colored the traditional mustard yellow of Engineering, it's really a remarkably ugly uniform.

In the engineering uniform is a piece of note paper.

>take paper
Taken.

>read paper
Scribbled on the paper is the number 9467.

>type 9467 in keypad
I didn't understand that sentence.

>type 9467 on keypad
The storage unit seems to be broken.

>open keypad with key
You open the front panel of the keypad, revealing a bundle of wiring. You can see the problem immediately -- two wires with worn insulation are in contact, causing a short-circuit.

>i
You are carrying:
  a piece of note paper
  an engineering uniform
  the red access card
  an Universal Game Emulator
  a knife
  a fresh fuse
  a hex-shaped tool
  a roll of electrical tape
  a small key
  a portable hand-held vacuum cleaner
  a vac suit (being worn)
  a broken sensor
  Bertie the Bear™
  a pair of slippers
  a To-Do list
  a repair corps uniform (being worn) with chewing gum stuck to it
  a toolbox

>put gum on wires
(first removing the chewing gum from the repair corps uniform)
You stick the chewing gum to the wires.

>x wires
Two of the wires are crossed, leading to a short circuit.

Some chewing gum is stuck to the wires.

>take gum
You unstick the chewing gum from the wires.

>i
You are carrying:
  some used chewing gum
  a piece of note paper
  an engineering uniform
  the red access card
  an Universal Game Emulator
  a knife
  a fresh fuse
  a hex-shaped tool
  a roll of electrical tape
  a small key
  a portable hand-held vacuum cleaner
  a vac suit (being worn)
  a broken sensor
  Bertie the Bear™
  a pair of slippers
  a To-Do list
  a repair corps uniform (being worn)
  a toolbox

The chewing gum has become stuck to the small key.

>fix wires with tape
I only understood you as far as wanting to fix the wires.

>tape wires
You wrap the wires in electrical tape and close the keypad.

You cross out an item ("fix the storage unit") on your to-do list.

[Your score has just gone up by one point.]

>close keypad
That's already closed.

>type 9647
I didn't understand that sentence.

>type 9467 on keypad
The top drawer slides open, revealing a copy of Planetfall.

>take planetfall
Taken.

>x planetfall
It's amazing that this still exists. A copy of the interactive fiction classic on 5.25" floppy disk for the Apple II.

>x gme
You can't see any such thing.

>i
You are carrying:
  a copy of Planetfall
  a piece of note paper
  an engineering uniform
  the red access card
  an Universal Game Emulator
  a knife
  a fresh fuse
  a hex-shaped tool
  a roll of electrical tape
  a small key with chewing gum stuck to it
  a portable hand-held vacuum cleaner
  a vac suit (being worn)
  a broken sensor
  Bertie the Bear™
  a pair of slippers
  a To-Do list
  a repair corps uniform (being worn)
  a toolbox

>x uge
This device, the Universal Game Emulator, or "UGE", can play any game ever produced for any system.

>turn on uge
It isn't something you can switch.

>play planetfall on uge
PLANETFALL
Infocom interactive fiction - a science fiction story
Copyright (c) 1983 by Infocom, Inc. All rights reserved.
PLANETFALL is a registered trademark of Infocom, Inc.
Release 39 / Serial number 880501

Another routine day of drudgery aboard the Stellar Patrol Ship Feinstein. This morning's assignment for a certain lowly Ensign Seventh Class: scrubbing the filthy metal deck at the port end of Level Nine. With your Patrol-issue self-contained multi-purpose all-weather scrub brush you shine the floor with a diligence born of the knowledge that at any moment dreaded Ensign First Class Blather, the bane of your shipboard existence, could appear.

>l
Deck Nine
This is a featureless corridor similar to every other corridor on the ship. It curves away to starboard, and a gangway leads up. To port is the entrance to one of the ship's primary escape pods. The pod bulkhead is closed.

>p
The escape pod bulkhead is closed.

The alien ambassador from the planet Blow'k-bibben-Gordo ambles toward you from down the corridor. He is munching on something resembling an enormous stalk of celery, and he leaves a trail of green slime on the deck. He stops nearby, and you wince as a pool of slime begins forming beneath him on your newly-polished deck. The ambassador wheezes loudly and hands you a brochure outlining his planet's major exports.

>take celery
You can't see any such thing.

>talk to ambassador
You say hello to the alien ambassador.

The ambassador asks where Admiral Smithers can be found.

>tell ambassador north
I'm not sure what you're trying to say. I might just not recognize the words you're using.

The ambassador asks if you are performing some sort of religious ceremony.

>i
You are carrying:
  a brochure
  a Patrol uniform (being worn)
    an ID card
  a chronometer (being worn)
  a Patrol-issue self-contained multi-purpose scrub brush

The ambassador inquires whether you are interested in a game of Bocci.

>yes
The ambassador grunts a polite farewell, and disappears up the gangway, leaving a trail of dripping slime.

>x chronometer
It is a standard wrist chronometer with a digital display. According to the chronometer, the current time is 4778. The back is engraved with the message "Good luck in the Patrol! Love, Mom and Dad."

>turn off UGE
You can't see any such thing.

>leave planetfall
I only understood you as far as wanting to leave.

>quit
You stop playing Planetfall. Time to save the ship.

Port-Side Crew Quarters
All crew members who aren't the captain sleep in this or the opposite-side bunk room. This one sleeps two in a bunk bed, done up with military precision. There is a large cabinet here, stretching almost to the ceiling. It is open and empty. Mounted in the wall is a crew personal storage unit. The sole exit is to starboard.

>play planetfall on uge
PLANETFALL
Infocom interactive fiction - a science fiction story
Copyright (c) 1983 by Infocom, Inc. All rights reserved.
PLANETFALL is a registered trademark of Infocom, Inc.
Release 39 / Serial number 880501

Another routine day of drudgery aboard the Stellar Patrol Ship Feinstein. This morning's assignment for a certain lowly Ensign Seventh Class: scrubbing the filthy metal deck at the port end of Level Nine. With your Patrol-issue self-contained multi-purpose all-weather scrub brush you shine the floor with a diligence born of the knowledge that at any moment dreaded Ensign First Class Blather, the bane of your shipboard existence, could appear.

A massive explosion rocks the ship. Echoes from the explosion resound deafeningly down the halls. The door to port slides open.

[No, no, no. This is hitting too close to home. Better quit and focus on saving the ship.]

Port-Side Crew Quarters
All crew members who aren't the captain sleep in this or the opposite-side bunk room. This one sleeps two in a bunk bed, done up with military precision. There is a large cabinet here, stretching almost to the ceiling. It is open and empty. Mounted in the wall is a crew personal storage unit. The sole exit is to starboard.

* * *

>computer, help
Helpful commands: 

 - ask computer about <subject>
 - computer, emergency protocols: activates the ship's emergency protocols (needs authorization)
 - computer, reboot: restarts all ship functions (needs authorization)
 - computer, access code <code>: authorizes user

You hear someone speaking above.

>computer, access code 3
Welcome, Captain Jane Mulgrew. Logging you in.

>computer, help
Helpful commands: 

 - ask computer about <subject>
 - computer, emergency protocols: activates the ship's emergency protocols (needs authorization)
 - computer, reboot: restarts all ship functions (needs authorization)
 - computer, access code <code>: authorizes user

You hear someone speaking above.

>computer, access code 2
Welcome, caller. Logging you in.

>computer, help
I'm unable to give you any information about the shipboard computer.

You hear someone speaking above.

>ask computer about computer
I'm unable to give you any information about the shipboard computer.

>actions
Actions listing on.

>ask computer about computer
[quizzing the shipboard computer about the shipboard computer]

I'm unable to give you any information about the shipboard computer.
[quizzing the shipboard computer about the shipboard computer - succeeded]

You hear someone speaking above.

* * *

>f
The obvious exits are aft (to junction) and up (to operations deck).

You hear someone speaking above.

>p
The obvious exits are aft (to junction) and up (to operations deck).

>a
Junction
This is a busy place when the ship is populated. To port and starboard are the crew quarters, aft is the closed door to the captain's private quarters, and fore is the galley. A ladder leads down to the staging area.

* * *

>s
Junction
This is a busy place when the ship is populated. To port and starboard are the crew quarters, aft is the closed door to the captain's private quarters, and fore is the galley. A ladder leads down to the staging area.

>s
Starboard-Side Crew Quarters
All crew members who aren't the captain sleep in this or the opposite-side bunk room. This one sleeps two in a bunk bed, done up with military precision. There is a large cabinet here, stretching almost to the ceiling. It is closed. Mounted in the wall is a crew personal storage unit. The sole exit is to port.

In a shocking lapse of military precision, there is a sticky note attached to the bed post.

You can also see a cardboard box (empty) and some wrapping paper here.

>x cabinet
A simple black-painted steel cabinet, open and contains an engineering uniform and an Universal Game Emulator.

* * *

>play planetfall on UGE
[No, I have more important things to do than playing that again.]

PLANETFALL
Infocom interactive fiction - a science fiction story
Copyright (c) 1983 by Infocom, Inc. All rights reserved.
PLANETFALL is a registered trademark of Infocom, Inc.
Release 39 / Serial number 880501

Another routine day of drudgery aboard the Stellar Patrol Ship Feinstein. This morning's assignment for a certain lowly Ensign Seventh Class: scrubbing the filthy metal deck at the port end of Level Nine. With your Patrol-issue self-contained multi-purpose all-weather scrub brush you shine the floor with a diligence born of the knowledge that at any moment dreaded Ensign First Class Blather, the bane of your shipboard existence, could appear.

* * *

>d
Staging Area
This is the staging area of the ship, where marines prepare for missions. It is adjacent to the aft airlock. Locked compartments set into the walls hold various munitions. A ladder leads up into the rest of the ship. 

An equipment locker is sprawled across the room, with its door to the ground.
 
Through the airlock windows you see the blank space left by the destruction of Space Station Omicron-5.

What looks like part of an engine is stowed in a corner.

You can also see a black trunk (closed) here.

>open locker
The locker has fallen door-side down.

>turn over locker
You turn over the locker. Now it's door-side-up.

>open locker
You open the vac suit locker, revealing four banged-up vac suits.

A massive explosion rocks the ship. Echoes from the explosion resound deafeningly down the halls.

[No, no, no. This is hitting too close to home. Better quit and focus on saving the ship.]

Staging Area
This is the staging area of the ship, where marines prepare for missions. It is adjacent to the aft airlock. Locked compartments set into the walls hold various munitions. A ladder leads up into the rest of the ship. 

An equipment locker is sprawled across the room. It has been turned door-side up. It is open and contains four banged-up vac suits.
 
Through the airlock windows you see the blank space left by the destruction of Space Station Omicron-5.

What looks like part of an engine is stowed in a corner.

You can also see a black trunk (closed) here.

* * *

>z
Time passes.

A massive explosion rocks the ship. Echoes from the explosion resound deafeningly down the halls.
 The door to port slides open.

[No, no, no. This is hitting too close to home. Better quit and focus on saving the ship.]

Port-Side Crew Quarters
All crew members who aren't the captain sleep in this or the opposite-side bunk room. This one sleeps two in a bunk bed, done up with military precision. There is a large cabinet here, stretching almost to the ceiling. It is open and contains an engineering uniform. Mounted in the wall is a crew personal storage unit. The sole exit is to starboard.

>pf
PLANETFALL
Infocom interactive fiction - a science fiction story
Copyright (c) 1983 by Infocom, Inc. All rights reserved.
PLANETFALL is a registered trademark of Infocom, Inc.
Release 39 / Serial number 880501

Another routine day of drudgery aboard the Stellar Patrol Ship Feinstein. This morning's assignment for a certain lowly Ensign Seventh Class: scrubbing the filthy metal deck at the port end of Level Nine. With your Patrol-issue self-contained multi-purpose all-weather scrub brush you shine the floor with a diligence born of the knowledge that at any moment dreaded Ensign First Class Blather, the bane of your shipboard existence, could appear.

* * *

>s
Junction
This is a busy place when the ship is populated. To port and starboard are the crew quarters, aft is the closed door to the captain's private quarters, and fore is the galley. A ladder leads down to the staging area.

* * *

>open locker
The locker has fallen door-side down.

>turn it over
You turn over the locker. Now it's door-side-up.

>open it
You open the vac suit locker, revealing four banged-up vac suits.

>undo
Staging Area
[Previous turn undone.]

>undo
Staging Area
[Previous turn undone.]

>turn over locker
You turn over the locker. Now it's door-side-up.

* * *

>z
Time passes.

Your vac suit pings gently to indicate you have expended a unit of air.

* * *

>z
Time passes.

Emergency protocols complete.

Approaching New Da Nang. Beginning emergency countdown at 60.

>z
Time passes.

>ask arvax about jkldfsjklsfd
"Finally! Where've you been? I'm sad to see you invoked Mulgrew's emergency protocols, but that's water under the bridge. Now we need to try to salvage the situation."

"We don't have time for that!

"I'm trying to divert the ship from its collision course with New Da Nang, but there are some problems: the helm is not responding to any commands and the fuel injection specification for the fusion engine is incorrect. 

"To be honest, friend, the readouts I'm seeing about the state of helm control are dire. I'm not sure it can be fixed."

>undo
Operations Deck
[Previous turn undone.]

>rules
Rules tracing now switched on. Type "rules off" to switch it off again, or "rules all" to include even rules which do not apply.

[Rule "reset report text rule" applies.]

* * *

>undo
Operations Deck
[Previous turn undone.]

>rules off
[Rule "After reading a command" applies.]
[Rule "declare everything initially unmentioned rule" applies.]
Rules tracing now switched off. Type "rules" to switch it on again.

>actions
Actions listing on.

>ask arvax about jkldfsjklsfd
[asking Master Sergeant R. Mu Arvax about "jkldfsjklsfd"]
[(1) saying hello to Master Sergeant R. Mu Arvax]
"Finally! Where've you been? I'm sad to see you invoked Mulgrew's emergency protocols, but that's water under the bridge. Now we need to try to salvage the situation."
[(1) saying hello to Master Sergeant R. Mu Arvax - succeeded]

"We don't have time for that!

[(1) quizzing Master Sergeant R. Mu Arvax about the SS Usagi]
"I'm trying to divert the ship from its collision course with New Da Nang, but there are some problems: the helm is not responding to any commands and the fuel injection specification for the fusion engine is incorrect. 

"To be honest, friend, the readouts I'm seeing about the state of helm control are dire. I'm not sure it can be fixed."
[(1) quizzing Master Sergeant R. Mu Arvax about the SS Usagi - succeeded]

[asking Master Sergeant R. Mu Arvax about "jkldfsjklsfd" - succeeded]

>hello
[hailing]
You are already talking to Master Sergeant R. Mu Arvax.
[hailing - failed the check what's being hailed rule]

* * *

Crash
An Interactive Disaster by Phil Riley
Release 5 / Serial number 220724 / Inform 7 build 6M62 (I6/v6.34 lib 6/12N) SD

Space Station Gangway
This is the pressurized bridge from Space Station Omicron-5 to the SS Usagi. Behind you is the familiar bulk of the huge station, largest outpost of the Space Authority in Deneb Sector. Before you is the aft airlock of the Usagi, beckoning you in.

[Better get a move on], you think.

>test spacewa;l
>--> The following tests are available:
'test airlock'
'test spacewalk'
'test microwave'
'test cabinet'
'test storage'
'test planetfall'
'test staging'
'test tether'
'test captain'
'test arvax'
'test win'
'test protocols'
'test explode'
'test nobly'
'test escape'

* * *

>p
Machine Room
The machine room is where the physical work of Engineering takes place; for instance, machining new parts. There is a large counter lined with drawers here, as well as numerous saws, drills, and other pieces of equipment. You can leave to starboard.

There's a hand vac sitting on the counter.

>take vac
You already have that.

* * *

>f
Operations Deck
This is where all of the support activity for the bridge occurs. There are large consoles for environmental controls, communications, and power systems here. The bridge continues forward from here, and engineering is aft. There is a door set in the floor with a ladder leading through it. Set in the frame of the door is a blue button.

A large equipment trunk lies on the midship door, blocking it.

A man's voice comes over comms: "Come in, Usagi, Come in, Usagi."

[Finally, another person! I'm saved!]

⇒ By the way... you can get help about speaking to other characters by typing "help speech".

⇒ You might try saying hello.

>take trunk
The trunk is far too heavy to lift by yourself.

>x trunk
It's a large black trunk with an electronic lock. You need the correct code to open it.

A man's voice comes over comms: "Usagi, are you there?"

>take it
Really, the equipment trunk isn't important to the story. But by all means, continue to fiddle with it.

>undo
Operations Deck
[Previous turn undone.]

>push it
You push the trunk clear of the door.

* * *

>p
Machine Room
The machine room is where the physical work of Engineering takes place; for instance, machining new parts. There is a large counter lined with drawers here, as well as numerous saws, drills, and other pieces of equipment. You can leave to starboard.

There's a hand vac sitting on the counter.

>x drawers
Under the counter is a row of drawers which are closed.

>open them
You open the machine room drawers, revealing a small key, a roll of electrical tape, a hex-shaped tool, and a fresh fuse.

>close it
You can't see 'it' (nothing) at the moment.

>close them
You close the machine room drawers.

* * *

>p
Machine Room
The machine room is where the physical work of Engineering takes place; for instance, machining new parts. There is a large counter lined with drawers here, as well as numerous saws, drills, and other pieces of equipment. You can leave to starboard.

There's a hand vac sitting on the counter.

>open drawer
You open the machine room drawers, revealing a small key, a roll of electrical tape, a hex-shaped tool, and a fresh fuse.

>take tool
Taken.

>s
Engineering Deck
The engineering crew is responsible for keeping the physical ship operating. They are in charge of every physical aspect of the ship, from the engines to hull integrity to the life support system.

The engineering deck consists of a large console giving a comprehensive view of the physical status of the ship. There is an airlock to starboard. The operations deck continues forward from here, and there are other exits to aft and port.

A device labeled "Suit Recharging Station" is here. It is shaped like a chair with nozzles protruding from either arm.

>f
Operations Deck
This is where all of the support activity for the bridge occurs. There are large consoles for environmental controls, communications, and power systems here. The bridge continues forward from here, and engineering is aft. There is a door set in the floor with a ladder leading through it. Set in the frame of the door is a blue button.

A large equipment trunk lies on the midship door, blocking it.

A man's voice comes over comms: "SS Usagi, come in! Is anyone there?"

[Finally, another person! I'm saved!]

⇒ By the way... you can get help about speaking to other characters by typing "help speech".

⇒ You might try saying hello.

>f
Bridge
This is where the captain, navigator, and pilot all sit. Large viewscreens give a full view of the space around the ship. To port you can see the huge blue-white disk of Deneb. Astern you can faintly see the fading embers of what was Space Station Omicron-5.

 The pilot's and navigator's chairs sit before their respective consoles. The captain's chair, with command console, sits halfway between them and operations further aft.

>x pilot's console
The pilot's console is a sloped table covered with cryptic readouts and touch controls. In the back is an access panel which is closed. A hex-shaped aperture is probably the locking mechanism.

You hear someone speaking aft of here.

>put tool in keyhole
You unlock the pilot's access panel.

>open it
It isn't something you can open.

You hear someone speaking aft of here.

* * *

>play it
(on the Universal Game Emulator)
PLANETFALL
Infocom interactive fiction - a science fiction story
Copyright (c) 1983 by Infocom, Inc. All rights reserved.
PLANETFALL is a registered trademark of Infocom, Inc.
Release 39 / Serial number 880501

Another routine day of drudgery aboard the Stellar Patrol Ship Feinstein. This morning's assignment for a certain lowly Ensign Seventh Class: scrubbing the filthy metal deck at the port end of Level Nine. With your Patrol-issue self-contained multi-purpose all-weather scrub brush you shine the floor with a diligence born of the knowledge that at any moment dreaded Ensign First Class Blather, the bane of your shipboard existence, could appear.

>quit
You stop playing Planetfall. Time to save the ship.

Port-Side Crew Quarters
All crew members who aren't the captain sleep in this or the opposite-side bunk room. This one sleeps two in a bunk bed, done up with military precision. There is a large cabinet here, stretching almost to the ceiling. It is open and contains an engineering uniform. Mounted in the wall is a crew personal storage unit. The sole exit is to starboard.

>restart
Are you sure you want to restart?

* * *

>play planetfall
(on the Universal Game Emulator)
PLANETFALL
Infocom interactive fiction - a science fiction story
Copyright (c) 1983 by Infocom, Inc. All rights reserved.
PLANETFALL is a registered trademark of Infocom, Inc.
Release 39 / Serial number 880501

Another routine day of drudgery aboard the Stellar Patrol Ship Feinstein. This morning's assignment for a certain lowly Ensign Seventh Class: scrubbing the filthy metal deck at the port end of Level Nine. With your Patrol-issue self-contained multi-purpose all-weather scrub brush you shine the floor with a diligence born of the knowledge that at any moment dreaded Ensign First Class Blather, the bane of your shipboard existence, could appear.

>undo
Port-Side Crew Quarters
[Previous turn undone.]

>i
You are carrying:
  a copy of Planetfall
  the red access card
  an Universal Game Emulator
  a piece of note paper
  a beacon
  a knife
  a fresh fuse
  a hex-shaped tool
  a roll of electrical tape
  a small key
  a portable hand-held vacuum cleaner
  a vac suit (being worn)
  a broken sensor
  Bertie the Bear™
  a pair of slippers
  a To-Do list
  a repair corps uniform (being worn) with chewing gum stuck to it
  a toolbox

>put UGE in cabinet
You put the Universal Game Emulator into the port-side equipment cabinet.

>close it
It isn't something you can close.

>close cabinet
You close the port-side equipment cabinet.

>play planetfall
You have nothing to play that on.

* * *

>x slime
What slime?

>s
Reactor Lobby
The corridor widens here as it nears the main drive area. To starboard is the Ion Reactor that powers the vessel, and aft of here is the Auxiliary Control Room. The corridor continues to port.

Ensign Blather, his uniform immaculate, enters and notices you are away from your post. "Twenty demerits, Ensign Seventh Class!" bellows Blather. "Forty if you're not back on Deck Nine in five seconds!" He curls his face into a hideous mask of disgust at your unbelievable negligence.

>hit blather
Blather removes several of your appendages and internal organs.

    ****  You have died  ****

[Ouch. I hope that's not prescient.]

You stop playing Planetfall. Time to save the ship.

Port-Side Crew Quarters
All crew members who aren't the captain sleep in this or the opposite-side bunk room. This one sleeps two in a bunk bed, done up with military precision. There is a large cabinet here, stretching almost to the ceiling. It is open and contains an engineering uniform. Mounted in the wall is a crew personal storage unit. The sole exit is to starboard.

>play planetfall
(on the Universal Game Emulator)
[No, I have more important things to do than playing that again.]

>pf
PLANETFALL
Infocom interactive fiction - a science fiction story
Copyright (c) 1983 by Infocom, Inc. All rights reserved.
PLANETFALL is a registered trademark of Infocom, Inc.
Release 39 / Serial number 880501

Another routine day of drudgery aboard the Stellar Patrol Ship Feinstein. This morning's assignment for a certain lowly Ensign Seventh Class: scrubbing the filthy metal deck at the port end of Level Nine. With your Patrol-issue self-contained multi-purpose all-weather scrub brush you shine the floor with a diligence born of the knowledge that at any moment dreaded Ensign First Class Blather, the bane of your shipboard existence, could appear.

>quit
You stop playing Planetfall. Time to save the ship.

Port-Side Crew Quarters
All crew members who aren't the captain sleep in this or the opposite-side bunk room. This one sleeps two in a bunk bed, done up with military precision. There is a large cabinet here, stretching almost to the ceiling. It is open and contains an engineering uniform. Mounted in the wall is a crew personal storage unit. The sole exit is to starboard.

>pf
PLANETFALL
Infocom interactive fiction - a science fiction story
Copyright (c) 1983 by Infocom, Inc. All rights reserved.
PLANETFALL is a registered trademark of Infocom, Inc.
Release 39 / Serial number 880501

Another routine day of drudgery aboard the Stellar Patrol Ship Feinstein. This morning's assignment for a certain lowly Ensign Seventh Class: scrubbing the filthy metal deck at the port end of Level Nine. With your Patrol-issue self-contained multi-purpose all-weather scrub brush you shine the floor with a diligence born of the knowledge that at any moment dreaded Ensign First Class Blather, the bane of your shipboard existence, could appear.

>s
Ensign Blather blocks your way, snarling angrily.

"I said to return to your post, Ensign Seventh Class!" bellows Blather, turning a deepening shade of crimson.

>x blather
Ensign Blather is a tall, beefy officer with a tremendous, misshapen nose. His uniform is perfect in every respect, and the crease in his trousers could probably slice diamonds in half.

"I said to return to your post, Ensign Seventh Class!" bellows Blather, turning a deepening shade of crimson.

>taste him
You taste nothing unexpected.

"I said to return to your post, Ensign Seventh Class!" bellows Blather, turning a deepening shade of crimson.

>x him
Ensign Blather is a tall, beefy officer with a tremendous, misshapen nose. His uniform is perfect in every respect, and the crease in his trousers could probably slice diamonds in half.

Blather loses his last vestige of patience and drags you to the Feinstein's brig. He throws you in, and the door clangs shut behind you.

Brig
You are in the Feinstein's brig. Graffiti cover the walls. The cell door to the south is locked.

>open door
You can't see any such thing.

* * *

>x copy
It's amazing that this still exists. A copy of the interactive fiction classic on 5.25" floppy disk for the Apple II.

* * *

>x planetfall
It's amazing that this still exists. A copy of the interactive fiction classic on 5.25" floppy disk for the Apple II.
[What? No feelies?]

>x planetfall
It's amazing that this still exists. A copy of the interactive fiction classic on 5.25" floppy disk for the Apple II.

* * *

Crash
An Interactive Disaster by Phil Riley
Release 5 / Serial number 220724 / Inform 7 build 6M62 (I6/v6.34 lib 6/12N) SD

Space Station Gangway
This is the pressurized bridge from Space Station Omicron-5 to the SS Usagi. Behind you is the familiar bulk of the huge station, largest outpost of the Space Authority in Deneb Sector. Before you is the aft airlock of the Usagi, beckoning you in.

[Better get a move on], you think.

>u
The only obvious exit is fore.

>pf
PLANETFALL
Infocom interactive fiction - a science fiction story
Copyright (c) 1983 by Infocom, Inc. All rights reserved.
PLANETFALL is a registered trademark of Infocom, Inc.
Release 39 / Serial number 880501

Another routine day of drudgery aboard the Stellar Patrol Ship Feinstein. This morning's assignment for a certain lowly Ensign Seventh Class: scrubbing the filthy metal deck at the port end of Level Nine. With your Patrol-issue self-contained multi-purpose all-weather scrub brush you shine the floor with a diligence born of the knowledge that at any moment dreaded Ensign First Class Blather, the bane of your shipboard existence, could appear.

* * *

>u
Deck Eight
This is a steep metal gangway connecting Deck Eight, above, and Deck Nine, below.

Ensign Blather, his uniform immaculate, enters and notices you are away from your post. "Twenty demerits, Ensign Seventh Class!" bellows Blather. "Forty if you're not back on Deck Nine in five seconds!" He curls his face into a hideous mask of disgust at your unbelievable negligence.

>x blather
You see nothing special about Ensign First Class Blather.

"I said to return to your post, Ensign Seventh Class!" bellows Blather, turning a deepening shade of crimson.

* * *

Crash
An Interactive Disaster by Phil Riley
Release 5 / Serial number 220724 / Inform 7 build 6M62 (I6/v6.34 lib 6/12N) SD

Space Station Gangway
This is the pressurized bridge from Space Station Omicron-5 to the SS Usagi. Behind you is the familiar bulk of the huge station, largest outpost of the Space Authority in Deneb Sector. Before you is the aft airlock of the Usagi, beckoning you in.

[Better get a move on], you think.

>z
Sorry, I don't understand.