Crash
An Interactive Disaster by Phil Riley
Release 15 / Serial number 220926 / Inform 7 build 6M62 (I6/v6.34 lib 6/12N) SD

Space Station Gangway
This is the pressurized bridge from Space Station Omicron-5 to the SS Usagi. Behind you is the familiar bulk of the huge station, largest outpost of the Space Authority in Deneb Sector. Before you is the aft airlock of the Usagi, beckoning you in.

[Better get a move on], you think.

>a
The only obvious exit is fore.

* * *

Crash
An Interactive Disaster by Phil Riley
Release 15 / Serial number 220926 / Inform 7 build 6M62 (I6/v6.34 lib 6/12N) SD

Space Station Gangway
This is the pressurized bridge from Space Station Omicron-5 to the SS Usagi. Behind you is the familiar bulk of the huge station, largest outpost of the Space Authority in Deneb Sector. Before you is the aft airlock of the Usagi, beckoning you in.

[Better get a move on], you think.

>f
You pass into the aft airlock, the outer door closing behind you.

The Second Law of Thermodynamics, in one formulation, states that disorganization always increases in the absence of some outside force. A corollary is that things will always break down in the absence of someone to fix them. As a member of the repair corps of Space Station Omicron-5, you're that someone.

Your last assignment of the day, on the SS Usagi, a Space Marines fighting ship, looks routine enough. Fix the microwave and a jammed locker door, and then you're off for the day.

Aft Airlock
You are in the aft airlock. Outside is the gangway back to Space Station Omicron-5. Forward leads into the ship.

A pleasant androgynous voice says, "Welcome to the SS Usagi. This is the shipboard computer. Please feel free to call upon me for any information you may need. Use the command 'computer, help' for more information."

* * *

>f
You enter the ship from the airlock. The inner door closes behind you.

Staging Area
This is the staging area of the ship, where marines prepare for missions. It is adjacent to the aft airlock. It houses a number of vac suits in an open locker, and various munitions in locked compartments set into the walls. A ladder leads up into the rest of the ship. 
Through the airlock windows you can see the gangway to Space Station Omicron-5.

What looks like part of an engine is stowed in a corner.

>u
You climb the la--

***BOOM***

Press any key...

A gigantic force grabs the ship, knocking you off the ladder and sending you flying against an aft bulkhead. The inertial dampers are probably all that saved you from being smashed to jelly rather than just banged up. 

Press any key...

Some time later you find yourself lying on the floor of the staging area with a throbbing headache. Gingerly you push yourself to your knees and stand up. The vac suit locker has detached from its mounting and slammed into the airlock door.

[Thank god I wasn't in the way of that.]

Looking outside --

[Holy -- ]

[Where's the station?].

Where Space Station Omicron-5 was, is now an expanding sphere of rubble, dimly lit by the blue light of far-off Deneb. The rubble is clearly receding behind the ship. [We're moving!]

[How am I going to get off this ship?]

Press any key...

Crash
An Interactive Disaster by Phil Riley
Release 15 / Serial number 220926 / Inform 7 build 6M62 (I6/v6.34 lib 6/12N) SD

Staging Area
This is the staging area of the ship, where marines prepare for missions. It is adjacent to the aft airlock. Locked compartments set into the walls hold various munitions. A ladder leads up into the rest of the ship. 

An equipment locker is sprawled across the room, with its door to the ground.
 
Through the airlock windows you see the blank space left by the destruction of Space Station Omicron-5.

What looks like part of an engine is stowed in a corner.

A vac suit is here, lying prone as if it were some malformed yellow person knocked unconscious by the shaking of the ship. It has chewing gum stuck to it.

[What now?]

[I think I spit out my gum.]

>computer, access code 2
Welcome, caller. Logging you in.

Attention all crew: command functions are offline and the computer is running with decreased capabilities. Full system reboot required.

>computer, reboot
Are you sure you wish to reboot?

* * *

>n
I'm not sure what you're trying to say. I might just not recognize the words you're using.

>computer, reboot
Are you sure you wish to reboot?

>y
Beginning reboot. Take all appropriate precautions.

Red alert lights flash throughout the ship.

The air in here has gotten a bit stale.

>reboot
You can't reboot yourself.

You're starting to feel faint.

>z
Time passes.

You pass out.

 ...

When you awake, your head is throbbing and you have no idea how much time has passed.
[I wonder what's going on?]

* * *

>u
Junction
This is a busy place when the ship is populated. To port and starboard are the crew quarters, aft is the closed door to the captain's private quarters, and fore is the galley. A ladder leads down to the staging area.

⇒ You can enter "hints" at any time for help in progressing in the game.

Attention all crew: command functions are offline and the computer is running with decreased capabilities. Full system reboot required.

>computer, access code 2
Welcome, caller. Logging you in.

>computer, reboot
Are you sure you wish to reboot?

>d
Staging Area
This is the staging area of the ship, where marines prepare for missions. It is adjacent to the aft airlock. Locked compartments set into the walls hold various munitions. A ladder leads up into the rest of the ship. 

An equipment locker is sprawled across the room, with its door to the ground.
 
Through the airlock windows you see the blank space left by the destruction of Space Station Omicron-5.

What looks like part of an engine is stowed in a corner.

A vac suit is here, lying prone as if it were some malformed yellow person knocked unconscious by the shaking of the ship. It has chewing gum stuck to it.

You're starting to feel faint.

>wear suit
(first taking the vac suit)
You put on the vac suit.

>z
Time passes.

* * *

>z
Time passes.

Reboot complete.

>computer, reboot
You've already rebooted once. That's enough.

* * *

>computer, reboot
Are you sure you wish to reboot?

>n
The shipboard computer has better things to do.

* * *

Crash
An Interactive Disaster by Phil Riley
Release 15 / Serial number 220926 / Inform 7 build 6M62 (I6/v6.34 lib 6/12N) SD

Space Station Gangway
This is the pressurized bridge from Space Station Omicron-5 to the SS Usagi. Behind you is the familiar bulk of the huge station, largest outpost of the Space Authority in Deneb Sector. Before you is the aft airlock of the Usagi, beckoning you in.

[Better get a move on], you think.

>gonear engine room
(Engine Room)

The Second Law of Thermodynamics, in one formulation, states that disorganization always increases in the absence of some outside force. A corollary is that things will always break down in the absence of someone to fix them. As a member of the repair corps of Space Station Omicron-5, you're that someone.

Your last assignment of the day, on the SS Usagi, a Space Marines fighting ship, looks routine enough. Fix the microwave and a jammed locker door, and then you're off for the day.

Engine Room
This where the combustion process is controlled. The aft wall is dominated by the operating panel section of the fusion engine. Monitoring electronics and controls cover the other two walls. A doorway opens forward to the Engineering Deck.

There is a large screen on the forward wall. It displays nothing right now. There is a large button below the diagram labeled "Test".

>x monitors
Without a degree in fusion propulsion, trying to understand these controls is pointless.

>take them
They're hardly portable.

>take it
You can't see 'it' (nothing) at the moment.

>i
You are carrying:
  some chewing gum (being chewed)
  a To-Do list
  a repair corps uniform (being worn)
  a toolbox

>pronouns
At the moment, "it" means Engine Room, "him" is unset, "her" is unset, and "them" means the engine room monitors.

>take it
You can't see 'it' (nothing) at the moment.

* * *

Crash
An Interactive Disaster by Phil Riley
Release 15 / Serial number 220926 / Inform 7 build 6M62 (I6/v6.34 lib 6/12N) SD

Space Station Gangway
This is the pressurized bridge from Space Station Omicron-5 to the SS Usagi. Behind you is the familiar bulk of the huge station, largest outpost of the Space Authority in Deneb Sector. Before you is the aft airlock of the Usagi, beckoning you in.

[Better get a move on], you think.

>gonear operations
Which do you mean, Operation Dalmatian, Operations Deck, or the door operations manual?

>deck
The Second Law of Thermodynamics, in one formulation, states that disorganization always increases in the absence of some outside force. A corollary is that things will always break down in the absence of someone to fix them. As a member of the repair corps of Space Station Omicron-5, you're that someone.

Your last assignment of the day, on the SS Usagi, a Space Marines fighting ship, looks routine enough. Fix the microwave and a jammed locker door, and then you're off for the day.

Operations Deck
This is where all of the support activity for the bridge occurs. There are large consoles for environmental controls (which include gravity, temperature, and pressure), communications, and power systems here. The bridge continues forward from here, and engineering is aft. There is a door set in the floor with a ladder leading through it. Set in the frame of the door is a blue button.

A large equipment trunk lies on the midship door, blocking it.

>hello
(addressing the caller)
You call out "Yes! I'm here! I'm here! What's going on?"

The caller responds, "Ahoy there, SS Usagi, good to hear from you. Seems like you're a bit out of sorts, and we'd like to help you out. But before we get into that, who am I speaking to? Tell me about yourself."

You tell the caller that you're from the repair corps.

"Alright then, Sergeant Screwdriver, I'll fill you in. Space Station Omicron-5 was bombed by separatists from Deneb IV. By some miracle the Usagi was spared the worst of the blast; you were thrown clear of the station. Only problem is now you're hurtling towards New Da Nang, a heavily-populated moon of Deneb II. An impact there would kill not only you but potentially thousands of people more.

 "So we've got some work to do. I'm Master Sergeant R. Mu Arvax -- you can ask the ship computer about me. I'm going to try and help you get this ship under control again. First we have to establish, though, what the ship is currently doing. Normally, I'd be able to tap into the ship diagnostics and controls from here on Deneb III, but something seems to have gone wrong. So I'm going to need your help. Are you up to the task?"

[Sergeant Screwdriver, guy thinks he's funny.]

"Yes sir!" you proclaim, despite his lame joke.

"Great, great. Now let's get to work.

 "The first thing I need you to do is reboot the system, using the computer. Once you do that, hopefully I'll be able to access ship controls. You'll have to use my access code: say 'compu--"

Master Sergeant R. Mu Arvax's voice breaks up and another voice comes over comms. "SS Usagi, this is Captain Jane Mulgrew, please come in. Repeat, this is Captain Mulgrew of the SS Usagi, Usagi come in."

[Somebody else?]

>help speech
There are a few commands that allow you to talk to other characters you meet. These are: 

 - hello: to start talking to someone.
 - ask <someone> about <something>: ask the character to tell you what it knows about a thing.
 - goodbye: to stop talking to someone.
 - tell <someone> about <something>: tell the character what you know about a thing.
 - yes
 - no

Note: you cannot talk or ask about a subject with which you are unfamiliar. Thus you cannot get an answer to "ask Frank about Sophie" unless you are aware of Sophie's existence.

To ask a person or thing to do something use the following pattern: "<name>, <action>", for instance, "computer, help."

One useful command is "<name>, repeat", which will cause the named person or thing to repeat the last thing they said, if anything. You can also say "<name>, repeat all", which will cause them to repeat an entire transcript of their speech.

* * *

Crash
An Interactive Disaster by Phil Riley
Release 15 / Serial number 220926 / Inform 7 build 6M62 (I6/v6.34 lib 6/12N) SD

Space Station Gangway
This is the pressurized bridge from Space Station Omicron-5 to the SS Usagi. Behind you is the familiar bulk of the huge station, largest outpost of the Space Authority in Deneb Sector. Before you is the aft airlock of the Usagi, beckoning you in.

[Better get a move on], you think.

>n
I'm not sure what you're trying to say. I might just not recognize the words you're using.

>f
You pass into the aft airlock, the outer door closing behind you.

Aft Airlock
You are in the aft airlock. Outside is the gangway back to Space Station Omicron-5. Forward leads into the ship.

A pleasant androgynous voice says, "Welcome to the SS Usagi. This is the shipboard computer. Please feel free to call upon me for any information you may need. Use the command 'computer, help' for more information."

>f
You enter the ship from the airlock. The inner door closes behind you.

Staging Area
This is the staging area of the ship, where marines prepare for missions. It is adjacent to the aft airlock. It houses a number of vac suits in an open locker, and various munitions in locked compartments set into the walls. A ladder leads up into the rest of the ship. 
Through the airlock windows you can see the gangway to Space Station Omicron-5.

What looks like part of an engine is stowed in a corner.

* * *

>f
⇒ Try going up: enter "u".

>u
Crash
An Interactive Disaster by Phil Riley
Release 15 / Serial number 220925 / Inform 7 build 6M62 (I6/v6.34 lib 6/12N) SD

Staging Area
This is the staging area of the ship, where marines prepare for missions. It is adjacent to the aft airlock. Locked compartments set into the walls hold various munitions. A ladder leads up into the rest of the ship. 

An equipment locker is sprawled across the room, with its door to the ground.
 
Through the airlock windows you see the blank space left by the destruction of Space Station Omicron-5.

What looks like part of an engine is stowed in a corner.

A vac suit is here, lying prone as if it were some malformed yellow person knocked unconscious by the shaking of the ship. It has chewing gum stuck to it.

[What now?]

[I think I spit out my gum.]

>u
Junction
This is a busy place when the ship is populated. To port and starboard are the crew quarters, aft is the closed door to the captain's private quarters, and fore is the galley. A ladder leads down to the staging area.

⇒ You can enter "hints" at any time for help in progressing in the game.

>z
Time passes.

I beg your pardon?

I beg your pardon?

>z
Time passes.

>z
Attention all crew: command functions are offline and the computer is running with decreased capabilities. Full system reboot required.

Time passes.

* * *

>i
You are carrying:
  some chewing gum (being chewed)
  a To-Do list
  a repair corps uniform (being worn)
  a toolbox

>u
Crash
An Interactive Disaster by Phil Riley
Release 15 / Serial number 220925 / Inform 7 build 6M62 (I6/v6.34 lib 6/12N) SD

Staging Area
This is the staging area of the ship, where marines prepare for missions. It is adjacent to the aft airlock. Locked compartments set into the walls hold various munitions. A ladder leads up into the rest of the ship. 

An equipment locker is sprawled across the room, with its door to the ground.
 
Through the airlock windows you see the blank space left by the destruction of Space Station Omicron-5.

What looks like part of an engine is stowed in a corner.

A vac suit is here, lying prone as if it were some malformed yellow person knocked unconscious by the shaking of the ship. It has chewing gum stuck to it.

[What now?]

[I think I spit out my gum.]

>u
Attention all crew: command functions are offline and the computer is running with decreased capabilities. Full system reboot required.

Junction
This is a busy place when the ship is populated. To port and starboard are the crew quarters, aft is the closed door to the captain's private quarters, and fore is the galley. A ladder leads down to the staging area.

⇒ You can enter "hints" at any time for help in progressing in the game.

Attention all crew: command functions are offline and the computer is running with decreased capabilities. Full system reboot required.

* * *

>f
You enter the ship from the airlock. The inner door closes behind you.

Staging Area
This is the staging area of the ship, where marines prepare for missions. It is adjacent to the aft airlock. It houses a number of vac suits in an open locker, and various munitions in locked compartments set into the walls. A ladder leads up into the rest of the ship. 
Through the airlock windows you can see the gangway to Space Station Omicron-5.

What looks like part of an engine is stowed in a corner.

>u
Crash
An Interactive Disaster by Phil Riley
Release 15 / Serial number 220925 / Inform 7 build 6M62 (I6/v6.34 lib 6/12N) SD

Staging Area
This is the staging area of the ship, where marines prepare for missions. It is adjacent to the aft airlock. Locked compartments set into the walls hold various munitions. A ladder leads up into the rest of the ship. 

An equipment locker is sprawled across the room, with its door to the ground.
 
Through the airlock windows you see the blank space left by the destruction of Space Station Omicron-5.

What looks like part of an engine is stowed in a corner.

A vac suit is here, lying prone as if it were some malformed yellow person knocked unconscious by the shaking of the ship. It has chewing gum stuck to it.

[What now?]

[I think I spit out my gum.]

>u
Junction
This is a busy place when the ship is populated. To port and starboard are the crew quarters, aft is the closed door to the captain's private quarters, and fore is the galley. A ladder leads down to the staging area.

⇒ You can enter "hints" at any time for help in progressing in the game.

Attention all crew: command functions are offline and the computer is running with decreased capabilities. Full system reboot required.

>ask computer about engine
Which do you mean, the brand-new JL-758 or engine status?

>ask computer about engine status
The SS Usagi employs a Luna Spacewerks Parsec VI. The shipboard engine is currently non-functional. It needs a replacement JL-758 engine stabilizer.

* * *

>f
You pass into the aft airlock, the outer door closing behind you.

Aft Airlock
You are in the aft airlock. Outside is the gangway back to Space Station Omicron-5. Forward leads into the ship.

A pleasant androgynous voice says, "Welcome to the SS Usagi. This is the shipboard computer. Please feel free to call upon me for any information you may need. Use the command 'computer, help' for more information."

>s
⇒ Try going in: enter "in".

>in
You enter the ship from the airlock. The inner door closes behind you.

Staging Area
This is the staging area of the ship, where marines prepare for missions. It is adjacent to the aft airlock. It houses a number of vac suits in an open locker, and various munitions in locked compartments set into the walls. A ladder leads up into the rest of the ship. 
Through the airlock windows you can see the gangway to Space Station Omicron-5.

What looks like part of an engine is stowed in a corner.

>in
⇒ Try going up: enter "u".

>u
Crash
An Interactive Disaster by Phil Riley
Release 15 / Serial number 220925 / Inform 7 build 6M62 (I6/v6.34 lib 6/12N) SD

Staging Area
This is the staging area of the ship, where marines prepare for missions. It is adjacent to the aft airlock. Locked compartments set into the walls hold various munitions. A ladder leads up into the rest of the ship. 

An equipment locker is sprawled across the room, with its door to the ground.
 
Through the airlock windows you see the blank space left by the destruction of Space Station Omicron-5.

What looks like part of an engine is stowed in a corner.

A vac suit is here, lying prone as if it were some malformed yellow person knocked unconscious by the shaking of the ship. It has chewing gum stuck to it.

[What now?]

[I think I spit out my gum.]

* * *

>p
Junction
This is a busy place when the ship is populated. To port and starboard are the crew quarters, aft is the closed door to the captain's private quarters, and fore is the galley. A ladder leads down to the staging area.

>d
Staging Area
This is the staging area of the ship, where marines prepare for missions. It is adjacent to the aft airlock. Locked compartments set into the walls hold various munitions. A ladder leads up into the rest of the ship. 

An equipment locker is sprawled across the room, with its door to the ground.
 
Through the airlock windows you see the blank space left by the destruction of Space Station Omicron-5.

What looks like part of an engine is stowed in a corner.

A vac suit is here, lying prone as if it were some malformed yellow person knocked unconscious by the shaking of the ship. It has chewing gum stuck to it.

>drop trunk
You place the black trunk near the airlock door.

>showme turn count
There seems to be no such object anywhere in the model world.

>z
Time passes.

* * *

>z
Attention all crew: command functions are offline and the computer is running with decreased capabilities. Full system reboot required.

Time passes.

>restart
Are you sure you want to restart?

* * *

>f
You pass into the aft airlock, the outer door closing behind you.

Aft Airlock
You are in the aft airlock. Outside is the gangway back to Space Station Omicron-5. Forward leads into the ship.

A pleasant androgynous voice says, "Welcome to the SS Usagi. This is the shipboard computer. Please feel free to call upon me for any information you may need. Use the command 'computer, help' for more information."

* * *

>open trunk
You open the black trunk, revealing a present.

>open  present
[I'll go to hell for this, but here goes...]

You rip off the wrapping paper and open the box. Inside is a stuffed bear you recognize as Bertie the Bear™. You discard the paper and box.

>take eyes
[Am I really going to do this? Yes, yes, I am, apparently.]

You grasp one of the eyes and give it a tug, first softly then harder. Eventually it gives and you extract the eye from the bear. Upon examination you discover that the eye is in fact an optical sensor in camouflage. It looks like you didn't pull it carefully enough, however, because the connector at the end has been damaged.

You try again more carefully with the second eye, and manage to produce an undamaged optical sensor.

>z
Time passes.

* * *

>z
Attention all crew: command functions are offline and the computer is running with decreased capabilities. Full system reboot required.

Time passes.

>z
Time passes.

* * *

Crash
An Interactive Disaster by Phil Riley
Release 15 / Serial number 220926 / Inform 7 build 6M62 (I6/v6.34 lib 6/12N) SD

Space Station Gangway
This is the pressurized bridge from Space Station Omicron-5 to the SS Usagi. Behind you is the familiar bulk of the huge station, largest outpost of the Space Authority in Deneb Sector. Before you is the aft airlock of the Usagi, beckoning you in.

[Better get a move on], you think.

>pf
PLANETFALL
Infocom interactive fiction - a science fiction story
Copyright (c) 1983 by Infocom, Inc. All rights reserved.
PLANETFALL is a registered trademark of Infocom, Inc.
Release 39 / Serial number 880501

Another routine day of drudgery aboard the Stellar Patrol Ship Feinstein. This morning's assignment for a certain lowly Ensign Seventh Class: scrubbing the filthy metal deck at the port end of Level Nine. With your Patrol-issue self-contained multi-purpose all-weather scrub brush you shine the floor with a diligence born of the knowledge that at any moment dreaded Ensign First Class Blather, the bane of your shipboard existence, could appear.

* * *

>i
You are carrying:
  a Patrol uniform (being worn)
    an ID card
  a chronometer (being worn)
  a Patrol-issue self-contained multi-purpose scrub brush

>x uniform
It is a standard-issue one-pocket Stellar Patrol uniform, a miracle of modern technology. It will keep its owner warm in cold climates and cool in warm locales. It provides protection against mild radiation, repels all insects, absorbs sweat, promotes healthy skin tone, and on top of everything else, it is super-comfy.

In the Patrol uniform is an ID card.

>x card
"STELLAR PATROL
 Special Assignment Task Force
 ID Number:  6172-531-541"

The alien ambassador from the planet Blow'k-bibben-Gordo ambles toward you from down the corridor. He is munching on something resembling an enormous stalk of celery, and he leaves a trail of green slime on the deck. He stops nearby, and you wince as a pool of slime begins forming beneath him on your newly-polished deck. The ambassador wheezes loudly and hands you a brochure outlining his planet's major exports.

>x slime
It looks like slime. Aren't you glad you didn't step in it?

The ambassador inquires whether you are interested in a game of Bocci.

>clean slime
Whew. You've cleaned up maybe one ten-thousandth of the slime. If you hurry, it might be all cleaned up before Ensign Blather gets here.

The ambassador offers you a bit of celery.

>take celery
You can't see any such thing.

>x it
It looks like slime. Aren't you glad you didn't step in it?

The ambassador asks if you are performing some sort of religious ceremony.

>x ambassador
The ambassador has around twenty eyes, seven of which are currently open. Half of his six legs are retracted. Green slime oozes from multiple orifices in his scaly skin. He speaks through a mechanical translator slung around his neck.

The ambassador grunts a polite farewell, and disappears up the gangway, leaving a trail of dripping slime.

>w
I'm not sure what you're trying to say. I might just not recognize the words you're using.

>p
The escape pod bulkhead is closed.

>s
Reactor Lobby
The corridor widens here as it nears the main drive area. To starboard is the Ion Reactor that powers the vessel, and aft of here is the Auxiliary Control Room. The corridor continues to port.

Ensign Blather, his uniform immaculate, enters and notices you are away from your post. "Twenty demerits, Ensign Seventh Class!" bellows Blather. "Forty if you're not back on Deck Nine in five seconds!" He curls his face into a hideous mask of disgust at your unbelievable negligence.

* * *

>p
Deck Nine
This is a featureless corridor similar to every other corridor on the ship. It curves away to starboard, and a gangway leads up. To port is the entrance to one of the ship's primary escape pods. The pod bulkhead is closed.

>z
Chew, chew, chew...

>z
Chew, chew, chew...

The alien ambassador from the planet Blow'k-bibben-Gordo ambles toward you from down the corridor. He is munching on something resembling an enormous stalk of celery, and he leaves a trail of green slime on the deck. He stops nearby, and you wince as a pool of slime begins forming beneath him on your newly-polished deck. The ambassador wheezes loudly and hands you a brochure outlining his planet's major exports.

The ambassador remarks that all humans look alike to him.

>z
Chew, chew, chew...

The ambassador asks where Admiral Smithers can be found.

>z
Chew, chew, chew...

The ambassador introduces himself as Br'gun-te'elkner-ipg'nun.

>z
Chew, chew, chew...

The ambassador introduces himself as Br'gun-te'elkner-ipg'nun.

>z
Chew, chew, chew...

The ambassador grunts a polite farewell, and disappears up the gangway, leaving a trail of dripping slime.

>z
Chew, chew, chew...

>z
Chew, chew, chew...

>z
Chew, chew, chew...

A massive explosion rocks the ship. Echoes from the explosion resound deafeningly down the halls.
 The door to port slides open.

[No, no, no. This is hitting too close to home. Better quit and focus on saving the ship.]

The Second Law of Thermodynamics, in one formulation, states that disorganization always increases in the absence of some outside force. A corollary is that things will always break down in the absence of someone to fix them. As a member of the repair corps of Space Station Omicron-5, you're that someone.

Your last assignment of the day, on the SS Usagi, a Space Marines fighting ship, looks routine enough. Fix the microwave and a jammed locker door, and then you're off for the day.

Space Station Gangway
This is the pressurized bridge from Space Station Omicron-5 to the SS Usagi. Behind you is the familiar bulk of the huge station, largest outpost of the Space Authority in Deneb Sector. Before you is the aft airlock of the Usagi, beckoning you in.

⇒ Tip: Type "help" to learn about this game, and interactive fiction in general.

>x gum
It still tastes pretty good.

* * *

>x gum
You can't see any such thing.

>take it
I'm not sure what 'it' refers to.

* * *

>ask arvax for access
There is no reply.

>ask mulgrew for access code
"It's 3."

>ask mulgrew for access
There is no reply.

>actions
Actions listing on.

>ask mulgrew for access
[imploring Captain Jane Mulgrew for "access"]
There is no reply.
[imploring Captain Jane Mulgrew for "access" - succeeded]

>ask arvax for security code
[requesting Master Sergeant R. Mu Arvax for security code]
[(1) saying hello to Master Sergeant R. Mu Arvax]
[(1) saying hello to Master Sergeant R. Mu Arvax - succeeded]

[(1) quizzing Master Sergeant R. Mu Arvax about security code]
"Just say 'Computer, access code 2'."
[(1) quizzing Master Sergeant R. Mu Arvax about security code - succeeded]

[requesting Master Sergeant R. Mu Arvax for security code - succeeded]

>ask arvax for code
[requesting Master Sergeant R. Mu Arvax for security code]
[(1) quizzing Master Sergeant R. Mu Arvax about security code]
"Just say 'Computer, access code 2'."
[(1) quizzing Master Sergeant R. Mu Arvax about security code - succeeded]

[requesting Master Sergeant R. Mu Arvax for security code - succeeded]

>ask arvax for access
[imploring Master Sergeant R. Mu Arvax for "access"]
There is no reply.
[imploring Master Sergeant R. Mu Arvax for "access" - succeeded]

>ask arvax for access code
[requesting Master Sergeant R. Mu Arvax for security code]
[(1) quizzing Master Sergeant R. Mu Arvax about security code]
"Just say 'Computer, access code 2'."
[(1) quizzing Master Sergeant R. Mu Arvax about security code - succeeded]

[requesting Master Sergeant R. Mu Arvax for security code - succeeded]

>ask arvax about access
[asking Master Sergeant R. Mu Arvax about "access"]
"I'm afraid I don't have anything to say about that."

"I'm afraid I don't have anything to say about that."
[asking Master Sergeant R. Mu Arvax about "access" - succeeded]

>actions off
Actions listing off.

>ask arvax about acces
"I'm afraid I don't have anything to say about that."

"I'm afraid I don't have anything to say about that."

Attention all crew: command functions are offline and the computer is running with decreased capabilities. Full system reboot required.

>rules
Rules tracing now switched on. Type "rules off" to switch it off again, or "rules all" to include even rules which do not apply.

[Rule "reset report text rule" applies.]

>ask arvax about acces
[Rule "After reading a command" applies.]
[Rule "After deciding the scope of the player when location is Operations" applies.]
[Rule "computer is everywhere rule" applies.]
[Rule "After deciding the scope of the player when location is Operations" applies.]
[Rule "computer is everywhere rule" applies.]
[Rule "After deciding the scope of the player when location is Operations" applies.]
[Rule "computer is everywhere rule" applies.]
[Rule "After deciding the scope of the player when location is Operations" applies.]
[Rule "computer is everywhere rule" applies.]
[Rule "After deciding the scope of the player when location is Operations" applies.]
[Rule "computer is everywhere rule" applies.]
[Rule "After deciding the scope of the player when location is Operations" applies.]
[Rule "computer is everywhere rule" applies.]
[Rule "After deciding the scope of the player when location is Operations" applies.]
[Rule "computer is everywhere rule" applies.]
[Rule "After deciding the scope of the player when location is Operations" applies.]
[Rule "computer is everywhere rule" applies.]
[Rule "declare everything initially unmentioned rule" applies.]
[Rule "announce items from multiple object lists rule" applies.]
[Rule "set pronouns from items from multiple object lists rule" applies.]
[Rule "before stage rule" applies.]
[Rule "Before doing something to Arvax" applies.]
[Rule "Before" applies.]
[Rule "reaching inside for Deneb III Naval Command" applies.]
[Rule "new instead stage rule" applies.]
[Rule "Instead of asking someone about a topic when end game is not happening" applies.]
"I'm afraid I don't have anything to say about that."

[Rule "investigate player's awareness before action rule" applies.]
[Rule "player aware of his own actions rule" applies.]
[Rule "check stage rule" applies.]
[Rule "carry out stage rule" applies.]
[Rule "after stage rule" applies.]
[Rule "investigate player's awareness after action rule" applies.]
[Rule "report stage rule" applies.]
[Rule "reset turns in state rule" applies.]
[Rule "standard response rule" applies.]
[Rule "block asking rule" applies.]
"I'm afraid I don't have anything to say about that."
[Rule "pre-report rule" applies.]
[Rule "last specific action-processing rule" applies.]

[Rule "A first turn sequence rule" applies.]
[Rule "post-report rule" applies.]
[Rule "every turn stage rule" applies.]
[Rule "Every turn when talking about asking mulgrew questions and computer-rebooting is false and protocols-in-progress is false" applies.]
[Rule "Every turn when explosion happened is true and computer-rebooted is false and protocols-activated is false" applies.]
[Rule "reset protocol rule" applies.]
[Rule "Every turn" applies.]
[Rule "close open doors rule" applies.]
[Rule "A last turn sequence rule" applies.]
[Rule "notify score changes rule" applies.]
[Rule "reset report text rule" applies.]

* * *

>ask arvax for access code
It's impossible for Master Sergeant R. Mu Arvax to give you anything.

* * *

>ask arvax for cheese
There is no reply.

* * *

>rules
Rules tracing now switched on. Type "rules off" to switch it off again, or "rules all" to include even rules which do not apply.

[Rule "reset report text rule" applies.]

>ask arvax for access code
[Rule "After reading a command" applies.]
[Rule "After deciding the scope of the player when location is Operations" applies.]
[Rule "computer is everywhere rule" applies.]
[Rule "After deciding the scope of the player when location is Operations" applies.]
[Rule "computer is everywhere rule" applies.]
[Rule "After deciding the scope of the player when location is Operations" applies.]
[Rule "computer is everywhere rule" applies.]
[Rule "After deciding the scope of the player when location is Operations" applies.]
[Rule "computer is everywhere rule" applies.]
[Rule "declare everything initially unmentioned rule" applies.]
[Rule "announce items from multiple object lists rule" applies.]
[Rule "set pronouns from items from multiple object lists rule" applies.]
[Rule "before stage rule" applies.]
[Rule "Before doing something to Arvax" applies.]
[Rule "Before" applies.]
[Rule "new instead stage rule" applies.]
[Rule "investigate player's awareness before action rule" applies.]
[Rule "player aware of his own actions rule" applies.]
[Rule "check stage rule" applies.]
[Rule "carry out stage rule" applies.]
[Rule "after stage rule" applies.]
[Rule "investigate player's awareness after action rule" applies.]
[Rule "report stage rule" applies.]
[Rule "reset turns in state rule" applies.]
[Rule "standard response rule" applies.]
[Rule "pre-report rule" applies.]
[Rule "last specific action-processing rule" applies.]
[Rule "A first turn sequence rule" applies.]
[Rule "post-report rule" applies.]
[Rule "every turn stage rule" applies.]
[Rule "Every turn when talking about asking mulgrew questions and computer-rebooting is false and protocols-in-progress is false" applies.]
[Rule "Every turn when explosion happened is true and computer-rebooted is false and protocols-activated is false" applies.]
[Rule "reset protocol rule" applies.]
[Rule "Every turn" applies.]
[Rule "close open doors rule" applies.]
[Rule "A last turn sequence rule" applies.]
[Rule "notify score changes rule" applies.]
[Rule "reset report text rule" applies.]

>rules off
[Rule "After reading a command" applies.]
[Rule "declare everything initially unmentioned rule" applies.]
Rules tracing now switched off. Type "rules" to switch it on again.

* * *

>actions
Actions listing on.

>ask arvax for access code
[requesting Master Sergeant R. Mu Arvax for security code]
[requesting Master Sergeant R. Mu Arvax for security code - succeeded]

* * *

>ask computer about asdfasdf
I'm unable to give you any information about asdfasdf.

>ask arvax about fjfjf
"I'm afraid I don't have anything to say about that."

>tell arvax about fjfjf
"I'm afraid I don't have anything to say about that."

* * *

>d
Galley
This narrow space is barely enough room for two Marines to prepare and eat a meal. There is a counter with a drawer, and two stools, a microwave oven, and a large closet here. Pots and pans hang from hooks in the ceiling. A ladder leads up through the midship door, and you can leave aft.

On the starboard wall is a panel on which is a blue button. Tacked to the panel is the operator's manual for the midship door.

You hear someone speaking above.

>u
Operations Deck
This is where all of the support activity for the bridge occurs. There are large consoles for environmental controls (which include gravity, temperature, and pressure), communications, and power systems here. The bridge continues forward from here, and engineering is aft. There is a door set in the floor with a ladder leading through it. Set in the frame of the door is a blue button.

You can see an equipment trunk (closed) here.

Captain Mulgrew: "Calling the SS Usagi..."

>restart
Are you sure you want to restart?

>y
Crash
An Interactive Disaster by Phil Riley
Release 15 / Serial number 220925 / Inform 7 build 6M62 (I6/v6.34 lib 6/12N) SD

Space Station Gangway
This is the pressurized bridge from Space Station Omicron-5 to the SS Usagi. Behind you is the familiar bulk of the huge station, largest outpost of the Space Authority in Deneb Sector. Before you is the aft airlock of the Usagi, beckoning you in.

[Better get a move on], you think.

* * *

>z
Time passes.

Master Sergeant R. Mu Arvax: "You there, Usagi? We don't have much time."

>hello
(addressing Master Sergeant R. Mu Arvax)
"You're back! Great job rebooting the computer -- I'm getting telemetry now."

>d
Galley
This narrow space is barely enough room for two Marines to prepare and eat a meal. There is a counter with a drawer, and two stools, a microwave oven, and a large closet here. Pots and pans hang from hooks in the ceiling. A ladder leads up through the midship door, and you can leave aft.

On the starboard wall is a panel on which is a blue button. Tacked to the panel is the operator's manual for the midship door.

You hear someone speaking above.

>u
Operations Deck
This is where all of the support activity for the bridge occurs. There are large consoles for environmental controls (which include gravity, temperature, and pressure), communications, and power systems here. The bridge continues forward from here, and engineering is aft. There is a door set in the floor with a ladder leading through it. Set in the frame of the door is a blue button.

You can see an equipment trunk (closed) here.

Master Sergeant R. Mu Arvax: "You there, Usagi? We don't have much time."

* * *

>x door
The Captain's Door is a conventional, self-opening starship door. It is painted in the traditional red of a starship captain. It features a slot through which you may slide the appropriate access card. Beside the door is an access panel, which is closed.

>f
The Captain's Door opens as you approach, and closes silently behind you.

Junction
This is a busy place when the ship is populated. To port and starboard are the crew quarters, aft is the closed door to the captain's private quarters, and fore is the galley. A ladder leads down to the staging area.

>a
The Captain's Door opens as you approach, and closes silently behind you.

Captain's Quarters
Neat and spartan, this cabin is the very model of a small fighting ship's captain's quarters. An impeccably organized desk is against one wall, while a typically spotless bed sits beneath a portrait of this very ship. You can exit to fore.

The desk drawer is open and empty.

* * *

>ask computer about journal
Information on the captain's journal is unavailable to protect the captain's privacy.

I beg your pardon?

* * *

>computer, reboot
Authorization required.

>computer, invoke emergency protocols
Authorization required.

>ask computer about journal
I'm unable to give you any information about journal.

* * *

>f
Engineering Deck
The engineering crew is responsible for keeping the physical ship operating. They are in charge of every physical aspect of the ship, from the engines to hull integrity to the life support system.

The engineering deck consists of a large console giving a comprehensive view of the physical status of the ship. There is an airlock to starboard. The operations deck continues forward from here, and there are other exits to aft and port.

You hear someone speaking to fore.

A device labeled "Suit Recharging Station" is here. It is shaped like a chair with nozzles protruding from either arm.

>f
Operations Deck
This is where all of the support activity for the bridge occurs. There are large consoles for environmental controls (which include gravity, temperature, and pressure), communications, and power systems here. The bridge continues forward from here, and engineering is aft. There is a door set in the floor with a ladder leading through it. Set in the frame of the door is a blue button.

You can see an equipment trunk (closed) here.

Master Sergeant R. Mu Arvax: "You there, Usagi? We don't have much time."

>ask arvax about ship
(the ss usagi)
"Looks like the ship is ready to fly! Quick! Get to the bridge and use the command console! Say 'computer, execute'"
[Not much time!]

Impact in 9.

>ask arvax about ship
(the ss usagi)
"Hurry! Get to the bridge!"

Impact in 8.

>ask arvax about ship
(the ss usagi)
"Hurry! Get to the bridge!"

Impact in 7.

>d
Galley
This narrow space is barely enough room for two Marines to prepare and eat a meal. There is a counter with a drawer, and two stools, a microwave oven, and a large closet here. Pots and pans hang from hooks in the ceiling. A ladder leads up through the midship door, and you can leave aft.

On the starboard wall is a panel on which is a blue button. Tacked to the panel is the operator's manual for the midship door.

You hear someone speaking above.

Impact in 6.

>a
Junction
This is a busy place when the ship is populated. To port and starboard are the crew quarters, aft is the closed door to the captain's private quarters, and fore is the galley. A ladder leads down to the staging area.

Impact in 5.

>z
Time passes.

Impact in 4.

>z
Time passes.

Impact in 3.

>z
Time passes.

Impact in 2.

>z
Time passes.

Impact in 1.

>z
Time passes.

You never see it happen. The SS Usagi slams into the Little New York neighborhood of New Da Nang. Several acres of buildings are flattened, killing thousands of people.

    *** You have died in ignominious failure. ***

In that game you scored 7 out of a possible 10, in 163 turns.

Well, you crashed into New Da Nang, saving neither yourself, the ship, nor the moon. All the same, you did earn some points, namely one point each for:
- fixing the aft airlock door
- fixing the microwave oven
- fixing the equipment cabinet in the starboard-side crew quarters
- fixing the storage unit in the port-side crew quarters
- fixing the fusion engine
- fixing the captain's door
- adjusting the fuel injection specification correctly

Would you like to RESTART, RESTORE a saved game, QUIT, or UNDO the last command?

>undo
Junction
[Previous turn undone.]

>undo
Galley
[Previous turn undone.]

>undo
Operations Deck
[Previous turn undone.]

>f
Bridge
This is where the captain, navigator, and pilot all sit. Large viewscreens give a full view of the space around the ship. To port you can see the blue-white disk of Deneb. Ahead, the moon New Da Nang looms steadily larger and larger before you.
 
The pilot's and navigator's chairs sit before their respective consoles. The captain's chair, with command console, sits halfway between them and operations further aft.

You hear someone speaking aft of here.

Impact in 6.

The moon of New Da Nang looms ever larger on the forward viewscreen.

>z
Time passes.

Impact in 5.

The moon of New Da Nang looms ever larger on the forward viewscreen.

>z
Time passes.

Impact in 4.

The moon of New Da Nang looms ever larger on the forward viewscreen.

>z
Time passes.

Impact in 3.

The moon of New Da Nang looms ever larger on the forward viewscreen.

>z
Time passes.

Impact in 2.

The moon of New Da Nang looms ever larger on the forward viewscreen.

>z
Time passes.

Impact in 1.

The moon of New Da Nang looms ever larger on the forward viewscreen.

>z
Time passes.

You watch helplessly as the SS Usagi slams into the Little New York neighborhood of New Da Nang. Several acres of buildings are flattened, killing thousands of people.

    *** You have died in ignominious failure. ***

In that game you scored 7 out of a possible 10, in 163 turns.

Well, you crashed into New Da Nang, saving neither yourself, the ship, nor the moon. All the same, you did earn some points, namely one point each for:
- fixing the aft airlock door
- fixing the microwave oven
- fixing the equipment cabinet in the starboard-side crew quarters
- fixing the storage unit in the port-side crew quarters
- fixing the fusion engine
- fixing the captain's door
- adjusting the fuel injection specification correctly

Would you like to RESTART, RESTORE a saved game, QUIT, or UNDO the last command?

>undo
Bridge
[Previous turn undone.]

>touch command console
Welcome, Captain. What are your orders?
You watch helplessly as the SS Usagi slams into the Little New York neighborhood of New Da Nang. Several acres of buildings are flattened, killing thousands of people.

    *** You have died in ignominious failure. ***

In that game you scored 7 out of a possible 10, in 163 turns.

Well, you crashed into New Da Nang, saving neither yourself, the ship, nor the moon. All the same, you did earn some points, namely one point each for:
- fixing the aft airlock door
- fixing the microwave oven
- fixing the equipment cabinet in the starboard-side crew quarters
- fixing the storage unit in the port-side crew quarters
- fixing the fusion engine
- fixing the captain's door
- adjusting the fuel injection specification correctly

Would you like to RESTART, RESTORE a saved game, QUIT, or UNDO the last command?

>undo
Bridge
[Previous turn undone.]

>undo
Bridge
[Previous turn undone.]

>touch command console
Welcome, Captain. What are your orders?

Impact in 1.

The moon of New Da Nang looms ever larger on the forward viewscreen.

>computer, execute
Yes, Captain. Executing evasive maneuvers.

The ship pulls out of its dive toward New Da Nang, delivering a g-force that forces the breath out of you despite the intertial dampers. Soon you are turned around and headed for open space.

Diverting communications to the bridge.

Arvax comes over comms: "Directing SS Usagi to Deneb III. Rendezvous with retrieval crew in approximately twenty-eight minutes.

"Sergeant Screwdriver, this couldn't have happened without you. You deserve to be a hero on New Da Nang, but unfortunately we need to keep this incident secret, as will no doubt be emphasized at your debriefing.

"You are to be especially commended for your judgment in determining the correct course of action when presented with a difficult choice. We have determined that Captain Mulgrew has been working with the separatists and was involved in the Omicron-5 bombing. She has been apprehended and will face the most severe justice permitted by the Space Authority.

"Now, soldier, time to relax. The crew will be there soon to pick you up."

You relax in the captain's chair and reflect on your accomplishment. At the end of the day, you can barely sleep, as the newest member of the 95th Mechanical Division Special Maintenance Force. Adventure at last!

    *** You have saved New Da Nang, the SS Usagi, and yourself! ***

In that game you scored 10 out of a possible 10, in 163 turns.

For your heroism in the face of almost certain death, we award you one point each for:
- fixing the aft airlock door
- fixing the microwave oven
- fixing the equipment cabinet in the starboard-side crew quarters
- fixing the storage unit in the port-side crew quarters
- fixing the fusion engine
- fixing the captain's door
- adjusting the fuel injection specification correctly

Additionally! We hereby award you one point for saving the SS Usagi, another point for saving yourself, and finally one more point for saving the moon New Da Nang! Congratulations!

Would you like to RESTART, RESTORE a saved game, QUIT, or UNDO the last command?

* * *

>f
Bridge (vacuum)
This is where the captain, navigator, and pilot all sit. Large viewscreens give a full view of the space around the ship. To port you can see the blue-white disk of Deneb. Astern you can faintly see the fading embers of what was Space Station Omicron-5.
 
The pilot's and navigator's chairs sit before their respective consoles. The captain's chair, with command console, sits halfway between them and operations further aft.

You hear someone speaking aft of here.

Your vac suit pings gently to indicate you have expended a unit of air.

>u
The only obvious exit is aft (to operations deck (vacuum)).

Your vac suit pings gently to indicate you have expended a unit of air.

The depressurization siren stops.

>hello
(addressing the Navigator)
When I say that "the captain, navigator, and pilot all sit" here, I don't mean they're actually here right now.

Emergency protocols complete.

Approaching New Da Nang. Beginning emergency countdown at 60.

>a
Operations Deck
This is where all of the support activity for the bridge occurs. There are large consoles for environmental controls (which include gravity, temperature, and pressure), communications, and power systems here. The bridge continues forward from here, and engineering is aft. There is a door set in the floor with a ladder leading through it. Set in the frame of the door is a blue button.

You can see an equipment trunk (closed) here.

>hello
(addressing Master Sergeant R. Mu Arvax)
"Finally! Where've you been? I'm sad to see you invoked Mulgrew's emergency protocols, but that's water under the bridge. Now we need to try to salvage the situation."

>ask arvax about the ship
(the ss usagi)
"I'm trying to divert the ship from its collision course with New Da Nang, but there are some problems: the helm is not responding to any commands and the fuel injection specification for the fusion engine is incorrect. 

"To be honest, friend, the readouts I'm seeing about the state of helm control are dire. I'm not sure it can be fixed."

* * *

>a
Engineering Deck (vacuum)
The engineering crew is responsible for keeping the physical ship operating. They are in charge of every physical aspect of the ship, from the engines to hull integrity to the life support system.

The engineering deck consists of a large console giving a comprehensive view of the physical status of the ship. There is an airlock to starboard. The operations deck continues forward from here, and there are other exits to aft and port.

You hear someone speaking to fore.

A device labeled "Suit Recharging Station" is here. It is shaped like a chair with nozzles protruding from either arm.

Your vac suit pings gently to indicate you have expended a unit of air.

>a
Engine Room (vacuum)
This where the combustion process is controlled. The aft wall is dominated by the operating panel of the fusion engine. Monitoring electronics and controls cover the other two walls. A doorway opens forward to the Engineering Deck.

There is a large screen on the forward wall. It displays nothing right now. There is a large button below the diagram labeled "Test".

You can see a broken JL-758 here.

Your vac suit pings gently to indicate you have expended a unit of air.

The depressurization siren stops.

>l
Engine Room
This where the combustion process is controlled. The aft wall is dominated by the operating panel of the fusion engine. Monitoring electronics and controls cover the other two walls. A doorway opens forward to the Engineering Deck.

There is a large screen on the forward wall. It displays nothing right now. There is a large button below the diagram labeled "Test".

You can see a broken JL-758 here.

Emergency protocols complete.

Approaching New Da Nang. Beginning emergency countdown at 60.

>l
Engine Room
This where the combustion process is controlled. The aft wall is dominated by the operating panel of the fusion engine. Monitoring electronics and controls cover the other two walls. A doorway opens forward to the Engineering Deck.

There is a large diagram of the fuel injection process on the forward wall. There is a large button below the diagram labeled "Test".

You can see a broken JL-758 here.

>read screen
This is a diagram of the fuel injection process for the fusion engine. Printed above it is the label "Delphi Engine Controls Aleph-Null". Below that is a representation of the various inputs and the products created during the fuel injection process. Each input has a touch-sensitive surface which can be used to alter the diagram's settings.

       Input: 2 --  3 --  4 --
                ||    ||    ||
             ===vv====vv====vv===
Input 1:     -- >> -- >> -- >> --  Output
             ====================

        FUEL INJECTION SPECIFICATION INCOMPLETE

Key:    --   empty input or output
        AH   Anti-Helium
        LC   Liquid Copernicium*
        Og   Oganesson
        RM   Red Matter            
        TC   Tachyon Crystals
        Un   Unobtainium
        VM   Void Matter*

        * this substance can only be produced, not input.

⇒ Use "substance > input" to set each input. For instance, "Un > 3" sets input 3 to Unobtainium. You may also use "set <input> to <substance>" for the same effect. Use "disconnect <input>" to disconnect an input.

>read diagram
This is a diagram of the fuel injection process for the fusion engine. Printed above it is the label "Delphi Engine Controls Aleph-Null". Below that is a representation of the various inputs and the products created during the fuel injection process. Each input has a touch-sensitive surface which can be used to alter the diagram's settings.

       Input: 2 --  3 --  4 --
                ||    ||    ||
             ===vv====vv====vv===
Input 1:     -- >> -- >> -- >> --  Output
             ====================

        FUEL INJECTION SPECIFICATION INCOMPLETE

Key:    --   empty input or output
        AH   Anti-Helium
        LC   Liquid Copernicium*
        Og   Oganesson
        RM   Red Matter            
        TC   Tachyon Crystals
        Un   Unobtainium
        VM   Void Matter*

        * this substance can only be produced, not input.

⇒ Use "substance > input" to set each input. For instance, "Un > 3" sets input 3 to Unobtainium. You may also use "set <input> to <substance>" for the same effect. Use "disconnect <input>" to disconnect an input.

>x diagram
This is a diagram of the fuel injection process for the fusion engine. Printed above it is the label "Delphi Engine Controls Aleph-Null". Below that is a representation of the various inputs and the products created during the fuel injection process. Each input has a touch-sensitive surface which can be used to alter the diagram's settings.

       Input: 2 --  3 --  4 --
                ||    ||    ||
             ===vv====vv====vv===
Input 1:     -- >> -- >> -- >> --  Output
             ====================

        FUEL INJECTION SPECIFICATION INCOMPLETE

Key:    --   empty input or output
        AH   Anti-Helium
        LC   Liquid Copernicium*
        Og   Oganesson
        RM   Red Matter            
        TC   Tachyon Crystals
        Un   Unobtainium
        VM   Void Matter*

        * this substance can only be produced, not input.

⇒ Use "substance > input" to set each input. For instance, "Un > 3" sets input 3 to Unobtainium. You may also use "set <input> to <substance>" for the same effect. Use "disconnect <input>" to disconnect an input.

* * *

>a
Engine Room (vacuum)
This where the combustion process is controlled. The aft wall is dominated by the operating panel of the fusion engine. Monitoring electronics and controls cover the other two walls. A doorway opens forward to the Engineering Deck.

There is a large screen on the forward wall. It displays nothing right now. There is a large button below the diagram labeled "Test".

You can see a broken JL-758 here.

Your vac suit pings gently to indicate you have expended a unit of air.

The depressurization siren stops.

>read screen
There is nothing to read on the engine diagram.

Emergency protocols complete.

Approaching New Da Nang. Beginning emergency countdown at 60.

>x screen
This is a diagram of the fuel injection process for the fusion engine. Printed above it is the label "Delphi Engine Controls Aleph-Null". Below that is a representation of the various inputs and the products created during the fuel injection process. Each input has a touch-sensitive surface which can be used to alter the diagram's settings.

       Input: 2 --  3 --  4 --
                ||    ||    ||
             ===vv====vv====vv===
Input 1:     -- >> -- >> -- >> --  Output
             ====================

        FUEL INJECTION SPECIFICATION INCOMPLETE

Key:    --   empty input or output
        AH   Anti-Helium
        LC   Liquid Copernicium*
        Og   Oganesson
        RM   Red Matter            
        TC   Tachyon Crystals
        Un   Unobtainium
        VM   Void Matter*

        * this substance can only be produced, not input.

⇒ Use "substance > input" to set each input. For instance, "Un > 3" sets input 3 to Unobtainium. You may also use "set <input> to <substance>" for the same effect. Use "disconnect <input>" to disconnect an input.

>l
Engine Room
This where the combustion process is controlled. The aft wall is dominated by the operating panel of the fusion engine. Monitoring electronics and controls cover the other two walls. A doorway opens forward to the Engineering Deck.

There is a large diagram of the fuel injection process on the forward wall. There is a large button below the diagram labeled "Test".

You can see a broken JL-758 here.

>read screen
There is nothing to read on the engine diagram.

* * *

>d
Galley (vacuum)
This narrow space is barely enough room for two Marines to prepare and eat a meal. There is a counter with a drawer, and two stools, a microwave oven, and a large closet here. Pots and pans hang from hooks in the ceiling. A ladder leads up through the midship door, and you can leave aft.

On the starboard wall is a panel on which is a blue button. Tacked to the panel is the operator's manual for the midship door.

You hear someone speaking above.

Your vac suit pings gently to indicate you have expended a unit of air.

>u
Operations Deck (vacuum)
This is where all of the support activity for the bridge occurs. There are large consoles for environmental controls (which include gravity, temperature, and pressure), communications, and power systems here. The bridge continues forward from here, and engineering is aft. There is a door set in the floor with a ladder leading through it. Set in the frame of the door is a blue button.

You can see an equipment trunk (closed) here.

Your vac suit pings gently to indicate you have expended a unit of air.

The depressurization siren stops.

>hello
There's no one here but you.

Emergency protocols complete.

Approaching New Da Nang. Beginning emergency countdown at 60.

>hello
(addressing Master Sergeant R. Mu Arvax)
"Finally! Where've you been? I'm sad to see you invoked Mulgrew's emergency protocols, but that's water under the bridge. Now we need to try to salvage the situation."

"I'm trying to divert the ship from its collision course with New Da Nang, but there are some problems: the helm is not responding to any commands and the fuel injection specification for the fusion engine is incorrect. 

"To be honest, friend, the readouts I'm seeing about the state of helm control are dire. I'm not sure it can be fixed."

>f
Bridge
This is where the captain, navigator, and pilot all sit. Large viewscreens give a full view of the space around the ship. To port you can see the blue-white disk of Deneb. Astern you can faintly see the fading embers of what was Space Station Omicron-5.
 
The pilot's and navigator's chairs sit before their respective consoles. The captain's chair, with command console, sits halfway between them and operations further aft.

You hear someone speaking aft of here.

>x helm
(the helm table)
The helm is a sloped table covered with cryptic readouts and touch controls. In the back is an access panel which is closed. A hex-shaped aperture is probably the locking mechanism.

>open panel
(the helm access panel)
It seems to be locked.

>open panel with hex
(the helm access panel with the hex-shaped tool)
You unlock the helm access panel.

>open it
Opening the helm access panel reveals a fused mass of wiring and circuit boards. It's ruined beyond repair.

>take wiring
That's hardly portable.

>x it
It's ruined.

>x boards
It's ruined.

>a
"I'm sorry, I don't think the helm can be fixed -- not with the time you have left. You're going to have to destroy the ship."
[Oh god, this is it.]

>a
Engineering Deck
The engineering crew is responsible for keeping the physical ship operating. They are in charge of every physical aspect of the ship, from the engines to hull integrity to the life support system.

The engineering deck consists of a large console giving a comprehensive view of the physical status of the ship. There is an airlock to starboard. The operations deck continues forward from here, and there are other exits to aft and port.

You hear someone speaking to fore.

A device labeled "Suit Recharging Station" is here. It is shaped like a chair with nozzles protruding from either arm.

>a
Engine Room
This where the combustion process is controlled. The aft wall is dominated by the operating panel of the fusion engine. Monitoring electronics and controls cover the other two walls. A doorway opens forward to the Engineering Deck.

There is a large diagram of the fuel injection process on the forward wall. There is a large button below the diagram labeled "Test".

You can see a broken JL-758 here.

* * *

>ask computer about vm
Void Matter is essentially vacuum condensed into matter, according to the most comprehensible description we could find. It is an extremely unstable substance, and tends to explode catastrophically in the presence of high levels of energy. It can be created by injecting one source of tachyon crystals into another source of tachyon crystals.

>ask computer about TC
Rather than containing or being formed of tachyons, tachyon crystals get their name from their use in detecting tachyons, due to their negative refractive index. The typical method of creating tachyon crystals is injecting Anti-Helium into Red Matter. Tachyon Crystals can be used in the creation of Void Matter.

>ask computer about RM
Red Matter is an unstable, possibly impossible substance created by injecting Tachyon Crystals into Unobtainium.

>un > 1
This is a diagram of the fuel injection process for the fusion engine. Printed above it is the label "Delphi Engine Controls Aleph-Null". Below that is a representation of the various inputs and the products created during the fuel injection process. Each input has a touch-sensitive surface which can be used to alter the diagram's settings.

       Input: 2 --  3 --  4 --
                ||    ||    ||
             ===vv====vv====vv===
Input 1:     Un >> -- >> -- >> --  Output
             ====================

        FUEL INJECTION SPECIFICATION INCOMPLETE

Key:    --   empty input or output
        AH   Anti-Helium
        LC   Liquid Copernicium*
        Og   Oganesson
        RM   Red Matter            
        TC   Tachyon Crystals
        Un   Unobtainium
        VM   Void Matter*

        * this substance can only be produced, not input.

⇒ Use "substance > input" to set each input. For instance, "Un > 3" sets input 3 to Unobtainium. You may also use "set <input> to <substance>" for the same effect. Use "disconnect <input>" to disconnect an input.

>tc > 2
This is a diagram of the fuel injection process for the fusion engine. Printed above it is the label "Delphi Engine Controls Aleph-Null". Below that is a representation of the various inputs and the products created during the fuel injection process. Each input has a touch-sensitive surface which can be used to alter the diagram's settings.

       Input: 2 TC  3 --  4 --
                ||    ||    ||
             ===vv====vv====vv===
Input 1:     Un >> RM >> -- >> --  Output
             ====================

        FUEL INJECTION SPECIFICATION INCOMPLETE

Key:    --   empty input or output
        AH   Anti-Helium
        LC   Liquid Copernicium*
        Og   Oganesson
        RM   Red Matter            
        TC   Tachyon Crystals
        Un   Unobtainium
        VM   Void Matter*

        * this substance can only be produced, not input.

⇒ Use "substance > input" to set each input. For instance, "Un > 3" sets input 3 to Unobtainium. You may also use "set <input> to <substance>" for the same effect. Use "disconnect <input>" to disconnect an input.

>ah > 3
This is a diagram of the fuel injection process for the fusion engine. Printed above it is the label "Delphi Engine Controls Aleph-Null". Below that is a representation of the various inputs and the products created during the fuel injection process. Each input has a touch-sensitive surface which can be used to alter the diagram's settings.

       Input: 2 TC  3 AH  4 --
                ||    ||    ||
             ===vv====vv====vv===
Input 1:     Un >> RM >> TC >> --  Output
             ====================

        FUEL INJECTION SPECIFICATION INCOMPLETE

Key:    --   empty input or output
        AH   Anti-Helium
        LC   Liquid Copernicium*
        Og   Oganesson
        RM   Red Matter            
        TC   Tachyon Crystals
        Un   Unobtainium
        VM   Void Matter*

        * this substance can only be produced, not input.

⇒ Use "substance > input" to set each input. For instance, "Un > 3" sets input 3 to Unobtainium. You may also use "set <input> to <substance>" for the same effect. Use "disconnect <input>" to disconnect an input.

>tc > 4
This is a diagram of the fuel injection process for the fusion engine. Printed above it is the label "Delphi Engine Controls Aleph-Null". Below that is a representation of the various inputs and the products created during the fuel injection process. Each input has a touch-sensitive surface which can be used to alter the diagram's settings.

       Input: 2 TC  3 AH  4 TC
                ||    ||    ||
             ===vv====vv====vv===
Input 1:     Un >> RM >> TC >> VM  Output
             ====================

        WARNING: DANGEROUS INJECTION PRODUCT

Key:    --   empty input or output
        AH   Anti-Helium
        LC   Liquid Copernicium*
        Og   Oganesson
        RM   Red Matter            
        TC   Tachyon Crystals
        Un   Unobtainium
        VM   Void Matter*

        * this substance can only be produced, not input.

⇒ Use "substance > input" to set each input. For instance, "Un > 3" sets input 3 to Unobtainium. You may also use "set <input> to <substance>" for the same effect. Use "disconnect <input>" to disconnect an input.

>f
Engineering Deck
The engineering crew is responsible for keeping the physical ship operating. They are in charge of every physical aspect of the ship, from the engines to hull integrity to the life support system.

The engineering deck consists of a large console giving a comprehensive view of the physical status of the ship. There is an airlock to starboard. The operations deck continues forward from here, and there are other exits to aft and port.

You hear someone speaking to fore.

A device labeled "Suit Recharging Station" is here. It is shaped like a chair with nozzles protruding from either arm.

>f
"I'm sorry, I don't think the helm can be fixed -- not with the time you have left. You're going to have to destroy the ship."
[Oh god, this is it.]

>ask arvax about ship
(the ss usagi)
"I'm sorry, I don't think the helm can be fixed -- not with the time you have left. You're going to have to destroy the ship."
[Oh god, this is it.]

>ask arvax about engine
(the fusion engine)
"Friend, if I were to start the fusion engine with the fuel injection you've specified, the ship would explode. Are you sure there is no other option to save the people of New Da Nang?"

⇒ If you really want to blow up the ship, enter "Arvax, self-destruct" to start the countdown from 10, or press the test button in the engine room.

>arvax, self-destruct
"9"

>s
The obvious exits are fore (to bridge), aft (to engineering deck) and down (to galley).

Master Sergeant R. Mu Arvax: "You there, Usagi? We don't have much time."

"8"

>a
Engineering Deck
The engineering crew is responsible for keeping the physical ship operating. They are in charge of every physical aspect of the ship, from the engines to hull integrity to the life support system.

The engineering deck consists of a large console giving a comprehensive view of the physical status of the ship. There is an airlock to starboard. The operations deck continues forward from here, and there are other exits to aft and port.

You hear someone speaking to fore.

A device labeled "Suit Recharging Station" is here. It is shaped like a chair with nozzles protruding from either arm.

"7"

>s
Engineering Airlock
You are in the engineering airlock. Outside, the space to starboard looks so empty and peaceful it's hard to imagine the awful sight astern.

"6"

>out
You propel yourself away from the ship, away from the explosion that follows moments later. You switch on your beacon. Hours later, after you'd given up hope, a ship of the Space Marines finds you and brings you home. You are sorry you couldn't save the SS Usagi, but for your part in saving the people of New Da Nang, you receive a medal for meritorious service and are promoted to Lance Corporal.

    *** You saved New Da Nang, but lost the ship. ***

In that game you scored 8 out of a possible 10, in 168 turns.

Hooray for saving New Da Nang! The Space Marine leadership is less happy about losing the SS Usagi. But here's your score breakdown. You get one point each for:
- fixing the aft airlock door
- fixing the microwave oven
- fixing the equipment cabinet in the starboard-side crew quarters
- fixing the storage unit in the port-side crew quarters
- fixing the fusion engine
- fixing the captain's door

You also get a point for saving yourself, and a point for saving New Da Nang! Congratulations!

Would you like to RESTART, RESTORE a saved game, QUIT, or UNDO the last command?

* * *

>arvax, self-destruct
"9"

>z
Time passes.

Master Sergeant R. Mu Arvax: "You there, Usagi? We don't have much time."

>rules
Rules tracing now switched on. Type "rules off" to switch it off again, or "rules all" to include even rules which do not apply.

[Rule "reset report text rule" applies.]

>arvax, self-destruct
[Rule "After reading a command" applies.]
[Rule "After deciding the scope of the player when location is Operations" applies.]
[Rule "computer is everywhere rule" applies.]
[Rule "After deciding the scope of the player when location is Operations" applies.]
[Rule "computer is everywhere rule" applies.]
[Rule "declare everything initially unmentioned rule" applies.]
[Rule "announce items from multiple object lists rule" applies.]
[Rule "set pronouns from items from multiple object lists rule" applies.]
[Rule "before stage rule" applies.]
[Rule "Before" applies.]
[Rule "new instead stage rule" applies.]
[Rule "Persuasion rule when asking Arvax to try self-destructing" applies.]
[Rule "announce items from multiple object lists rule" applies.]
[Rule "set pronouns from items from multiple object lists rule" applies.]
[Rule "before stage rule" applies.]
[Rule "Before" applies.]
[Rule "new instead stage rule" applies.]
[Rule "investigate player's awareness before action rule" applies.]
[Rule "player aware of his own actions rule" applies.]
[Rule "player aware of actions by visible actors rule" applies.]
[Rule "After deciding the scope of the player when location is Operations" applies.]
[Rule "computer is everywhere rule" applies.]
[Rule "check stage rule" applies.]
[Rule "carry out stage rule" applies.]
[Rule "Carry out Arvax self-destructing" applies.]
[Rule "after stage rule" applies.]
[Rule "investigate player's awareness after action rule" applies.]
[Rule "report stage rule" applies.]
[Rule "pre-report rule" applies.]
[Rule "last specific action-processing rule" applies.]
[Rule "A first turn sequence rule" applies.]
[Rule "post-report rule" applies.]
[Rule "every turn stage rule" applies.]
[Rule "Every turn when last-moves is true or protocols-activated is true" applies.]
[Rule "Every turn when ( not talking about asking mulgrew questions ) and computer-rebooting is false and protocols-in-progress is false and last-moves is false" applies.]
[Rule "reset protocol rule" applies.]
[Rule "Every turn" applies.]
[Rule "close open doors rule" applies.]
[Rule "A last turn sequence rule" applies.]
[Rule "notify score changes rule" applies.]
[Rule "reset report text rule" applies.]

>undo
Operations Deck
[Previous turn undone.]

>i
You are carrying:
  the captain's journal
  a blown fuse
  a copy of Planetfall
  the red access card
  an Universal Game Emulator
  a piece of note paper
  a beacon
  a microwavable dinner
  a knife
  a hex-shaped tool
  a roll of electrical tape
  a small key
  a portable hand-held vacuum cleaner
  a vac suit (being worn)
  a broken sensor
  Bertie the Bear™
  some pair of slippers
  a To-Do list
  a repair corps uniform (being worn)
  a toolbox

>ask arvax about ship
(the ss usagi)
"I'm sorry, I don't think the helm can be fixed -- not with the time you have left. You're going to have to destroy the ship."
[Oh god, this is it.]

>ask arvax about engine
(the fusion engine)
"Friend, if I were to start the fusion engine with the fuel injection you've specified, the ship would explode. Are you sure there is no other option to save the people of New Da Nang?"⇒ If you really want to blow up the ship, enter "Arvax, self-destruct" to start the countdown from 10, or press the test button in the engine room.

>rule
I'm not sure what you're trying to say. I might just not recognize the words you're using.

>rules
Rules tracing now switched on. Type "rules off" to switch it off again, or "rules all" to include even rules which do not apply.

[Rule "reset report text rule" applies.]

* * *

>z
[Rule "After reading a command" applies.]
[Rule "declare everything initially unmentioned rule" applies.]
[Rule "announce items from multiple object lists rule" applies.]
[Rule "set pronouns from items from multiple object lists rule" applies.]
[Rule "before stage rule" applies.]
[Rule "Before" applies.]
[Rule "new instead stage rule" applies.]
[Rule "investigate player's awareness before action rule" applies.]
[Rule "player aware of his own actions rule" applies.]
[Rule "check stage rule" applies.]
[Rule "carry out stage rule" applies.]
[Rule "after stage rule" applies.]
[Rule "investigate player's awareness after action rule" applies.]
[Rule "report stage rule" applies.]
[Rule "standard report waiting rule" applies.]
Time passes.
[Rule "pre-report rule" applies.]
[Rule "last specific action-processing rule" applies.]

[Rule "A first turn sequence rule" applies.]
[Rule "post-report rule" applies.]
[Rule "every turn stage rule" applies.]
[Rule "Every turn when last-moves is true or protocols-activated is true" applies.]
[Rule "Every turn when ( not talking about asking mulgrew questions ) and computer-rebooting is false and protocols-in-progress is false and last-moves is false" applies.]
[Rule "For asking for attention by Arvax while talking about cs-end-game-protocols" applies.]
Master Sergeant R. Mu Arvax: "You there, Usagi? We don't have much time."
[Rule "Arvax reminder text rule" applies.]

[Rule "reset protocol rule" applies.]
[Rule "Every turn" applies.]
[Rule "close open doors rule" applies.]
[Rule "A last turn sequence rule" applies.]
[Rule "notify score changes rule" applies.]
[Rule "reset report text rule" applies.]

>z
[Rule "After reading a command" applies.]
[Rule "declare everything initially unmentioned rule" applies.]
[Rule "announce items from multiple object lists rule" applies.]
[Rule "set pronouns from items from multiple object lists rule" applies.]
[Rule "before stage rule" applies.]
[Rule "Before" applies.]
[Rule "new instead stage rule" applies.]
[Rule "investigate player's awareness before action rule" applies.]
[Rule "player aware of his own actions rule" applies.]
[Rule "check stage rule" applies.]
[Rule "carry out stage rule" applies.]
[Rule "after stage rule" applies.]
[Rule "investigate player's awareness after action rule" applies.]
[Rule "report stage rule" applies.]
[Rule "standard report waiting rule" applies.]
Time passes.
[Rule "pre-report rule" applies.]
[Rule "last specific action-processing rule" applies.]

[Rule "A first turn sequence rule" applies.]
[Rule "post-report rule" applies.]
[Rule "every turn stage rule" applies.]
[Rule "Every turn when last-moves is true or protocols-activated is true" applies.]
[Rule "Every turn when ( not talking about asking mulgrew questions ) and computer-rebooting is false and protocols-in-progress is false and last-moves is false" applies.]
[Rule "reset protocol rule" applies.]
[Rule "Every turn" applies.]
[Rule "close open doors rule" applies.]
[Rule "A last turn sequence rule" applies.]
[Rule "notify score changes rule" applies.]
[Rule "reset report text rule" applies.]

>z
[Rule "After reading a command" applies.]
[Rule "declare everything initially unmentioned rule" applies.]
[Rule "announce items from multiple object lists rule" applies.]
[Rule "set pronouns from items from multiple object lists rule" applies.]
[Rule "before stage rule" applies.]
[Rule "Before" applies.]
[Rule "new instead stage rule" applies.]
[Rule "investigate player's awareness before action rule" applies.]
[Rule "player aware of his own actions rule" applies.]
[Rule "check stage rule" applies.]
[Rule "carry out stage rule" applies.]
[Rule "after stage rule" applies.]
[Rule "investigate player's awareness after action rule" applies.]
[Rule "report stage rule" applies.]
[Rule "standard report waiting rule" applies.]
Time passes.
[Rule "pre-report rule" applies.]
[Rule "last specific action-processing rule" applies.]

[Rule "A first turn sequence rule" applies.]
[Rule "post-report rule" applies.]
[Rule "every turn stage rule" applies.]
[Rule "Every turn when last-moves is true or protocols-activated is true" applies.]
[Rule "Every turn when ( not talking about asking mulgrew questions ) and computer-rebooting is false and protocols-in-progress is false and last-moves is false" applies.]
[Rule "For asking for attention by Arvax while talking about cs-end-game-protocols" applies.]
Master Sergeant R. Mu Arvax: "You there, Usagi? We don't have much time."
[Rule "Arvax reminder text rule" applies.]

[Rule "reset protocol rule" applies.]
[Rule "Every turn" applies.]
[Rule "close open doors rule" applies.]
[Rule "A last turn sequence rule" applies.]
[Rule "notify score changes rule" applies.]
[Rule "reset report text rule" applies.]

* * *

>f
Bridge (vacuum)
This is where the captain, navigator, and pilot all sit. Large viewscreens give a full view of the space around the ship. To port you can see the blue-white disk of Deneb. Astern you can faintly see the fading embers of what was Space Station Omicron-5.
 
The pilot's and navigator's chairs sit before their respective consoles. The captain's chair, with command console, sits halfway between them and operations further aft.

You hear someone speaking aft of here.

Your vac suit pings gently to indicate you have expended a unit of air.

>a
Operations Deck (vacuum)
This is where all of the support activity for the bridge occurs. There are large consoles for environmental controls (which include gravity, temperature, and pressure), communications, and power systems here. The bridge continues forward from here, and engineering is aft. There is a door set in the floor with a ladder leading through it. Set in the frame of the door is a blue button.

You can see an equipment trunk (closed) here.

Your vac suit pings gently to indicate you have expended a unit of air.

The depressurization siren stops.

>f
Bridge
This is where the captain, navigator, and pilot all sit. Large viewscreens give a full view of the space around the ship. To port you can see the blue-white disk of Deneb. Astern you can faintly see the fading embers of what was Space Station Omicron-5.
 
The pilot's and navigator's chairs sit before their respective consoles. The captain's chair, with command console, sits halfway between them and operations further aft.

You hear someone speaking aft of here.

Emergency protocols complete.

Approaching New Da Nang. Beginning emergency countdown at 60.

>a
"I'm trying to divert the ship from its collision course with New Da Nang, but there are some problems: the helm is not responding to any commands and the fuel injection specification for the fusion engine is incorrect. 

"To be honest, friend, the readouts I'm seeing about the state of helm control are dire. I'm not sure it can be fixed."

>hello
(addressing Master Sergeant R. Mu Arvax)
"Finally! Where've you been? I'm sad to see you invoked Mulgrew's emergency protocols, but that's water under the bridge. Now we need to try to salvage the situation."

* * *

>a
Operations Deck (vacuum)
This is where all of the support activity for the bridge occurs. There are large consoles for environmental controls (which include gravity, temperature, and pressure), communications, and power systems here. The bridge continues forward from here, and engineering is aft. There is a door set in the floor with a ladder leading through it. Set in the frame of the door is a blue button.

You can see an equipment trunk (closed) here.

Your vac suit pings gently to indicate you have expended a unit of air.

The depressurization siren stops.

>hello
There's no one here but you.

Emergency protocols complete.

Approaching New Da Nang. Beginning emergency countdown at 60.

>hello
(addressing Master Sergeant R. Mu Arvax)
"Finally! Where've you been? I'm sad to see you invoked Mulgrew's emergency protocols, but that's water under the bridge. Now we need to try to salvage the situation."

>f
Bridge
This is where the captain, navigator, and pilot all sit. Large viewscreens give a full view of the space around the ship. To port you can see the blue-white disk of Deneb. Astern you can faintly see the fading embers of what was Space Station Omicron-5.
 
The pilot's and navigator's chairs sit before their respective consoles. The captain's chair, with command console, sits halfway between them and operations further aft.

You hear someone speaking aft of here.

>a
Operations Deck
This is where all of the support activity for the bridge occurs. There are large consoles for environmental controls (which include gravity, temperature, and pressure), communications, and power systems here. The bridge continues forward from here, and engineering is aft. There is a door set in the floor with a ladder leading through it. Set in the frame of the door is a blue button.

You can see an equipment trunk (closed) here.

Master Sergeant R. Mu Arvax: "You there, Usagi? We don't have much time."

* * *

>test captain
Please give one of the answers above.

Would you like to RESTART, RESTORE a saved game, QUIT, or UNDO the last command?

>test tether
Please give one of the answers above.

Would you like to RESTART, RESTORE a saved game, QUIT, or UNDO the last command?

* * *

>d
Please give one of the answers above.

Would you like to RESTART, RESTORE a saved game, QUIT, or UNDO the last command?

>turn locker
Please give one of the answers above.

Would you like to RESTART, RESTORE a saved game, QUIT, or UNDO the last command?

>open locker
Please give one of the answers above.

Would you like to RESTART, RESTORE a saved game, QUIT, or UNDO the last command?

* * *

>hello
Please give one of the answers above.

Would you like to RESTART, RESTORE a saved game, QUIT, or UNDO the last command?

>hello
Please give one of the answers above.

Would you like to RESTART, RESTORE a saved game, QUIT, or UNDO the last command?

* * *

>tell arvax about journal
Please give one of the answers above.

Would you like to RESTART, RESTORE a saved game, QUIT, or UNDO the last command?

>computer, access code 3
Please give one of the answers above.

Would you like to RESTART, RESTORE a saved game, QUIT, or UNDO the last command?

>computer, emergency protocols
Please give one of the answers above.

Would you like to RESTART, RESTORE a saved game, QUIT, or UNDO the last command?

>d
Please give one of the answers above.

Would you like to RESTART, RESTORE a saved game, QUIT, or UNDO the last command?

>u
Please give one of the answers above.

Would you like to RESTART, RESTORE a saved game, QUIT, or UNDO the last command?

>hello
Please give one of the answers above.

Would you like to RESTART, RESTORE a saved game, QUIT, or UNDO the last command?

>f
Please give one of the answers above.

Would you like to RESTART, RESTORE a saved game, QUIT, or UNDO the last command?

>x helm
Please give one of the answers above.

Would you like to RESTART, RESTORE a saved game, QUIT, or UNDO the last command?

>open panel
Please give one of the answers above.

Would you like to RESTART, RESTORE a saved game, QUIT, or UNDO the last command?

>open panel with hex
Please give one of the answers above.

Would you like to RESTART, RESTORE a saved game, QUIT, or UNDO the last command?

>open it
Please give one of the answers above.

Would you like to RESTART, RESTORE a saved game, QUIT, or UNDO the last command?

>take wiring
Please give one of the answers above.

Would you like to RESTART, RESTORE a saved game, QUIT, or UNDO the last command?

>x it
Please give one of the answers above.

Would you like to RESTART, RESTORE a saved game, QUIT, or UNDO the last command?

>x boards
Please give one of the answers above.

Would you like to RESTART, RESTORE a saved game, QUIT, or UNDO the last command?

>a
Please give one of the answers above.

Would you like to RESTART, RESTORE a saved game, QUIT, or UNDO the last command?

>a
Please give one of the answers above.

Would you like to RESTART, RESTORE a saved game, QUIT, or UNDO the last command?

>x diagram
Please give one of the answers above.

Would you like to RESTART, RESTORE a saved game, QUIT, or UNDO the last command?

>ask computer about vm
Please give one of the answers above.

Would you like to RESTART, RESTORE a saved game, QUIT, or UNDO the last command?

>ask computer about TC
Please give one of the answers above.

Would you like to RESTART, RESTORE a saved game, QUIT, or UNDO the last command?

>ask computer about RM
Please give one of the answers above.

Would you like to RESTART, RESTORE a saved game, QUIT, or UNDO the last command?

>un > 1
Please give one of the answers above.

Would you like to RESTART, RESTORE a saved game, QUIT, or UNDO the last command?

>tc > 2
Please give one of the answers above.

Would you like to RESTART, RESTORE a saved game, QUIT, or UNDO the last command?

>ah > 3
Please give one of the answers above.

Would you like to RESTART, RESTORE a saved game, QUIT, or UNDO the last command?

>tc > 4
Please give one of the answers above.

Would you like to RESTART, RESTORE a saved game, QUIT, or UNDO the last command?

>f
Please give one of the answers above.

Would you like to RESTART, RESTORE a saved game, QUIT, or UNDO the last command?

>ask arvax about ship
Please give one of the answers above.

Would you like to RESTART, RESTORE a saved game, QUIT, or UNDO the last command?

>ask arvax about engine
Please give one of the answers above.

Would you like to RESTART, RESTORE a saved game, QUIT, or UNDO the last command?

* * *

>d
Galley
This narrow space is barely enough room for two Marines to prepare and eat a meal. There is a counter with a drawer, and two stools, a microwave oven, and a large closet here. Pots and pans hang from hooks in the ceiling. A ladder leads up through the midship door, and you can leave aft.

On the starboard wall is a panel on which is a blue button. Tacked to the panel is the operator's manual for the midship door.

You hear someone speaking above.

>u
Operations Deck
This is where all of the support activity for the bridge occurs. There are large consoles for environmental controls (which include gravity, temperature, and pressure), communications, and power systems here. The bridge continues forward from here, and engineering is aft. There is a door set in the floor with a ladder leading through it. Set in the frame of the door is a blue button.

You can see an equipment trunk (closed) here.

>z
Time passes.

Master Sergeant R. Mu Arvax: "You there, Usagi? We don't have much time."

>d
Galley
This narrow space is barely enough room for two Marines to prepare and eat a meal. There is a counter with a drawer, and two stools, a microwave oven, and a large closet here. Pots and pans hang from hooks in the ceiling. A ladder leads up through the midship door, and you can leave aft.

On the starboard wall is a panel on which is a blue button. Tacked to the panel is the operator's manual for the midship door.

You hear someone speaking above.

* * *

>u
Operations Deck
This is where all of the support activity for the bridge occurs. There are large consoles for environmental controls (which include gravity, temperature, and pressure), communications, and power systems here. The bridge continues forward from here, and engineering is aft. There is a door set in the floor with a ladder leading through it. Set in the frame of the door is a blue button.

You can see an equipment trunk (closed) here.

Master Sergeant R. Mu Arvax: "You there, Usagi? We don't have much time."

>hello
(addressing Master Sergeant R. Mu Arvax)
"You're back! Great job rebooting the computer -- I'm getting telemetry now."

>hello
You are already talking to Master Sergeant R. Mu Arvax.

>ask arvax about ship
(the ss usagi)
"I'm seeing the engine fully online. Now you need to get the fuel specification right."

You add an item ("adjust fuel injection specification") to your to-do list.

* * *

>d
Galley
This narrow space is barely enough room for two Marines to prepare and eat a meal. There is a counter with a drawer, and two stools, a microwave oven, and a large closet here. Pots and pans hang from hooks in the ceiling. A ladder leads up through the midship door, and you can leave aft.

On the starboard wall is a panel on which is a blue button. Tacked to the panel is the operator's manual for the midship door.

You hear someone speaking above.

>u
"I'm seeing the engine fully online. Now you need to get the fuel specification right."

You add an item ("adjust fuel injection specification") to your to-do list.

>hello
(addressing Master Sergeant R. Mu Arvax)
"You're back! Great job rebooting the computer -- I'm getting telemetry now."

* * *

>ask arvax about asdf
"You're back! Great job rebooting the computer -- I'm getting telemetry now."
"I'm trying to divert the ship from its collision course with New Da Nang, but there's a problem: the fuel injection specification for the fusion engine is incorrect."

"I'm afraid I don't have anything to say about that."

You add an item ("adjust fuel injection specification") to your to-do list.

>ask arvax about asdf
"I'm afraid I don't have anything to say about that."

>ask arvax about asdf
"I'm afraid I don't have anything to say about that."

>ask arvax about access code
"Just say 'Computer, access code 2'."

>c
I'm not sure what you're trying to say. I might just not recognize the words you're using.

>x
(the portable hand-held vacuum cleaner)
A small canister vacuum, with a handle to easily carry it around, and a short hose.

>i
You are carrying:
  the captain's journal
  a blown fuse
  a copy of Planetfall
  the red access card
  an Universal Game Emulator
  a piece of note paper
  a beacon
  a microwavable dinner
  a knife
  a hex-shaped tool
  a roll of electrical tape
  a small key
  a portable hand-held vacuum cleaner
  a vac suit (being worn)
  a broken sensor
  Bertie the Bear™
  some pair of slippers
  a To-Do list
  a repair corps uniform (being worn)
  a toolbox

Master Sergeant R. Mu Arvax: "You there, Usagi? We don't have much time."

>pronouns
At the moment, "it" means the portable hand-held vacuum cleaner, "him" means Master Sergeant R. Mu Arvax, "her" is unset, and "them" means the machine room drawers.

>x key
A small steel key.

>x
(the portable hand-held vacuum cleaner)
A small canister vacuum, with a handle to easily carry it around, and a short hose.

Master Sergeant R. Mu Arvax: "You there, Usagi? We don't have much time."

>x key
A small steel key.

>pronouns
At the moment, "it" means the small key, "him" means Master Sergeant R. Mu Arvax, "her" is unset, and "them" means the machine room drawers.

>x it
A small steel key.

Master Sergeant R. Mu Arvax: "You there, Usagi? We don't have much time."

>x
(the portable hand-held vacuum cleaner)
A small canister vacuum, with a handle to easily carry it around, and a short hose.

* * *

>computer, emergency protocols
Authorization required.

>computer, access code 3
Welcome, Captain Jane Mulgrew. Logging you in.

>computer, emergency protocols
Beginning emergency protocols. Take all appropriate precautions.

Red alert lights flash throughout the ship.

The emergency depressurization siren sounds throughout the ship.
[Nice of Mulgrew to warn me.]

>hello
There's no one here but you.

Your vac suit pings gently to indicate you have expended a unit of air.

* * *

>z
Time passes.

Emergency protocols complete.
Approaching New Da Nang. Beginning emergency countdown at 60.

>hello
(addressing Master Sergeant R. Mu Arvax)
"Finally! Where've you been? I'm sad to see you invoked Mulgrew's emergency protocols, but that's water under the bridge. Now we need to try to salvage the situation."

"I'm trying to divert the ship from its collision course with New Da Nang, but there are some problems: the helm is not responding to any commands and the fuel injection specification for the fusion engine is incorrect. 

"To be honest, friend, the readouts I'm seeing about the state of helm control are dire. I'm not sure it can be fixed."

>computer, access code 2
Welcome, Master Sergeant R. Mu Arvax. Logging you in.

* * *

>z
Time passes.

Reboot complete.

>hello
(addressing Master Sergeant R. Mu Arvax)
"You're back! Great job rebooting the computer -- I'm getting telemetry now."
"I'm trying to divert the ship from its collision course with New Da Nang, but there are some problems: the helm is not responding to any commands and the fuel injection specification for the fusion engine is incorrect."

You add an item ("adjust fuel injection specification") to your to-do list.

* * *

>z
Time passes.

Master Sergeant R. Mu Arvax: "You there, Usagi? We don't have much time."

>ask arvax about card
"You're back! Great job rebooting the computer -- I'm getting telemetry now."

"I'm afraid I don't have anything to say about that."

>ask arvax about card
"I'm afraid I don't have anything to say about that."

>ask arvax about ship
(the ss usagi)
"I'm trying to divert the ship from its collision course with New Da Nang, but there's a problem: the fuel injection specification for the fusion engine is incorrect."

You add an item ("adjust fuel injection specification") to your to-do list.

>read list
You have the following items on your to-do list: adjust fuel injection specification. You have finished the following: fix the airlock door, fix the microwave, fix the cabinet, fix the storage unit, fix the engine, and fix the captain's door.

>ask arvax about engine
(the fusion engine)
"I'm seeing the engine fully online. Now you need to get the fuel specification right."

* * *

>restart
Are you sure you want to restart?

* * *

>read list
You have finished the following: fix the airlock door, fix the microwave, fix the cabinet, fix the storage unit, fix the engine, fix the captain's door, and adjust fuel injection specification.

>a
"I'm seeing the engine fully online."

>ask arvax about ship
(the ss usagi)
"I'm seeing the engine fully online."

* * *

Crash
An Interactive Disaster by Phil Riley
Release 15 / Serial number 220926 / Inform 7 build 6M62 (I6/v6.34 lib 6/12N) SD

Space Station Gangway
This is the pressurized bridge from Space Station Omicron-5 to the SS Usagi. Behind you is the familiar bulk of the huge station, largest outpost of the Space Authority in Deneb Sector. Before you is the aft airlock of the Usagi, beckoning you in.

[Better get a move on], you think.

>z
Chew, chew, chew...

>pf
PLANETFALL
Infocom interactive fiction - a science fiction story
Copyright (c) 1983 by Infocom, Inc. All rights reserved.
PLANETFALL is a registered trademark of Infocom, Inc.
Release 39 / Serial number 880501

Another routine day of drudgery aboard the Stellar Patrol Ship Feinstein. This morning's assignment for a certain lowly Ensign Seventh Class: scrubbing the filthy metal deck at the port end of Level Nine. With your Patrol-issue self-contained multi-purpose all-weather scrub brush you shine the floor with a diligence born of the knowledge that at any moment dreaded Ensign First Class Blather, the bane of your shipboard existence, could appear.

* * *

>z
Time passes.

>i
You are carrying:
  a Patrol uniform (being worn)
    an ID card
  a chronometer (being worn)
  a Patrol-issue self-contained multi-purpose scrub brush

>quit
You stop playing Planetfall. Time to save the ship.

The Second Law of Thermodynamics, in one formulation, states that disorganization always increases in the absence of some outside force. A corollary is that things will always break down in the absence of someone to fix them. As a member of the repair corps of Space Station Omicron-5, you're that someone.

Your last assignment of the day, on the SS Usagi, a Space Marines fighting ship, looks routine enough. Fix the microwave and a jammed locker door, and then you're off for the day.

Space Station Gangway
This is the pressurized bridge from Space Station Omicron-5 to the SS Usagi. Behind you is the familiar bulk of the huge station, largest outpost of the Space Authority in Deneb Sector. Before you is the aft airlock of the Usagi, beckoning you in.

⇒ Tip: Type "help" to learn about this game, and interactive fiction in general.

>of
I'm not sure what you're trying to say. I might just not recognize the words you're using.

>pf
PLANETFALL
Infocom interactive fiction - a science fiction story
Copyright (c) 1983 by Infocom, Inc. All rights reserved.
PLANETFALL is a registered trademark of Infocom, Inc.
Release 39 / Serial number 880501

Another routine day of drudgery aboard the Stellar Patrol Ship Feinstein. This morning's assignment for a certain lowly Ensign Seventh Class: scrubbing the filthy metal deck at the port end of Level Nine. With your Patrol-issue self-contained multi-purpose all-weather scrub brush you shine the floor with a diligence born of the knowledge that at any moment dreaded Ensign First Class Blather, the bane of your shipboard existence, could appear.

>save
Save failed.

>quit
You stop playing Planetfall. Time to save the ship.

Space Station Gangway
This is the pressurized bridge from Space Station Omicron-5 to the SS Usagi. Behind you is the familiar bulk of the huge station, largest outpost of the Space Authority in Deneb Sector. Before you is the aft airlock of the Usagi, beckoning you in.

>purloin uge and planetfall
Which do you mean, the copy of Planetfall or Gangway?

>purloin uge and copy of planetfall
[Purloined.]
[Purloined.]

>play planetfall
(on the Universal Game Emulator)
PLANETFALL
Infocom interactive fiction - a science fiction story
Copyright (c) 1983 by Infocom, Inc. All rights reserved.
PLANETFALL is a registered trademark of Infocom, Inc.
Release 39 / Serial number 880501

Another routine day of drudgery aboard the Stellar Patrol Ship Feinstein. This morning's assignment for a certain lowly Ensign Seventh Class: scrubbing the filthy metal deck at the port end of Level Nine. With your Patrol-issue self-contained multi-purpose all-weather scrub brush you shine the floor with a diligence born of the knowledge that at any moment dreaded Ensign First Class Blather, the bane of your shipboard existence, could appear.

The alien ambassador from the planet Blow'k-bibben-Gordo ambles toward you from down the corridor. He is munching on something resembling an enormous stalk of celery, and he leaves a trail of green slime on the deck. He stops nearby, and you wince as a pool of slime begins forming beneath him on your newly-polished deck. The ambassador wheezes loudly and hands you a brochure outlining his planet's major exports.

>quit
You stop playing Planetfall. Time to save the ship.

Space Station Gangway
This is the pressurized bridge from Space Station Omicron-5 to the SS Usagi. Behind you is the familiar bulk of the huge station, largest outpost of the Space Authority in Deneb Sector. Before you is the aft airlock of the Usagi, beckoning you in.

>play planetfall
(on the Universal Game Emulator)
[No, I have more important things to do than playing that again.]

* * *

>z
Time passes.

Master Sergeant R. Mu Arvax: "You there, Usagi? We don't have much time."

>hello
(addressing Master Sergeant R. Mu Arvax)
"You're back! Great job rebooting the computer -- I'm getting telemetry now."
"I'm seeing the engine fully online. Now you need to get the fuel specification right."

You add an item ("adjust fuel injection specification") to your to-do list.

>a
Engineering Deck
The engineering crew is responsible for keeping the physical ship operating. They are in charge of every physical aspect of the ship, from the engines to hull integrity to the life support system.

The engineering deck consists of a large console giving a comprehensive view of the physical status of the ship. There is an airlock to starboard. The operations deck continues forward from here, and there are other exits to aft and port.

You hear someone speaking to fore.

A device labeled "Suit Recharging Station" is here. It is shaped like a chair with nozzles protruding from either arm.

>f
"I'm seeing the engine fully online. Now you need to get the fuel specification right."