Crash
An Interactive Disaster by Phil Riley
Release 19 / Serial number 230101 / Inform 7 build 6M62 (I6/v6.34 lib 6/12N) SD

Space Station Gangway
This is the pressurized bridge from Space Station Omicron-5 to the SS Usagi. Behind you is the familiar bulk of the huge station, largest outpost of the Space Authority in Deneb Sector. Before you is the aft airlock of the Usagi, beckoning you in.

[Better get a move on], you think.

>about
Crash
An Interactive Disaster by Phil Riley
Release 19 / Serial number 230101 / Inform 7 build 6M62 (I6/v6.34 lib 6/12N) SD
Standard Rules version 3/120430 by Graham Nelson
Adaptive Hints version 7 by Eric Eve
Conversation Framework version 11 by Eric Eve
Conversation Responses version 7 by Eric Eve
Epistemology version 9 by Eric Eve
Exit Lister version 11 by Eric Eve
Data Structures version 1/220331 by Dannii Willis
Nautical Directions by Philip Riley

Thanks for great playtesting goes to: Garry Francis, Mike Russo, Peter Gross, Drew Cook, Stu Dobbie, and Jade.
Special thanks to Laura Taalman for so many great ideas and improvements.

Also Steve Meretzky.

* * *

Crash
An Interactive Disaster by Phil Riley
Release 19 / Serial number 230101 / Inform 7 build 6M62 (I6/v6.34 lib 6/12N) SD

Space Station Gangway
This is the pressurized bridge from Space Station Omicron-5 to the SS Usagi. Behind you is the familiar bulk of the huge station, largest outpost of the Space Authority in Deneb Sector. Before you is the aft airlock of the Usagi, beckoning you in.

[Better get a move on], you think.

>charge suit
I'm not sure what you're trying to say. I might just not recognize the words you're using.

>recharge suit
You can't see any such thing.

>f
You pass into the aft airlock, the outer door closing behind you.

The Second Law of Thermodynamics, in one formulation, states that disorganization always increases in the absence of some outside force. A corollary is that things will always break down in the absence of someone to fix them. As a member of the repair corps of Space Station Omicron-5, you're that someone.

Your last assignment of the day, on the SS Usagi, a Space Marines fighting ship, looks routine enough. Fix the microwave and a jammed cabinet door, and then you're off for the day.

Aft Airlock
You are in the aft airlock. Outside is the gangway back to Space Station Omicron-5. Forward leads into the ship.

A pleasant androgynous voice says, "Welcome to the SS Usagi. This is the shipboard computer. Please feel free to call upon me for any information you may need. Use the command 'computer, help' for more information."

>f
You enter the ship from the airlock. The inner door closes behind you.

Staging Area
This is the staging area of the ship, where marines prepare for missions. It is adjacent to the aft airlock. It houses a number of vac suits in an open locker, and various munitions in locked compartments set into the walls. A ladder leads up into the rest of the ship. 
Through the airlock windows you can see the gangway to Space Station Omicron-5.

What looks like part of an engine is stowed in a corner.

>u
You climb the la--

***BOOM***

Press any key...

A gigantic force grabs the ship, knocking you off the ladder and sending you flying against an aft bulkhead. The inertial dampers are probably all that saved you from being smashed to jelly rather than just banged up. 

Press any key...

Some time later you find yourself lying on the floor of the staging area with a throbbing headache. Gingerly you push yourself to your knees and stand up. The vac suit locker has detached from its mounting and lies face down on the floor.

[Thank god I wasn't in the way of that.]

Looking outside --

[Holy -- ]

[Where's the station?].

Where Space Station Omicron-5 was, is now an expanding sphere of rubble, dimly lit by the blue light of far-off Deneb. The rubble is clearly receding behind the ship. [We're moving!]

[How am I going to get off this ship?]

Press any key...

Crash
An Interactive Disaster by Phil Riley
Release 18 / Serial number 221124 / Inform 7 build 6M62 (I6/v6.34 lib 6/12N) SD

Staging Area
This is the staging area of the ship, where marines prepare for missions. It is adjacent to the aft airlock. Locked compartments set into the walls hold various munitions. A ladder leads up into the rest of the ship. 

An equipment locker is sprawled across the room, with its door to the ground.
 
Through the airlock windows you see the blank space left by the destruction of Space Station Omicron-5.

What looks like part of an engine is stowed in a corner.

A vac suit is here, lying prone as if it were some malformed yellow person knocked unconscious by the shaking of the ship.

[What now?]

[I think I spit out my gum.]

>wear suit
(first taking the vac suit)
You put on the vac suit.

Attention all crew: command functions are offline and the computer is running with decreased capabilities. Full system reboot required. There is also an oxygen leak due to a jammed vent cover on the external hull.

You add an item ("close the vent") to your to-do list.

>recharge suit
There is no recharging station here.

>gonear engineering deck
Engineering Deck
The engineering crew is responsible for keeping the physical ship operating. They are in charge of every physical aspect of the ship, from the engines to hull integrity to the life support system.

The engineering deck consists of a large console giving a comprehensive view of the physical status of the ship. There is an airlock to starboard. The operations deck continues forward from here, and there are doorways aft and port, to the engine room and machine room respectively.

You hear someone speaking to fore.

A device labeled "Suit Recharging Station" is here. It is shaped like a chair with nozzles protruding from either arm.

>recharge suit
The nozzles on either side of the chair connect with the suit. After a few moments, the machine emits a pleasant "ping", the nozzles retract, and you stand up.

>recharge suit
The nozzles on either side of the chair connect with the suit. Apparently, the suit is already full, for the machine immediately emits a pleasant "ping" and the nozzles retract. You stand up.

>remove suit
(the vac suit)
You take off the vac suit.

>recharge suit
You sit in the suit recharger, but nothing happens. You stand up again.

>drop uit
You can't see any such thing.

>drop suit
(the vac suit)
Dropped.

>recharge suit
You sit in the suit recharger, but nothing happens. You stand up again.

* * *

Crash
An Interactive Disaster by Phil Riley
Release 19 / Serial number 230101 / Inform 7 build 6M62 (I6/v6.34 lib 6/12N) SD

Space Station Gangway
This is the pressurized bridge from Space Station Omicron-5 to the SS Usagi. Behind you is the familiar bulk of the huge station, largest outpost of the Space Authority in Deneb Sector. Before you is the aft airlock of the Usagi, beckoning you in.

[Better get a move on], you think.

>enter airlock
You pass into the aft airlock, the outer door closing behind you.

The Second Law of Thermodynamics, in one formulation, states that disorganization always increases in the absence of some outside force. A corollary is that things will always break down in the absence of someone to fix them. As a member of the repair corps of Space Station Omicron-5, you're that someone.

Your last assignment of the day, on the SS Usagi, a Space Marines fighting ship, looks routine enough. Fix the microwave and a jammed cabinet door, and then you're off for the day.

Aft Airlock
You are in the aft airlock. Outside is the gangway back to Space Station Omicron-5. Forward leads into the ship.

A pleasant androgynous voice says, "Welcome to the SS Usagi. This is the shipboard computer. Please feel free to call upon me for any information you may need. Use the command 'computer, help' for more information."

>restart
Are you sure you want to restart?

>y
Crash
An Interactive Disaster by Phil Riley
Release 18 / Serial number 221124 / Inform 7 build 6M62 (I6/v6.34 lib 6/12N) SD

Space Station Gangway
This is the pressurized bridge from Space Station Omicron-5 to the SS Usagi. Behind you is the familiar bulk of the huge station, largest outpost of the Space Authority in Deneb Sector. Before you is the aft airlock of the Usagi, beckoning you in.

[Better get a move on], you think.

>enter usagi
That's not something you can enter.

* * *

Crash
An Interactive Disaster by Phil Riley
Release 19 / Serial number 230101 / Inform 7 build 6M62 (I6/v6.34 lib 6/12N) SD

Space Station Gangway
This is the pressurized bridge from Space Station Omicron-5 to the SS Usagi. Behind you is the familiar bulk of the huge station, largest outpost of the Space Authority in Deneb Sector. Before you is the aft airlock of the Usagi, beckoning you in.

[Better get a move on], you think.

>enter usagi
You pass into the aft airlock, the outer door closing behind you.

The Second Law of Thermodynamics, in one formulation, states that disorganization always increases in the absence of some outside force. A corollary is that things will always break down in the absence of someone to fix them. As a member of the repair corps of Space Station Omicron-5, you're that someone.

Your last assignment of the day, on the SS Usagi, a Space Marines fighting ship, looks routine enough. Fix the microwave and a jammed cabinet door, and then you're off for the day.

Aft Airlock
You are in the aft airlock. Outside is the gangway back to Space Station Omicron-5. Forward leads into the ship.

A pleasant androgynous voice says, "Welcome to the SS Usagi. This is the shipboard computer. Please feel free to call upon me for any information you may need. Use the command 'computer, help' for more information."

>restart
Are you sure you want to restart?

* * *

>y
Crash
An Interactive Disaster by Phil Riley
Release 18 / Serial number 221124 / Inform 7 build 6M62 (I6/v6.34 lib 6/12N) SD

Space Station Gangway
This is the pressurized bridge from Space Station Omicron-5 to the SS Usagi. Behind you is the familiar bulk of the huge station, largest outpost of the Space Authority in Deneb Sector. Before you is the aft airlock of the Usagi, beckoning you in.

[Better get a move on], you think.

>enter ship
You pass into the aft airlock, the outer door closing behind you.

The Second Law of Thermodynamics, in one formulation, states that disorganization always increases in the absence of some outside force. A corollary is that things will always break down in the absence of someone to fix them. As a member of the repair corps of Space Station Omicron-5, you're that someone.

Your last assignment of the day, on the SS Usagi, a Space Marines fighting ship, looks routine enough. Fix the microwave and a jammed cabinet door, and then you're off for the day.

Aft Airlock
You are in the aft airlock. Outside is the gangway back to Space Station Omicron-5. Forward leads into the ship.

A pleasant androgynous voice says, "Welcome to the SS Usagi. This is the shipboard computer. Please feel free to call upon me for any information you may need. Use the command 'computer, help' for more information."

>drop all
chewing gum: [The gum's still got flavor. I don't want to spit it out yet.]

To-Do list: You need that to write on.

toolbox: [No. That's my life right there.]

>drop screwdriver
No, you'd rather keep all of your tools close by.

>f
You enter the ship from the airlock. The inner door closes behind you.

Staging Area
This is the staging area of the ship, where marines prepare for missions. It is adjacent to the aft airlock. It houses a number of vac suits in an open locker, and various munitions in locked compartments set into the walls. A ladder leads up into the rest of the ship. 
Through the airlock windows you can see the gangway to Space Station Omicron-5.

What looks like part of an engine is stowed in a corner.

>f
⇒ Try going up: enter "u".

>climb ladder
You climb the la--

***BOOM***

Press any key...

A gigantic force grabs the ship, knocking you off the ladder and sending you flying against an aft bulkhead. The inertial dampers are probably all that saved you from being smashed to jelly rather than just banged up. 

Press any key...

Some time later you find yourself lying on the floor of the staging area with a throbbing headache. Gingerly you push yourself to your knees and stand up. The vac suit locker has detached from its mounting and lies face down on the floor.

[Thank god I wasn't in the way of that.]

Looking outside --

[Holy -- ]

[Where's the station?].

Where Space Station Omicron-5 was, is now an expanding sphere of rubble, dimly lit by the blue light of far-off Deneb. The rubble is clearly receding behind the ship. [We're moving!]

[How am I going to get off this ship?]

Press any key...

Crash
An Interactive Disaster by Phil Riley
Release 18 / Serial number 221124 / Inform 7 build 6M62 (I6/v6.34 lib 6/12N) SD

Staging Area
This is the staging area of the ship, where marines prepare for missions. It is adjacent to the aft airlock. Locked compartments set into the walls hold various munitions. A ladder leads up into the rest of the ship. 

An equipment locker is sprawled across the room, with its door to the ground.
 
Through the airlock windows you see the blank space left by the destruction of Space Station Omicron-5.

What looks like part of an engine is stowed in a corner.

A vac suit is here, lying prone as if it were some malformed yellow person knocked unconscious by the shaking of the ship.

[What now?]

[I think I spit out my gum.]

>s
The obvious exits are aft (to aft airlock), up and outside (to aft airlock).

Attention all crew: command functions are offline and the computer is running with decreased capabilities. Full system reboot required. There is also an oxygen leak due to a jammed vent cover on the external hull.

You add an item ("close the vent") to your to-do list.

>purloin knife
[Purloined.]

>open door with knife
That doesn't seem to be something you can unlock.

* * *

Crash
An Interactive Disaster by Phil Riley
Release 19 / Serial number 230101 / Inform 7 build 6M62 (I6/v6.34 lib 6/12N) SD

Space Station Gangway
This is the pressurized bridge from Space Station Omicron-5 to the SS Usagi. Behind you is the familiar bulk of the huge station, largest outpost of the Space Authority in Deneb Sector. Before you is the aft airlock of the Usagi, beckoning you in.

[Better get a move on], you think.

>f
You pass into the aft airlock, the outer door closing behind you.

The Second Law of Thermodynamics, in one formulation, states that disorganization always increases in the absence of some outside force. A corollary is that things will always break down in the absence of someone to fix them. As a member of the repair corps of Space Station Omicron-5, you're that someone.

Your last assignment of the day, on the SS Usagi, a Space Marines fighting ship, looks routine enough. Fix the microwave and a jammed cabinet door, and then you're off for the day.

Aft Airlock
You are in the aft airlock. Outside is the gangway back to Space Station Omicron-5. Forward leads into the ship.

A pleasant androgynous voice says, "Welcome to the SS Usagi. This is the shipboard computer. Please feel free to call upon me for any information you may need. Use the command 'computer, help' for more information."

>ask computer about earth
The home planet of the human race, third planet from the star Sol. It is one of only a handful of habitable planets discovered by the human race.

>ask computer about sol
A small unregarded yellow sun far out in the uncharted backwaters of the unfashionable end of the western spiral arm of the Galaxy. Sol, the home star of the human race, has eight planets: Mercury, Venus, Earth, Mars, Jupiter, Saturn, Uranus, and Neptune. Sol also has numerous dwarf planets, of which the best known is Pluto, once classified as a planet.

>ask computer about galaxy
The Milky Way is the galaxy that includes the Solar System, and the systems of Deneb and Pollux, for instance.

>ask computer about pollux
Which do you mean, Pollux star, Pollux III, or Pollux VI?

>star
Pollux is the brightest star in the Earth constellation of Gemini.

>ask computer about gemini
One of the thirteen zodiac constellations seen from Earth.

>ask computer about pollux iii
Pollux III, now uninhabitable due to intense radiation, was once the home of the Irion race, who now live on the single moon of Pollux III.

>ask computer about irion
A sentient race of silicon-based insectoids originally from Pollux III. Their homeworld was destroyed in an industrial accident, leaving only the Irion who had settled on their planet's moon.

>ask computer about moon of pollux iii
I'm unable to give you any information about moon of pollux iii.

>ask computer about moon of pollux iv
I'm unable to give you any information about moon of pollux iv.

>ask computer about pollux iv
I'm unable to give you any information about pollux iv.

>ask computer about pollux vi
A human-settled planet which is contested by the Irion.

>ask computer about ship
(the ss usagi)
The SS Usagi is a light frigate in the Deneb system, with a crew of five including the captain. It is currently helmed by Captain Jane Mulgrew. The ship's main drive is a Luna Spacewerks Parsec VI.

>ask computer parsec VI
You can only do that to something animate.

>ask computer about parsec VI
The Luna Spacewerks Parsec VI is a starship engine used mainly by the Space Authority to drive light frigate class vessels. It is powered by Liquid Copernicium.

>ask computer about luna spacewerks
Which do you mean, Luna Spacewerks Parsec VI or Luna Spacewerks Company?

>company
Based on the moon of Earth, Luna Spacewerks is a leading supplier of engine parts to the Space Marines.

>ask computer about moon
The moon of Earth, often called simply "The Moon", is famously the first extraterrestrial body inhabited by humans.

>ask computer about access key
I'm unable to give you any information about access key.

>ask computer about tehtys
I'm unable to give you any information about tehtys.

>ask computer about tethys
The fifteenth moon of Saturn, it is made primarily of water ice with a small fraction of rock.

>ask computer about liquid copernicium
Liquid Copernicium is the liquid form of the element Copernicium. It is a common starship fuel. It can be created by injecting Oganesson into Red Matter.

>ask computer about fuel
Starship fuel injection is the process of "injecting" one substance into another, creating a third substance at a higher energy level. See "Substance Injection".

>ask computer about oganesson
Oganesson is an element with atomic number 118. It is often used to create Liquid Copernicium.

>ask computer about red matter
Red Matter is an unstable, possibly impossible substance created by injecting Tachyon Crystals into Unobtainium.

>u
⇒ Try going in: enter "in".

>in
You enter the ship from the airlock. The inner door closes behind you.

Staging Area
This is the staging area of the ship, where marines prepare for missions. It is adjacent to the aft airlock. It houses a number of vac suits in an open locker, and various munitions in locked compartments set into the walls. A ladder leads up into the rest of the ship. 
Through the airlock windows you can see the gangway to Space Station Omicron-5.

What looks like part of an engine is stowed in a corner.

>u
You climb the la--

***BOOM***

Press any key...

A gigantic force grabs the ship, knocking you off the ladder and sending you flying against an aft bulkhead. The inertial dampers are probably all that saved you from being smashed to jelly rather than just banged up. 

Press any key...

Some time later you find yourself lying on the floor of the staging area with a throbbing headache. Gingerly you push yourself to your knees and stand up. The vac suit locker has detached from its mounting and lies face down on the floor.

[Thank god I wasn't in the way of that.]

Looking outside --

[Holy -- ]

[Where's the station?].

Where Space Station Omicron-5 was, is now an expanding sphere of rubble, dimly lit by the blue light of far-off Deneb. The rubble is clearly receding behind the ship. [We're moving!]

[How am I going to get off this ship?]

Press any key...

Crash
An Interactive Disaster by Phil Riley
Release 18 / Serial number 221124 / Inform 7 build 6M62 (I6/v6.34 lib 6/12N) SD

Staging Area
This is the staging area of the ship, where marines prepare for missions. It is adjacent to the aft airlock. Locked compartments set into the walls hold various munitions. A ladder leads up into the rest of the ship. 

An equipment locker is sprawled across the room, with its door to the ground.
 
Through the airlock windows you see the blank space left by the destruction of Space Station Omicron-5.

What looks like part of an engine is stowed in a corner.

A vac suit is here, lying prone as if it were some malformed yellow person knocked unconscious by the shaking of the ship.

[What now?]

[I think I spit out my gum.]

>u
Junction
This is a busy place when the ship is populated. To port and starboard are the crew quarters, aft is the closed door to the captain's private quarters, and fore is the galley. A ladder leads down to the staging area.

⇒ You can enter "hints" at any time for help in progressing in the game.

Attention all crew: command functions are offline and the computer is running with decreased capabilities. Full system reboot required. There is also an oxygen leak due to a jammed vent cover on the external hull.

You add an item ("close the vent") to your to-do list.

>s
Starboard-Side Crew Quarters
All crew members who aren't the captain sleep in this or the opposite-side bunk room. This one sleeps two in a bunk bed, done up with military precision. There is a large cabinet here, stretching almost to the ceiling. It is closed. Mounted in the wall is a crew personal storage unit. The sole exit is to port.

In a shocking lapse of military precision, there is a sticky note attached to the bed post.

A pair of slippers peeks out from under the bed.

>take all
sticky note: Taken.
slippers: As you lean to take the slippers, you notice something under the bed.

>climb bed
As you clamber up, it looks like there's something wrong with the cabinet door.

>take all
But you don't see anything.

>x door
You can see the problem from up here: the top hinge of the cabinet door has a crooked screw, probably from the door being slammed too many times. You'll have to replace it.

>take all
But you don't see anything.

>take screw
You unscrew the old, crooked screw and replace it with a new one from your toolbox.

You cross out an item ("fix the cabinet") on your to-do list.

[Your score has just gone up by one point.]

* * *

>ask computer about me
Members of the Omicron-5 repair corps are responsible for the upkeep of Space Marines ships in dock.

>ask computer about code
I'm unable to give you any information about code.

>ask computer about access
I'm unable to give you any information about access.

>showme access code
security code - subject
location: in the Room of Stuff
singular-named, proper-named; unlit, inedible, portable, unseen, familiar, screwed
list grouping key: none
printed name: "security code"
printed plural name: "subjects"
indefinite article: none
description: "subject"
initial appearance: none
last utterance: none
readable text: none
voice locale: yourself

* * *

>ask computer about new da nang
New Da Nang is a moon of Deneb II. It is the home of famous composer Orenascopol Thrax.

>ask computer about thrax
Possibly the most famous musician of the 30th century, Orenascopol Thrax is responsible for the composition "Please I Really Need Some $$$".

>ask computer about rigel
I'm unable to give you any information about rigel.

>ask computer about deneb
Which do you mean, Deneb System, Deneb IV, Deneb II, Deneb sector, the Deneb separatists, or Deneb (star)?

>star
Deneb is a blue-white supergiant located 2,615 light-years from Earth. When seen from Earth, it appears in the constellation of Cygnus.

>ask computer about cygnus
As seen from Earth, Cygnus is a northern constellation on the plane of the Milky Way. It derives its name from the Latinized Greek word for swan.

>ask computer about milky way
The Milky Way is the galaxy that includes the Solar System, and the systems of Deneb and Pollux, for instance.

>ask computer about pollux
Which do you mean, Pollux star, Pollux III, or Pollux VI?

* * *

>star
Pollux is the brightest star in the Earth constellation of Gemini.

>ask computer about gemini
I'm unable to give you any information about gemini.

* * *

>f
You enter the ship from the airlock. The inner door closes behind you.

Staging Area
This is the staging area of the ship, where marines prepare for missions. It is adjacent to the aft airlock. It houses a number of vac suits in an open locker, and various munitions in locked compartments set into the walls. A ladder leads up into the rest of the ship. 
Through the airlock windows you can see the gangway to Space Station Omicron-5.

What looks like part of an engine is stowed in a corner.

>ask computer about code
Authorization for higher-level functions requires an access code.

>u
You climb the la--

***BOOM***

Press any key...

A gigantic force grabs the ship, knocking you off the ladder and sending you flying against an aft bulkhead. The inertial dampers are probably all that saved you from being smashed to jelly rather than just banged up. 

Press any key...

Some time later you find yourself lying on the floor of the staging area with a throbbing headache. Gingerly you push yourself to your knees and stand up. The vac suit locker has detached from its mounting and lies face down on the floor.

[Thank god I wasn't in the way of that.]

Looking outside --

[Holy -- ]

[Where's the station?].

Where Space Station Omicron-5 was, is now an expanding sphere of rubble, dimly lit by the blue light of far-off Deneb. The rubble is clearly receding behind the ship. [We're moving!]

[How am I going to get off this ship?]

Press any key...

Crash
An Interactive Disaster by Phil Riley
Release 18 / Serial number 221124 / Inform 7 build 6M62 (I6/v6.34 lib 6/12N) SD

Staging Area
This is the staging area of the ship, where marines prepare for missions. It is adjacent to the aft airlock. Locked compartments set into the walls hold various munitions. A ladder leads up into the rest of the ship. 

An equipment locker is sprawled across the room, with its door to the ground.
 
Through the airlock windows you see the blank space left by the destruction of Space Station Omicron-5.

What looks like part of an engine is stowed in a corner.

A vac suit is here, lying prone as if it were some malformed yellow person knocked unconscious by the shaking of the ship.

[What now?]

[I think I spit out my gum.]

* * *

>u
Junction
This is a busy place when the ship is populated. To port and starboard are the crew quarters, aft is the closed door to the captain's private quarters, and fore is the galley. A ladder leads down to the staging area.

⇒ You can enter "hints" at any time for help in progressing in the game.

Attention all crew: command functions are offline and the computer is running with decreased capabilities. Full system reboot required. There is also an oxygen leak due to a jammed vent cover on the external hull.

You add an item ("close the vent") to your to-do list.

>f
Galley
This narrow space is barely enough room for two Marines to prepare and eat a meal. There is a counter with a drawer, and two stools, a microwave oven, and a large closet here. Pots and pans hang from hooks in the ceiling. A ladder leads up through the midship door, and you can leave aft.

On the starboard wall is a panel on which is a blue button. Tacked to the panel is the operator's manual for the midship door.

You faintly hear someone speaking above.

>open cabinet
You can't see any such thing.

>open closet
You open the closet, revealing ten MREs and a microwavable dinner.

>take mres
MRE: The MREs are not important to the story.

MRE: The MREs are not important to the story.

MRE: The MREs are not important to the story.

MRE: The MREs are not important to the story.

MRE: The MREs are not important to the story.

MRE: The MREs are not important to the story.

MRE: The MREs are not important to the story.

MRE: The MREs are not important to the story.

MRE: The MREs are not important to the story.

MRE: The MREs are not important to the story.

>take mre
The MREs are not important to the story.

>take dinner
The microwavable dinner is not important to the story.

>x dinner
Spiced ham in some kind of sauce. Ugh.

>x mre
A regulation Meal Ready-to-Eat. One perk of not going on missions is you don't have to eat these things.

>take mre
The MREs are not important to the story.

* * *

>f
You enter the ship from the airlock. The inner door closes behind you.

Staging Area
This is the staging area of the ship, where marines prepare for missions. It is adjacent to the aft airlock. It houses a number of vac suits in an open locker, and various munitions in locked compartments set into the walls. A ladder leads up into the rest of the ship. 
Through the airlock windows you can see the gangway to Space Station Omicron-5.

What looks like part of an engine is stowed in a corner.

>ask computer about gemini
I'm unable to give you any information about gemini.

>ask computer about earth
The home planet of the human race, third planet from the star Sol. It is one of only a handful of habitable planets discovered by the human race.

* * *

>ask computer about sol
A small unregarded yellow sun far out in the uncharted backwaters of the unfashionable end of the western spiral arm of the Galaxy. Sol, the home star of the human race, has eight planets: Mercury, Venus, Earth, Mars, Jupiter, Saturn, Uranus, and Neptune. Sol also has numerous dwarf planets, of which the best known is Pluto, once classified as a planet.

>ask computer about galaxy
I'm unable to give you any information about galaxy.

* * *

>take gum
You unstick the chewing gum from the repair corps uniform.

Attention all crew: command functions are offline and the computer is running with decreased capabilities. Full system reboot required. There is also an oxygen leak due to a jammed vent cover on the external hull.

You add an item ("close the vent") to your to-do list.

The chewing gum has become stuck to the toolbox.

>chew gum
You can't chew the gum when it's stuck to the toolbox.

>u
Junction
This is a busy place when the ship is populated. To port and starboard are the crew quarters, aft is the closed door to the captain's private quarters, and fore is the galley. A ladder leads down to the staging area.

⇒ You can enter "hints" at any time for help in progressing in the game.

>read list
You have the following items on your to-do list: fix the microwave, fix the cabinet, and close the vent.

>s
Starboard-Side Crew Quarters
All crew members who aren't the captain sleep in this or the opposite-side bunk room. This one sleeps two in a bunk bed, done up with military precision. There is a large cabinet here, stretching almost to the ceiling. It is closed. Mounted in the wall is a crew personal storage unit. The sole exit is to port.

In a shocking lapse of military precision, there is a sticky note attached to the bed post.

A pair of slippers peeks out from under the bed.

* * *

>take them
As you lean to take the slippers, you notice something under the bed.

>look under bed
You find a black trunk and move it out from under the bottom bunk.

Starboard-Side Crew Quarters
All crew members who aren't the captain sleep in this or the opposite-side bunk room. This one sleeps two in a bunk bed, done up with military precision. There is a large cabinet here, stretching almost to the ceiling. It is closed. Mounted in the wall is a crew personal storage unit. The sole exit is to port.

In a shocking lapse of military precision, there is a sticky note attached to the bed post.

You can also see a black trunk (closed) here.

>open trunk
You open the black trunk, revealing a present.

* * *

>x bear
Bertie the Bear™ is a massively popular toy. It accepts voice commands, and its eyes, actually advanced optical sensors, can differentiate between individuals. This bear's blindly staring eyes are unnerving.

>bear, hello
Bertie the Bear™ has no batteries, apparently.

>talk to bear
Bertie the Bear™ has no batteries, apparently.

>hello
There's no one here but you.

>computer, hello
The shipboard computer has better things to do.

>bear, s
Bertie the Bear™ has no batteries, apparently.

Attention all crew: command functions are offline and the computer is running with decreased capabilities. Full system reboot required. There is also an oxygen leak due to a jammed vent cover on the external hull.

>x bear
Bertie the Bear™ is a massively popular toy. It accepts voice commands, and its eyes, actually advanced optical sensors, can differentiate between individuals. This bear's blindly staring eyes are unnerving.

>feel bear
You feel nothing unexpected.

>l
Starboard-Side Crew Quarters
All crew members who aren't the captain sleep in this or the opposite-side bunk room. This one sleeps two in a bunk bed, done up with military precision. There is a large cabinet here, stretching almost to the ceiling. It is closed. Mounted in the wall is a crew personal storage unit. The sole exit is to port.

In a shocking lapse of military precision, there is a sticky note attached to the bed post.

You can also see a cardboard box (empty), some wrapping paper, and a black trunk (empty) here.

>x note
Written on the note is "Mail package to Mitchell ASAP".

>x paper
The paper, which is adorned with cartoon animals in primary colors prancing around the words "Happy Birthday", is ripped beyond repair.

>x eyes
They're well disguised, but the eyes are clearly top-of-the-line optical sensors that you might see in more serious uses, such as in facial recognition devices.

>take eye
[Am I really going to do this? Yes, yes, I am, apparently.]

You grasp one of the eyes and give it a tug, first softly then harder. Eventually it gives and you extract the eye from the bear. Upon examination you discover that the eye is in fact an optical sensor in camouflage. It looks like you didn't pull it carefully enough, however, because the connector at the end has been damaged.

You try again more carefully with the second eye, and manage to produce an undamaged optical sensor.

>x eye
You can't see any such thing.

>x sensor
The optical sensor is a small component with a two-pronged connector on the back and a blue metallic circle on the other.

>p
Junction
This is a busy place when the ship is populated. To port and starboard are the crew quarters, aft is the closed door to the captain's private quarters, and fore is the galley. A ladder leads down to the staging area.

>a
The door stays shut as you try to go through it.
[Almost bumped my head.]

>d
Staging Area
This is the staging area of the ship, where marines prepare for missions. It is adjacent to the aft airlock. Locked compartments set into the walls hold various munitions. A ladder leads up into the rest of the ship. 

An equipment locker is sprawled across the room, with its door to the ground.
 
Through the airlock windows you see the blank space left by the destruction of Space Station Omicron-5.

What looks like part of an engine is stowed in a corner.

A vac suit is here, lying prone as if it were some malformed yellow person knocked unconscious by the shaking of the ship.

>u
Junction
This is a busy place when the ship is populated. To port and starboard are the crew quarters, aft is the closed door to the captain's private quarters, and fore is the galley. A ladder leads down to the staging area.

>x door
The Captain's Door is a conventional, self-opening starship door. It is painted in the traditional red of a starship captain. It features a slot through which you may slide the appropriate access card. Beside the door is an access panel, which is closed.

>d
Staging Area
This is the staging area of the ship, where marines prepare for missions. It is adjacent to the aft airlock. Locked compartments set into the walls hold various munitions. A ladder leads up into the rest of the ship. 

An equipment locker is sprawled across the room, with its door to the ground.
 
Through the airlock windows you see the blank space left by the destruction of Space Station Omicron-5.

What looks like part of an engine is stowed in a corner.

A vac suit is here, lying prone as if it were some malformed yellow person knocked unconscious by the shaking of the ship.

>wear suit
(first taking the vac suit)
You put on the vac suit.

Attention all crew: command functions are offline and the computer is running with decreased capabilities. Full system reboot required. There is also an oxygen leak due to a jammed vent cover on the external hull.

>drop trunk
You can't see any such thing.

>u
Junction
This is a busy place when the ship is populated. To port and starboard are the crew quarters, aft is the closed door to the captain's private quarters, and fore is the galley. A ladder leads down to the staging area.

>s
Starboard-Side Crew Quarters
All crew members who aren't the captain sleep in this or the opposite-side bunk room. This one sleeps two in a bunk bed, done up with military precision. There is a large cabinet here, stretching almost to the ceiling. It is closed. Mounted in the wall is a crew personal storage unit. The sole exit is to port.

In a shocking lapse of military precision, there is a sticky note attached to the bed post.

You can also see a cardboard box (empty), some wrapping paper, and a black trunk (empty) here.

>take trunk
Taken.

* * *

>d
Staging Area
This is the staging area of the ship, where marines prepare for missions. It is adjacent to the aft airlock. Locked compartments set into the walls hold various munitions. A ladder leads up into the rest of the ship. 

An equipment locker is sprawled across the room, with its door to the ground.
 
Through the airlock windows you see the blank space left by the destruction of Space Station Omicron-5.

What looks like part of an engine is stowed in a corner.

>drop trunk
You place the black trunk near the airlock door.

>stand on engine
That's not something you can stand on.

>stand on locker
You get onto the vac suit locker.

>x panel
The locker isn't close enough to the airlock door for you to see the component panel well.

>stand on trunk
(first closing the black trunk)
(getting off the vac suit locker)
You get onto the black trunk.

>x panel
The prominent features of the panel are two optical sensors. One of them has become partially detached and looks broken.

You add an item ("fix the airlock door") to your to-do list.

>replace sensor
You remove the broken sensor and insert the fresh sensor into the empty socket.
[There. That should do it.]

You cross out an item ("fix the airlock door") on your to-do list.

[Your score has just gone up by one point.]

>x list
You have the following items on your to-do list: fix the microwave, fix the cabinet, and close the vent. You have finished the following: fix the airlock door.

>a
(first getting off the black trunk)

Aft Airlock
You are in the aft airlock. Outside is the blackness of space, speckled with the dying embers of what was once Space Station Omicron-5. Forward leads into the ship.

>turn on boots
You switch the Magnetic boots on.

Attention all crew: command functions are offline and the computer is running with decreased capabilities. Full system reboot required. There is also an oxygen leak due to a jammed vent cover on the external hull.

>a
It's dangerous out there. I recommend saving the game first...
⇒ Use "save" to save the game, or go "out" again to continue without saving.

>a
Outside the Aft Airlock (vacuum)
You are standing on the hull of the ship, outside the aft airlock, secured by your vac suit's mag boots. Most of the hull is taken up by the protrusions of various machinery, antennae, radio dishes, and heat sinks. There is a clear path to fore among the obstructions. You can also go in to the airlock.

A hook protrudes from the hull next to the airlock door.

Your vac suit pings gently to indicate you have expended a unit of air.

>s
The obvious exits are fore, inside (to aft airlock) and outside.

Your vac suit pings gently to indicate you have expended a unit of air.

>und
I'm not sure what you're trying to say. I might just not recognize the words you're using.

>undo
Outside the Aft Airlock (vacuum)
[Previous turn undone.]

>f
Hull of the Usagi (vacuum)
Here the path runs aft to the aft airlock and starboard to the engineering airlock. Your path to starboard is blocked by a piece of debris lodged in the hull. [Whatever happened, this was part of it. It's fortunate it didn't penetrate further into the hull.] It's going to be tough to get over; it doesn't look magnetic, so your mag boots won't stick to it. You'll need to be careful.

There is a hook set in the hull here.

It looks like you could break off a small piece of debris.

Your vac suit pings gently to indicate you have expended a unit of air.

* * *

>grab hook
The hook is just out of reach.

Your vac suit pings gently to indicate you have expended a unit of air.

>vent suit
You vent a bit of air from your suit. It propels you just a tiny amount toward the hull, but it's enough. One agonizing minute later, you're attached to the hull again.

[Oh thank god! I thought I was a goner.]

Hull of the Usagi (vacuum)
Here the path runs aft to the aft airlock and starboard to the engineering airlock. Where there used to be a large embedded chunk of debris blocking the path, now there is a scattering of rubble.

There is a hook set in the hull here.

Your vac suit pings gently to indicate you have expended a unit of air.

>s
Outside the Engineering Airlock (vacuum)
You are standing on the hull of the ship, outside the engineering airlock, secured by your vac suit's mag boots. Most of the hull is taken up by the protrusions of various machinery, antennae, radio dishes, and heat sinks. There is a clear path to port among the obstructions. You can also go in to the airlock.

Near your feet is a six-inch hole in the hull labeled "Caution: Stand back during venting." The hole is almost entirely closed by a sliding cover, but a small gap remains, held open by a tiny piece of debris.

A hook protrudes from the hull next to the airlock door.

Your vac suit pings gently to indicate you have expended a unit of air.

>take debris
(the tiny piece of debris)
The vent slides all the way shut.

Taken.

You cross out an item ("close the vent") on your to-do list.

Your vac suit pings gently to indicate you have expended a unit of air.

[Your score has just gone up by one point.]

>x it
It's like a small piece of debris, only smaller.

Your vac suit pings gently to indicate you have expended a unit of air.

>in
Welcome back, visitor. I hope your spacewalk was uneventful.

Engineering Airlock
You are in the engineering airlock. Outside, the space to starboard looks so empty and peaceful it's hard to imagine the awful sight astern.

⇒ astern: behind or toward the rear of a ship, spaceship or aircraft.

>in
Engineering Deck
The engineering crew is responsible for keeping the physical ship operating. They are in charge of every physical aspect of the ship, from the engines to hull integrity to the life support system.

The engineering deck consists of a large console giving a comprehensive view of the physical status of the ship. There is an airlock to starboard. The operations deck continues forward from here, and there are doorways aft and port, to the engine room and machine room respectively.

You hear someone speaking to fore.

A device labeled "Suit Recharging Station" is here. It is shaped like a chair with nozzles protruding from either arm.

>sit
(on the engineering console)
That's not something you can sit down on.

>sit in station
The nozzles on either side of the chair connect with the suit. After a few moments, the machine emits a pleasant "ping", the nozzles retract, and you stand up.

>x suit
(the vac suit)
A puffy yellow suit with an attached helmet and magnetic boots. The gloves are misshapen things, optimized for carrying weaponry, not precision work. There is a nozzle on the front through which air can be recharged or vented. Lights indicate the boots are currently on. A gauge indicates the suit has 50 units of air left.
[I always wanted one of these.]

⇒ You can vent air by using "vent suit."

Attention all crew: command functions are offline and the computer is running with decreased capabilities. Full system reboot required.

>x suit
(the vac suit)
A puffy yellow suit with an attached helmet and magnetic boots. The gloves are misshapen things, optimized for carrying weaponry, not precision work. There is a nozzle on the front through which air can be recharged or vented. Lights indicate the boots are currently on. A gauge indicates the suit has 50 units of air left.
⇒ You can vent air by using "vent suit."

>l
Engineering Deck
The engineering crew is responsible for keeping the physical ship operating. They are in charge of every physical aspect of the ship, from the engines to hull integrity to the life support system.

The engineering deck consists of a large console giving a comprehensive view of the physical status of the ship. There is an airlock to starboard. The operations deck continues forward from here, and there are doorways aft and port, to the engine room and machine room respectively.

You hear someone speaking to fore.

A device labeled "Suit Recharging Station" is here. It is shaped like a chair with nozzles protruding from either arm.

>ask computer about engineering
Which do you mean, Engineering Deck or Engineering Airlock?

>deck
I'm unable to give you any information about Engineering Deck.

>ask computer about hull integrity
Despite the recent battering from the destruction of Space Station Omicron-5, hull integrity remains at 90%.

>ask computer about life support
Life support systems are all functioning satisfactorily.

>x console
The engineering console is huge, boasting an incomprehensible array of controls and monitors of the physical state of the ship. You dare not mess with it.

>mess with it
I SAID YOU DARE NOT MESS WITH IT!

>x controls
Without a degree in starship engineering, trying to understand these controls is pointless.

>x monitors
Without a degree in starship engineering, trying to understand these controls is pointless.

>ask computer about status
The SS Usagi employs a Luna Spacewerks Parsec VI. The shipboard engine is currently non-functional. It needs a replacement JL-758 engine stabilizer.

>ask computer about engine
Which do you mean, the brand-new JL-758 or engine status?

>status
The SS Usagi employs a Luna Spacewerks Parsec VI. The shipboard engine is currently non-functional. It needs a replacement JL-758 engine stabilizer.

>ask computer about ship
(the ss usagi)
The SS Usagi is a light frigate in the Deneb system, with a crew of five including the captain. It is currently helmed by Captain Jane Mulgrew. The ship's main drive is a Luna Spacewerks Parsec VI.

>ask computer about jl-758
The JL-758 is a widely-used model of engine stabilizer produced by Luna Spacewerks.

>ask computer about luna spacewerks
Which do you mean, Luna Spacewerks Parsec VI or Luna Spacewerks Company?

* * *

>company
Based on the moon of Earth, Luna Spacewerks is a leading supplier of engine parts to the Space Marines.

>ask computer about moon
The moon of Earth, often called simply "The Moon", is famously the first extraterrestrial body inhabited by humans.

Attention all crew: command functions are offline and the computer is running with decreased capabilities. Full system reboot required.

>ask computer about earth
The home planet of the human race, third planet from the star Sol. It is one of only a handful of habitable planets discovered by the human race.

* * *

>ask computer about sol
A small unregarded yellow sun far out in the uncharted backwaters of the unfashionable end of the western spiral arm of the Galaxy. Sol, the home star of the human race, has eight planets: Mercury, Venus, Earth, Mars, Jupiter, Saturn, Uranus, and Neptune. Sol also has numerous dwarf planets, of which the best known is Pluto, once classified as a planet.

>ask computer about pluto
Once considered the ninth planet, Pluto is now classified as a dwarf planet. Along with many of the trans-Neptunian dwarf planets, Pluto is part of the solar system's defensive "early warning" system, with a listening post on its largest moon, Charon.

>ask computer about charon
I'm unable to give you any information about charon.

>ask computer about neptune
The eighth and last planet from the sun, Neptune is an ice giant.

>l
Engineering Deck
The engineering crew is responsible for keeping the physical ship operating. They are in charge of every physical aspect of the ship, from the engines to hull integrity to the life support system.

The engineering deck consists of a large console giving a comprehensive view of the physical status of the ship. There is an airlock to starboard. The operations deck continues forward from here, and there are doorways aft and port, to the engine room and machine room respectively.

You hear someone speaking to fore.

A device labeled "Suit Recharging Station" is here. It is shaped like a chair with nozzles protruding from either arm.

>x statio
You can't see any such thing.

>x station
It looks like a person might sit in it.

>p
Machine Room
The machine room is where the physical work of Engineering takes place; for instance, machining new parts. There is a large counter lined with drawers here, as well as numerous saws, drills, and other pieces of equipment. You can leave to starboard.

There's a hand vac sitting on the counter.

>x saws
The machine room boasts an impressive array of tools, none of which you have call to use for now.

>take hand
Taken.

>open drawer
You open the machine room drawers, revealing a small key, a roll of electrical tape, a hex-shaped tool, and a fresh fuse.

>take all
small key: Taken.
roll of electrical tape: Taken.
hex-shaped tool: Taken.
fresh fuse: Taken.

>s
Engineering Deck
The engineering crew is responsible for keeping the physical ship operating. They are in charge of every physical aspect of the ship, from the engines to hull integrity to the life support system.

The engineering deck consists of a large console giving a comprehensive view of the physical status of the ship. There is an airlock to starboard. The operations deck continues forward from here, and there are doorways aft and port, to the engine room and machine room respectively.

You hear someone speaking to fore.

A device labeled "Suit Recharging Station" is here. It is shaped like a chair with nozzles protruding from either arm.

>f
Operations Deck
This is where all of the support activity for the bridge occurs. There are large consoles for environmental controls (which include gravity, temperature, and pressure), communications, and power systems here. The bridge continues forward from here, and engineering is aft. There is a door set in the floor with a ladder leading through it. Set in the frame of the door is a blue button.

A large equipment trunk lies on the midship door, blocking it.

A man's voice comes over comms: "SS Usagi, come in! Is anyone there?"

[Finally, another person! I'm saved!]

⇒ By the way... you can get help about speaking to other characters by typing "help speech".
⇒ You might try saying hello.

>hello
(addressing the caller)
You call out "Yes! I'm here! I'm here! What's going on?"

The caller responds, "Ahoy there, SS Usagi, good to hear from you. Seems like you're a bit out of sorts, and we'd like to help you out. But before we get into that, who am I speaking to? Tell me about yourself."

You tell the caller that you're from the repair corps.

"Alright then, Sergeant Screwdriver, I'll fill you in. Space Station Omicron-5 was bombed by separatists from Deneb IV. By some miracle the Usagi was spared the worst of the blast; you were thrown clear of the station. Only problem is now you're hurtling towards New Da Nang, a heavily-populated moon of Deneb II. An impact there would kill not only you but potentially thousands of people more.

 "So we've got some work to do. I'm Master Sergeant R. Mu Arvax -- you can ask the ship computer about me. I'm going to try and help you get this ship under control again. First we have to establish, though, what the ship is currently doing. Normally, I'd be able to tap into the ship diagnostics and controls from here on Deneb III, but something seems to have gone wrong. So I'm going to need your help. Are you up to the task?"

[Sergeant Screwdriver, guy thinks he's funny.]

"Yes sir!" you proclaim, despite his lame joke.

"Great, great. Now let's get to work.

 "The first thing I need you to do is reboot the system, using the computer. Once you do that, hopefully I'll be able to access ship controls. You'll have to use my access code: say 'compu--"

Master Sergeant R. Mu Arvax's voice breaks up and another voice comes over comms. "SS Usagi, this is Captain Jane Mulgrew, please come in. Repeat, this is Captain Mulgrew of the SS Usagi, Usagi come in."

[Somebody else?]

Attention all crew: command functions are offline and the computer is running with decreased capabilities. Full system reboot required.

>hello
(addressing Captain Jane Mulgrew)
Captain Mulgrew responds, "Hello there, Usagi. That's my ship you've got there. Be careful with her.

"We've been listening in and we've heard your communications with Arvax. He had us jammed for a while, but we managed to break through and here we are. Now it's very important that you understand this: Arvax is not your friend. His allegiances lie with Deneb IV, not with the Space Authority. He would like nothing more than to see this ship wipe out a few neighborhoods on New Da Nang.

"So what we need you to do is deny Arvax by shutting down any access to the ship's controls from the outside by invoking the emergency protocols. That will put the ship in a state where we can board and take control of the ship. What do you say? Do you have any questions?"

Master Sergeant R. Mu Arvax's voice comes back over the radio: "You there still, Usagi? I think I lost you for a second."

[Oh no, who should I trust?]

>ask arvax about mulgrew
"Let me guess. She told you I'm a separatist stooge, right? I guess it's time to blow my cover. I've been cultivating that image for several years now to infiltrate Deneb IV. Here. Enter my access code: 'computer, access code 2' and look up 'Operation Dalmatian'."

>ask mulgrew about emergency
"To prevent Arvax from seizing control of the ship remotely, we need to put the ship in a mode where it ignores all data communications. Voice radio will still be able to get through, but communications with the computer from outside will cease. You'll need to use my access code: say 'computer, access code 3'."

>computer, access code 3
Welcome, Captain Jane Mulgrew. Logging you in.

>ask computer about trajectory
Unable to access navigation system. Please reboot the computer.

Captain Mulgrew: "Calling the SS Usagi..."

>ask arvax about ship
(the ss usagi)
"Great ship. I hope we can save her. And you."

>ask computer about new da nang
New Da Nang is a moon of Deneb II. It is the home of famous composer Orenascopol Thrax.

>ask computer about thrax
I'm unable to give you any information about thrax.

Captain Mulgrew: "Calling the SS Usagi..."

>l
Operations Deck
This is where all of the support activity for the bridge occurs. There are large consoles for environmental controls (which include gravity, temperature, and pressure), communications, and power systems here. The bridge continues forward from here, and engineering is aft. There is a door set in the floor with a ladder leading through it. Set in the frame of the door is a blue button.

A large equipment trunk lies on the midship door, blocking it.

>x trunk
It's a large black trunk with an electronic lock. Generally you need a special RF device to open one of these.

Master Sergeant R. Mu Arvax: "Hey, friend, we need to reboot the computer soon before it's too late."

>open it
It seems to be locked.

>unlock it
You must specify what you want to unlock the equipment trunk with.

Captain Mulgrew: "Calling the SS Usagi..."

>move it
You push the trunk clear of the door.

>x door
The midship door is a square horizontal hatch, separating Operations Deck from the Galley. It is made of a strong black plastic/metal alloy. Set in the frame of the door is a blue button.

Master Sergeant R. Mu Arvax: "Hey, friend, we need to reboot the computer soon before it's too late."

>undo
Operations Deck
[Previous turn undone.]

>undo
Operations Deck
[Previous turn undone.]

>x door
The midship door is a square horizontal hatch, separating Operations Deck from the Galley. It is made of a strong black plastic/metal alloy. Set in the frame of the door is a blue button. A large equipment trunk is lying on the door, blocking it.

>l
Operations Deck
This is where all of the support activity for the bridge occurs. There are large consoles for environmental controls (which include gravity, temperature, and pressure), communications, and power systems here. The bridge continues forward from here, and engineering is aft. There is a door set in the floor with a ladder leading through it. Set in the frame of the door is a blue button.

A large equipment trunk lies on the midship door, blocking it.

Master Sergeant R. Mu Arvax: "Hey, friend, we need to reboot the computer soon before it's too late."

>f
Bridge
This is where the captain, navigator, and pilot all sit. Large viewscreens give a full view of the space around the ship. To port you can see the blue-white disk of Deneb. Astern you can faintly see the fading embers of what was Space Station Omicron-5.
 
The pilot's and navigator's chairs sit before the large helm console. The captain's chair, with command console, sits halfway between them and operations further aft.

You hear someone speaking aft of here.

Attention all crew: command functions are offline and the computer is running with decreased capabilities. Full system reboot required.

>x chair
Which do you mean, the pilot's chair, the navigator's chair, or the captain's chair?

>captain
Functional yet comfortable, it is every inch the chair of a commander. On the arm of the captain's chair is the command console, with which the captain commands the shipboard computer.

>x command console
The command console displays the red outline of a hand.

⇒ You can "touch command console" to touch your palm to it.

>touch it
Unauthorized access attempted. This event has been logged by security.

>computer, help
Helpful commands: 

 - ask computer about <subject>
 - computer, emergency protocols: activates the ship's emergency protocols (needs authorization)
 - computer, reboot: restarts all ship functions (needs authorization)
 - computer, access code <code>: authorizes user

>computer, asdfa
Please present hand print to command console in order to activate command mode.

>x helm
(the helm table)
The helm is a sloped table covered with cryptic readouts and touch controls. In the back is an access panel which is closed. A hex-shaped aperture is probably the locking mechanism.

>open it
It seems to be locked.

>unlock it
You must specify what you want to unlock the helm table with.

>unlock it with hex
You unlock the helm access panel.

>open it
Opening the helm access panel reveals an array of wiring and circuit boards.

>x it
The helm is a sloped table covered with cryptic readouts and touch controls. In the back is an access panel which is open, revealing a maze of wiring and circuit boards.

>x wiring
There's a lot of it.

>close it
It isn't something you can close.

>close helm
(the helm table)
You close the helm access panel.

>x helm
(the helm table)
The helm is a sloped table covered with cryptic readouts and touch controls. In the back is an access panel which is closed. A hex-shaped aperture is probably the locking mechanism.

Attention all crew: command functions are offline and the computer is running with decreased capabilities. Full system reboot required.

>x aperture
It's a small hex-shaped hole.

>put hex in hole
You unlock the helm access panel.

>close helm then open it
(the helm table)
That's already closed.

Opening the helm access panel reveals an array of wiring and circuit boards.

>close helm then open it
(the helm table)
You close the helm access panel.

It seems to be locked.

>l
Bridge
This is where the captain, navigator, and pilot all sit. Large viewscreens give a full view of the space around the ship. To port you can see the blue-white disk of Deneb. Astern you can faintly see the fading embers of what was Space Station Omicron-5.
 
The pilot's and navigator's chairs sit before the large helm console. The captain's chair, with command console, sits halfway between them and operations further aft.

You hear someone speaking aft of here.

>x screen
To port you can see the blue-white disk of Deneb. Astern you can faintly see the fading embers of what was Space Station Omicron-5.

>x deneb
Deneb is a blue-white spot off the port side of the ship.

>x station
The space station is now just an expanding cloud of debris, receding behind the ship.

>x pilot
(the pilot's chair)
An ergonomically-countoured swivel chair designed for hours of stressful work.
[Nice chair.]

>x navigator
(the navigator's chair)
An ergonomically-countoured swivel chair designed for hours of stressful work.

>x   console
The command console displays the red outline of a hand.

⇒ You can "touch command console" to touch your palm to it.

>touch it
Unauthorized access attempted. This event has been logged by security.

>x   console
The command console displays the red outline of a hand.

⇒ You can "touch command console" to touch your palm to it.

Attention all crew: command functions are offline and the computer is running with decreased capabilities. Full system reboot required.

>computer, access code 3
Please present hand print to command console in order to activate command mode.

>s
The only obvious exit is aft (to operations deck).

>a
Operations Deck
This is where all of the support activity for the bridge occurs. There are large consoles for environmental controls (which include gravity, temperature, and pressure), communications, and power systems here. The bridge continues forward from here, and engineering is aft. There is a door set in the floor with a ladder leading through it. Set in the frame of the door is a blue button.

A large equipment trunk lies on the midship door, blocking it.

Captain Mulgrew: "Did I lose you, Usagi?"

>computer, access code 3
Welcome, Captain Jane Mulgrew. Logging you in.

>computer, emergency
"I'm afraid I don't have anything to say about that."

>computer, emergency protocols
Are you sure you wish to invoke the emergency protocols?

>y
Beginning emergency protocols. Take all appropriate precautions.

Red alert lights flash throughout the ship.

The emergency depressurization siren sounds throughout the ship.
[Nice of Mulgrew to warn me.]

>z
Time passes.

Your vac suit pings gently to indicate you have expended a unit of air.

>z
Time passes.

Your vac suit pings gently to indicate you have expended a unit of air.

The depressurization siren stops.

>z
Time passes.

Emergency protocols complete.
Approaching New Da Nang. Beginning emergency countdown at 60.

>hello
(addressing Master Sergeant R. Mu Arvax)
"Finally! Where've you been? I'm sad to see you invoked Mulgrew's emergency protocols, but that's water under the bridge. Now we need to try to salvage the situation."

"I'm trying to divert the ship from its collision course with New Da Nang, but there are some problems: the helm is not responding to any commands, there is some physical issue with the engine, and the fuel injection specification for the fusion engine is incorrect. 

"To be honest, friend, the readouts I'm seeing about the state of helm control are dire. I'm not sure it can be fixed."

>f
Bridge
This is where the captain, navigator, and pilot all sit. Large viewscreens give a full view of the space around the ship. To port you can see the blue-white disk of Deneb. Astern you can faintly see the fading embers of what was Space Station Omicron-5.
 
The pilot's and navigator's chairs sit before the large helm console. The captain's chair, with command console, sits halfway between them and operations further aft.

You hear someone speaking aft of here.

Attention: current trajectory intersects the moon New Da Nang. Please correct course.

>open helm
(the helm table)
It seems to be locked.

>unlock helm
(the helm table)
You must specify what you want to unlock the helm table with.

>unlock helm with hex
(the helm table with the hex-shaped tool)
You unlock the helm access panel.

>open it
Opening the helm access panel reveals a fused mass of wiring and circuit boards. It's ruined beyond repair.

>a
Operations Deck
This is where all of the support activity for the bridge occurs. There are large consoles for environmental controls (which include gravity, temperature, and pressure), communications, and power systems here. The bridge continues forward from here, and engineering is aft. There is a door set in the floor with a ladder leading through it. Set in the frame of the door is a blue button.

⇒ You can always find out the current status by asking Arvax about the ship.

A large equipment trunk lies on the midship door, blocking it.

Master Sergeant R. Mu Arvax: "You there, Usagi? We don't have much time."

>hello
You are already talking to Master Sergeant R. Mu Arvax.

>ask arvax about ship
(the ss usagi)
"I'm sorry, I don't think the helm can be fixed -- not with the time you have left. You're going to have to destroy the ship."
[Oh god, this is it.]

>a
Engineering Deck
The engineering crew is responsible for keeping the physical ship operating. They are in charge of every physical aspect of the ship, from the engines to hull integrity to the life support system.

The engineering deck consists of a large console giving a comprehensive view of the physical status of the ship. There is an airlock to starboard. The operations deck continues forward from here, and there are doorways aft and port, to the engine room and machine room respectively.

You hear someone speaking to fore.

A device labeled "Suit Recharging Station" is here. It is shaped like a chair with nozzles protruding from either arm.

>a
Engine Room
This where the combustion process is controlled. The aft wall is dominated by the operating panel section of the fusion engine. Monitoring electronics and controls cover the other two walls. A doorway opens forward to the Engineering Deck.

There is a large diagram of the fuel injection process on the forward wall. There is a large button below the diagram labeled "Test".

>x diagram
This is a diagram of the fuel injection process for the fusion engine. Printed above it is the label "Delphi Engine Controls Aleph-Null". Below that is a representation of the various inputs and the products created during the fuel injection process. Each input has a touch-sensitive surface which can be used to alter the diagram's settings.

       Input: 2 --  3 --  4 --
                ||    ||    ||
             ===vv====vv====vv===
Input 1:     -- >> -- >> -- >> --  Output
             ====================

        FUEL INJECTION SPECIFICATION INCOMPLETE

Key:    --   empty input or output
        AH   Anti-Helium
        LC   Liquid Copernicium*
        Og   Oganesson
        RM   Red Matter            
        TC   Tachyon Crystals
        Un   Unobtainium
        VM   Void Matter*

        * this substance can only be produced, not input.

⇒ Use "substance > input" to set each input. For instance, "Un > 3" sets input 3 to Unobtainium. You may also use "set <input> to <substance>" for the same effect. Use "disconnect <input>" to disconnect an input.

Attention: current trajectory intersects the moon New Da Nang. Please correct course.

>ask computer about vm
Void Matter is essentially vacuum condensed into matter, according to the most comprehensible description we could find. It is an extremely unstable substance, and tends to explode catastrophically in the presence of high levels of energy. It can be created by injecting one source of tachyon crystals into another source of tachyon crystals.

>tc > 4
This is a diagram of the fuel injection process for the fusion engine. Printed above it is the label "Delphi Engine Controls Aleph-Null". Below that is a representation of the various inputs and the products created during the fuel injection process. Each input has a touch-sensitive surface which can be used to alter the diagram's settings.

       Input: 2 --  3 --  4 TC
                ||    ||    ||
             ===vv====vv====vv===
Input 1:     -- >> -- >> -- >> --  Output
             ====================

        FUEL INJECTION SPECIFICATION INCOMPLETE

Key:    --   empty input or output
        AH   Anti-Helium
        LC   Liquid Copernicium*
        Og   Oganesson
        RM   Red Matter            
        TC   Tachyon Crystals
        Un   Unobtainium
        VM   Void Matter*

        * this substance can only be produced, not input.

⇒ Use "substance > input" to set each input. For instance, "Un > 3" sets input 3 to Unobtainium. You may also use "set <input> to <substance>" for the same effect. Use "disconnect <input>" to disconnect an input.

>ask computer about tc
Rather than containing or being formed of tachyons, tachyon crystals get their name from their use in detecting tachyons, due to their negative refractive index. The typical method of creating tachyon crystals is injecting Anti-Helium into Red Matter. Tachyon Crystals can be used in the creation of Void Matter.

>AH > 3
This is a diagram of the fuel injection process for the fusion engine. Printed above it is the label "Delphi Engine Controls Aleph-Null". Below that is a representation of the various inputs and the products created during the fuel injection process. Each input has a touch-sensitive surface which can be used to alter the diagram's settings.

       Input: 2 --  3 AH  4 TC
                ||    ||    ||
             ===vv====vv====vv===
Input 1:     -- >> -- >> -- >> --  Output
             ====================

        FUEL INJECTION SPECIFICATION INCOMPLETE

Key:    --   empty input or output
        AH   Anti-Helium
        LC   Liquid Copernicium*
        Og   Oganesson
        RM   Red Matter            
        TC   Tachyon Crystals
        Un   Unobtainium
        VM   Void Matter*

        * this substance can only be produced, not input.

⇒ Use "substance > input" to set each input. For instance, "Un > 3" sets input 3 to Unobtainium. You may also use "set <input> to <substance>" for the same effect. Use "disconnect <input>" to disconnect an input.

>ask computer about RM
Red Matter is an unstable, possibly impossible substance created by injecting Tachyon Crystals into Unobtainium.

>un > 1
This is a diagram of the fuel injection process for the fusion engine. Printed above it is the label "Delphi Engine Controls Aleph-Null". Below that is a representation of the various inputs and the products created during the fuel injection process. Each input has a touch-sensitive surface which can be used to alter the diagram's settings.

       Input: 2 --  3 AH  4 TC
                ||    ||    ||
             ===vv====vv====vv===
Input 1:     Un >> -- >> -- >> --  Output
             ====================

        FUEL INJECTION SPECIFICATION INCOMPLETE

Key:    --   empty input or output
        AH   Anti-Helium
        LC   Liquid Copernicium*
        Og   Oganesson
        RM   Red Matter            
        TC   Tachyon Crystals
        Un   Unobtainium
        VM   Void Matter*

        * this substance can only be produced, not input.

⇒ Use "substance > input" to set each input. For instance, "Un > 3" sets input 3 to Unobtainium. You may also use "set <input> to <substance>" for the same effect. Use "disconnect <input>" to disconnect an input.

>tc > 2
This is a diagram of the fuel injection process for the fusion engine. Printed above it is the label "Delphi Engine Controls Aleph-Null". Below that is a representation of the various inputs and the products created during the fuel injection process. Each input has a touch-sensitive surface which can be used to alter the diagram's settings.

       Input: 2 TC  3 AH  4 TC
                ||    ||    ||
             ===vv====vv====vv===
Input 1:     Un >> RM >> TC >> VM  Output
             ====================

        WARNING: DANGEROUS INJECTION PRODUCT

Key:    --   empty input or output
        AH   Anti-Helium
        LC   Liquid Copernicium*
        Og   Oganesson
        RM   Red Matter            
        TC   Tachyon Crystals
        Un   Unobtainium
        VM   Void Matter*

        * this substance can only be produced, not input.

⇒ Use "substance > input" to set each input. For instance, "Un > 3" sets input 3 to Unobtainium. You may also use "set <input> to <substance>" for the same effect. Use "disconnect <input>" to disconnect an input.

>press test
A voice says "Fuel test sequence beginning..."

"10"

>f
Engineering Deck
The engineering crew is responsible for keeping the physical ship operating. They are in charge of every physical aspect of the ship, from the engines to hull integrity to the life support system.

The engineering deck consists of a large console giving a comprehensive view of the physical status of the ship. There is an airlock to starboard. The operations deck continues forward from here, and there are doorways aft and port, to the engine room and machine room respectively.

You hear someone speaking to fore.

A device labeled "Suit Recharging Station" is here. It is shaped like a chair with nozzles protruding from either arm.

"9"

>out
Engineering Airlock
You are in the engineering airlock. Outside, the space to starboard looks so empty and peaceful it's hard to imagine the awful sight astern.

Attention: current trajectory intersects the moon New Da Nang. Please correct course.

"8"

>turn off boots
You switch the Magnetic boots off.

"7"

>out
You propel yourself away from the ship, away from the explosion that follows moments later. However, in the blackness of space, there is no way anyone will find you. You float until you run out of air and suffocate.

    *** You died saving New Da Nang. ***

In that game you scored 3 out of a possible 11, in 172 turns.

Well done! You made the ultimate sacrifice so that others might live. First, we award you one point each for:
- fixing the aft airlock door
- closing the vent

We also award you one point for saving New Da Nang. Congratulations!

Would you like to RESTART, RESTORE a saved game, QUIT, or UNDO the last command?

* * *

>f
Galley
This narrow space is barely enough room for two Marines to prepare and eat a meal. There is a counter with a drawer, and two stools, a microwave oven, and a large closet here. Pots and pans hang from hooks in the ceiling. A ladder leads up through the midship door, and you can leave aft.

On the starboard wall is a panel on which is a blue button. Tacked to the panel is the operator's manual for the midship door.

You faintly hear someone speaking above.

>hints
Some players may find the temptation to rely on hints overwhelming, and you may prefer to remove temptation by disabling hints for the rest of this game. If you do so, however, you will not be able to access the hints unless you restart. Do you wish to disable hints? >

>no
Galley
This narrow space is barely enough room for two Marines to prepare and eat a meal. There is a counter with a drawer, and two stools, a microwave oven, and a large closet here. Pots and pans hang from hooks in the ceiling. A ladder leads up through the midship door, and you can leave aft.

On the starboard wall is a panel on which is a blue button. Tacked to the panel is the operator's manual for the midship door.

You faintly hear someone speaking above.

>f
The obvious exits are aft (to junction) and up.

>a
Junction
This is a busy place when the ship is populated. To port and starboard are the crew quarters, aft is the closed door to the captain's private quarters, and fore is the galley. A ladder leads down to the staging area.

>d
Staging Area
This is the staging area of the ship, where marines prepare for missions. It is adjacent to the aft airlock. Locked compartments set into the walls hold various munitions. A ladder leads up into the rest of the ship. 

An equipment locker is sprawled across the room, with its door to the ground.
 
Through the airlock windows you see the blank space left by the destruction of Space Station Omicron-5.

What looks like part of an engine is stowed in a corner.

A vac suit is here, lying prone as if it were some malformed yellow person knocked unconscious by the shaking of the ship.

>set gravity to 1
You got it. Physics has been changed at your whim.

* * *

>push engine a
You try to enter the airlock, but the automatic door fails to open for you.
[It's always just opened in the past.]

You add an item ("fix the airlock door") to your to-do list.

>push engine
Which direction do you want to push it in?

>pull it
Nothing obvious happens.

* * *

>f
Galley
This narrow space is barely enough room for two Marines to prepare and eat a meal. There is a counter with a drawer, and two stools, a microwave oven, and a large closet here. Pots and pans hang from hooks in the ceiling. A ladder leads up through the midship door, and you can leave aft.

On the starboard wall is a panel on which is a blue button. Tacked to the panel is the operator's manual for the midship door.

You faintly hear someone speaking above.

>knock door
(Midship Door)
Whoever's up there, they didn't hear you apparently.

* * *

>f
Galley
This narrow space is barely enough room for two Marines to prepare and eat a meal. There is a counter with a drawer, and two stools, a microwave oven, and a large closet here. Pots and pans hang from hooks in the ceiling. A ladder leads up through the midship door, and you can leave aft.

On the starboard wall is a panel on which is a blue button. Tacked to the panel is the operator's manual for the midship door.

You faintly hear someone speaking above.

>open closet
You open the closet, revealing ten MREs and a microwavable dinner.

>take MREs
MRE: The MREs are not important to the story.

MRE: The MREs are not important to the story.

MRE: The MREs are not important to the story.

MRE: The MREs are not important to the story.

MRE: The MREs are not important to the story.

MRE: The MREs are not important to the story.

MRE: The MREs are not important to the story.

MRE: The MREs are not important to the story.

MRE: The MREs are not important to the story.

MRE: The MREs are not important to the story.

>eat MRE
The MREs are not important to the story.

>x closet
A closet with a folding door, set into the bulkhead. It is open.

In the closet are ten MREs and a microwavable dinner.

>x door
(Midship Door)
The midship door is a square horizontal hatch, separating Operations Deck from the Galley. It is made of a strong black plastic/metal alloy.

>x closet door
I only understood you as far as wanting to examine the closet.

>x folding door
The folding door is part of the closet. It is open, revealing a plethora of MREs.

>l
Galley
This narrow space is barely enough room for two Marines to prepare and eat a meal. There is a counter with a drawer, and two stools, a microwave oven, and a large closet here. Pots and pans hang from hooks in the ceiling. A ladder leads up through the midship door, and you can leave aft.

On the starboard wall is a panel on which is a blue button. Tacked to the panel is the operator's manual for the midship door.

You faintly hear someone speaking above.

>x closet
A closet with a folding door, set into the bulkhead. It is open.

In the closet are ten MREs and a microwavable dinner.

>take dinner
Taken.

>x dinner
Spiced ham in some kind of sauce. Ugh.

>drop it
Dropped.

>l
Galley
This narrow space is barely enough room for two Marines to prepare and eat a meal. There is a counter with a drawer, and two stools, a microwave oven, and a large closet here. Pots and pans hang from hooks in the ceiling. A ladder leads up through the midship door, and you can leave aft.

On the starboard wall is a panel on which is a blue button. Tacked to the panel is the operator's manual for the midship door.

You faintly hear someone speaking above.

You can see a microwavable dinner here.

* * *

>open closet
You open the closet, revealing ten MREs and a microwavable dinner.

>take dinner
The microwavable dinner is not important to the story.

>eat it
The microwavable dinner is not important to the story.

* * *

>open drawer
You open the kitchen drawer, revealing a knife, a fork, and a spoon.

>take knife
Taken.

>a
Junction
This is a busy place when the ship is populated. To port and starboard are the crew quarters, aft is the closed door to the captain's private quarters, and fore is the galley. A ladder leads down to the staging area.

* * *

>type
What do you want to type on?

>keypad
As you press a key, the storage unit starts buzzing continuously. The display lights up with random characters, and you smell the distinct odor of burning wires. The bottom drawer pops out a centimeter or two.

You add an item ("fix the storage unit") to your to-do list.

>put knife in drawer
Which do you mean, the top drawer or the bottom drawer?

>bottom
You wedge the knife into the seam and lever the drawer open, revealing the red access card.

* * *

>take eyes
[Am I really going to do this? Yes, yes, I am, apparently.]

You grasp one of the eyes and give it a tug, first softly then harder. Eventually it gives and you extract the eye from the bear. Upon examination you discover that the eye is in fact an optical sensor in camouflage. It looks like you didn't pull it carefully enough, however, because the connector at the end has been damaged.

You try again more carefully with the second eye, and manage to produce an undamaged optical sensor.

>take eyes
You can't see any such thing.

>take eyes
You can't see any such thing.

* * *

>s
Starboard-Side Crew Quarters
All crew members who aren't the captain sleep in this or the opposite-side bunk room. This one sleeps two in a bunk bed, done up with military precision. There is a large cabinet here, stretching almost to the ceiling. It is closed. Mounted in the wall is a crew personal storage unit. The sole exit is to port.

In a shocking lapse of military precision, there is a sticky note attached to the bed post.

A pair of slippers peeks out from under the bed.

>pry cabinet open with screwdriver
Prying the cabinet door open would probably damage the cabinet.

* * *

>s
Starboard-Side Crew Quarters
All crew members who aren't the captain sleep in this or the opposite-side bunk room. This one sleeps two in a bunk bed, done up with military precision. There is a large cabinet here, stretching almost to the ceiling. It is closed. Mounted in the wall is a crew personal storage unit. The sole exit is to port.

In a shocking lapse of military precision, there is a sticky note attached to the bed post.

A pair of slippers peeks out from under the bed.

>purloin knife
[Purloined.]

>open cabinet with knife
That doesn't seem to be something you can unlock.

>open door with knife
That's just likely to bend the knife.

>open cabinet with knife
That doesn't seem to be something you can unlock.

>actions
Actions listing on.

>open cabinet with knife
[unlocking the starboard-side equipment cabinet with the knife]
That doesn't seem to be something you can unlock.
[unlocking the starboard-side equipment cabinet with the knife - failed the can't unlock without a lock rule]

* * *

>open cabinet with knife
That doesn't seem to be something you can unlock.

>unlock cabinet with knife
That doesn't seem to be something you can unlock.

* * *

>s
Starboard-Side Crew Quarters
All crew members who aren't the captain sleep in this or the opposite-side bunk room. This one sleeps two in a bunk bed, done up with military precision. There is a large cabinet here, stretching almost to the ceiling. It is closed. Mounted in the wall is a crew personal storage unit. The sole exit is to port.

In a shocking lapse of military precision, there is a sticky note attached to the bed post.

A pair of slippers peeks out from under the bed.

>take slippers
As you lean to take the slippers, you notice something under the bed.

>put slippers in door
That can't contain things.

>look under bed
You find a black trunk and move it out from under the bottom bunk.

Starboard-Side Crew Quarters
All crew members who aren't the captain sleep in this or the opposite-side bunk room. This one sleeps two in a bunk bed, done up with military precision. There is a large cabinet here, stretching almost to the ceiling. It is closed. Mounted in the wall is a crew personal storage unit. The sole exit is to port.

In a shocking lapse of military precision, there is a sticky note attached to the bed post.

You can also see a black trunk (closed) here.

* * *

>take eyes
[Am I really going to do this? Yes, yes, I am, apparently.]

You grasp one of the eyes and give it a tug, first softly then harder. Eventually it gives and you extract the eye from the bear. Upon examination you discover that the eye is in fact an optical sensor in camouflage. It looks like you didn't pull it carefully enough, however, because the connector at the end has been damaged.

You try again more carefully with the second eye, and manage to produce an undamaged optical sensor.

>put sensor in door
That can't contain things.

>x air
You see nothing special about Air.

* * *

>s
Starboard-Side Crew Quarters
All crew members who aren't the captain sleep in this or the opposite-side bunk room. This one sleeps two in a bunk bed, done up with military precision. There is a large cabinet here, stretching almost to the ceiling. It is closed. Mounted in the wall is a crew personal storage unit. The sole exit is to port.

In a shocking lapse of military precision, there is a sticky note attached to the bed post.

A pair of slippers peeks out from under the bed.

>unscrew door
You can't see anything to unscrew from this angle. There are probably screws you can't reach inside the cabinet.

>get on cabinet
That's not something you can enter.

>get on bunk
As you clamber up, it looks like there's something wrong with the cabinet door.

>x door
You can see the problem from up here: the top hinge of the cabinet door has a crooked screw, probably from the door being slammed too many times. You'll have to replace it.

>replace screw
You unscrew the old, crooked screw and replace it with a new one from your toolbox.

You cross out an item ("fix the cabinet") on your to-do list.

[Your score has just gone up by one point.]

>d
You get off the top bunk.

Starboard-Side Crew Quarters
All crew members who aren't the captain sleep in this or the opposite-side bunk room. This one sleeps two in a bunk bed, done up with military precision. There is a large cabinet here, stretching almost to the ceiling. It is closed. Mounted in the wall is a crew personal storage unit. The sole exit is to port.

In a shocking lapse of military precision, there is a sticky note attached to the bed post.

A pair of slippers peeks out from under the bed.

>take slippers
As you lean to take the slippers, you notice something under the bed.

* * *

>wear suit
(first taking the vac suit)
You put on the vac suit.

Attention all crew: command functions are offline and the computer is running with decreased capabilities. Full system reboot required. There is also an oxygen leak due to a jammed vent cover on the external hull.

You add an item ("close the vent") to your to-do list.

>turn on boots
You switch the Magnetic boots on.

>turn on boots
They're already on.

>x boots
Big boots with a thick sole. Lights indicate these boots are currently on.

>x suit
A puffy yellow suit with an attached helmet and magnetic boots. The gloves are misshapen things, optimized for carrying weaponry, not precision work. There is a nozzle on the front through which air can be recharged or vented. Lights indicate the boots are currently on. A gauge indicates the suit has 20 units of air left.
[I always wanted one of these.]

⇒ You can vent air by using "vent suit."

>x me
Not much to see other than the vac suit.

* * *

>x suit
A puffy yellow suit with an attached helmet and magnetic boots. The gloves are misshapen things, optimized for carrying weaponry, not precision work. There is a nozzle on the front through which air can be recharged or vented. Lights indicate the boots are currently off. A gauge indicates the suit has 20 units of air left.
[I always wanted one of these.]

⇒ You can vent air by using "vent suit."

Attention all crew: command functions are offline and the computer is running with decreased capabilities. Full system reboot required. There is also an oxygen leak due to a jammed vent cover on the external hull.

You add an item ("close the vent") to your to-do list.

>jrb
Reboot complete.

Operations Deck
This is where all of the support activity for the bridge occurs. There are large consoles for environmental controls (which include gravity, temperature, and pressure), communications, and power systems here. The bridge continues forward from here, and engineering is aft. There is a door set in the floor with a ladder leading through it. Set in the frame of the door is a blue button.

⇒ You can always find out the current status by asking Arvax about the ship.

A large equipment trunk lies on the midship door, blocking it.

* * *

>f
You enter the ship from the airlock. The inner door closes behind you.

Staging Area
This is the staging area of the ship, where marines prepare for missions. It is adjacent to the aft airlock. It houses a number of vac suits in an open locker, and various munitions in locked compartments set into the walls. A ladder leads up into the rest of the ship. 
Through the airlock windows you can see the gangway to Space Station Omicron-5.

What looks like part of an engine is stowed in a corner.

>x munitions
The munitions compartment is a glass-fronted, horizontal cabinet mounted in the wall. It is closed, and holds an array of offensive weapons, including the Syrinx 52-K laser rifle.

>x munitions
The munitions compartment is a glass-fronted, horizontal cabinet mounted in the wall. It is closed, and holds an array of offensive weapons, including the Syrinx 52-K laser rifle.

>x munitions
Leave the munitions compartment alone. You will not win this game through your superior firepower.

>open door
No need. Just go aft.

>a
Your work is in the ship, not outside.

>u
You climb the la--

***BOOM***

Press any key...

A gigantic force grabs the ship, knocking you off the ladder and sending you flying against an aft bulkhead. The inertial dampers are probably all that saved you from being smashed to jelly rather than just banged up. 

Press any key...

Some time later you find yourself lying on the floor of the staging area with a throbbing headache. Gingerly you push yourself to your knees and stand up. The vac suit locker has detached from its mounting and lies face down on the floor.

[Thank god I wasn't in the way of that.]

Looking outside --

[Holy -- ]

[Where's the station?].

Where Space Station Omicron-5 was, is now an expanding sphere of rubble, dimly lit by the blue light of far-off Deneb. The rubble is clearly receding behind the ship. [We're moving!]

[How am I going to get off this ship?]

Press any key...

Crash
An Interactive Disaster by Phil Riley
Release 18 / Serial number 221124 / Inform 7 build 6M62 (I6/v6.34 lib 6/12N) SD

Staging Area
This is the staging area of the ship, where marines prepare for missions. It is adjacent to the aft airlock. Locked compartments set into the walls hold various munitions. A ladder leads up into the rest of the ship. 

An equipment locker is sprawled across the room, with its door to the ground.
 
Through the airlock windows you see the blank space left by the destruction of Space Station Omicron-5.

What looks like part of an engine is stowed in a corner.

A vac suit is here, lying prone as if it were some malformed yellow person knocked unconscious by the shaking of the ship.

[What now?]

[I think I spit out my gum.]

>a
You try to enter the airlock, but the automatic door fails to open for you.
[It's always just opened in the past.]

You add an item ("fix the airlock door") to your to-do list.

Attention all crew: command functions are offline and the computer is running with decreased capabilities. Full system reboot required. There is also an oxygen leak due to a jammed vent cover on the external hull.

You add an item ("close the vent") to your to-do list.

>a
You try to enter the airlock, but the automatic door fails to open for you.

>f
The obvious exits are aft (to aft airlock), up and outside (to aft airlock).

>open door
No need. Just go aft.

* * *

>f
You enter the ship from the airlock. The inner door closes behind you.

Staging Area
This is the staging area of the ship, where marines prepare for missions. It is adjacent to the aft airlock. It houses a number of vac suits in an open locker, and various munitions in locked compartments set into the walls. A ladder leads up into the rest of the ship. 
Through the airlock windows you can see the gangway to Space Station Omicron-5.

What looks like part of an engine is stowed in a corner.

>x rifle
A red and black ferocious stick of death, the Syrinx 52-K is among the best rifles available today.

>x rifle
A red and black ferocious stick of death, the Syrinx 52-K is among the best rifles available today.

>x rifle
Leave the laser rifle alone. You will not win this game through your superior firepower.

>x rifle
A red and black ferocious stick of death, the Syrinx 52-K is among the best rifles available today.

>f
⇒ Try going up: enter "u".

>u
You climb the la--

***BOOM***

Press any key...

A gigantic force grabs the ship, knocking you off the ladder and sending you flying against an aft bulkhead. The inertial dampers are probably all that saved you from being smashed to jelly rather than just banged up. 

Press any key...

Some time later you find yourself lying on the floor of the staging area with a throbbing headache. Gingerly you push yourself to your knees and stand up. The vac suit locker has detached from its mounting and lies face down on the floor.

[Thank god I wasn't in the way of that.]

Looking outside --

[Holy -- ]

[Where's the station?].

Where Space Station Omicron-5 was, is now an expanding sphere of rubble, dimly lit by the blue light of far-off Deneb. The rubble is clearly receding behind the ship. [We're moving!]

[How am I going to get off this ship?]

Press any key...

Crash
An Interactive Disaster by Phil Riley
Release 18 / Serial number 221124 / Inform 7 build 6M62 (I6/v6.34 lib 6/12N) SD

Staging Area
This is the staging area of the ship, where marines prepare for missions. It is adjacent to the aft airlock. Locked compartments set into the walls hold various munitions. A ladder leads up into the rest of the ship. 

An equipment locker is sprawled across the room, with its door to the ground.
 
Through the airlock windows you see the blank space left by the destruction of Space Station Omicron-5.

What looks like part of an engine is stowed in a corner.

A vac suit is here, lying prone as if it were some malformed yellow person knocked unconscious by the shaking of the ship.

[What now?]

[I think I spit out my gum.]

* * *

>wear suit
(first taking the vac suit)
You put on the vac suit.

Attention all crew: command functions are offline and the computer is running with decreased capabilities. Full system reboot required. There is also an oxygen leak due to a jammed vent cover on the external hull.

You add an item ("close the vent") to your to-do list.

>x gum
You know it's on the repair corps uniform, but you can't see it with the vac suit over it.

* * *

>remove suit
You take off the vac suit.

>take gum
You unstick the chewing gum from the repair corps uniform.

The chewing gum has become stuck to the To-Do list.

>take it
You unstick the chewing gum from the To-Do list.

>chew it
You put the chewing gum in your mouth.

>wear suit
You put on the vac suit.

>x it
A puffy yellow suit with an attached helmet and magnetic boots. The gloves are misshapen things, optimized for carrying weaponry, not precision work. There is a nozzle on the front through which air can be recharged or vented. Lights indicate the boots are currently off. A gauge indicates the suit has 20 units of air left.
[I always wanted one of these.]

⇒ You can vent air by using "vent suit."

>x me
Not much to see other than the vac suit.

>aft
You try to enter the airlock, but the automatic door fails to open for you.
[It's always just opened in the past.]

You add an item ("fix the airlock door") to your to-do list.

>u
Junction
This is a busy place when the ship is populated. To port and starboard are the crew quarters, aft is the closed door to the captain's private quarters, and fore is the galley. A ladder leads down to the staging area.

⇒ You can enter "hints" at any time for help in progressing in the game.

* * *

>f
Galley
This narrow space is barely enough room for two Marines to prepare and eat a meal. There is a counter with a drawer, and two stools, a microwave oven, and a large closet here. Pots and pans hang from hooks in the ceiling. A ladder leads up through the midship door, and you can leave aft.

On the starboard wall is a panel on which is a blue button. Tacked to the panel is the operator's manual for the midship door.

You faintly hear someone speaking above.

>x room
You really don't need to worry about the ceiling.

>x space
You can't see any such thing.

>x marines
You can't see any such thing.

>x meal
You can't see any such thing.

>x counter
A standard kitchen counter.

>open it
It isn't something you can open.

>open drawer
You open the kitchen drawer, revealing a knife, a fork, and a spoon.

Attention all crew: command functions are offline and the computer is running with decreased capabilities. Full system reboot required. There is also an oxygen leak due to a jammed vent cover on the external hull.

>take all
knife: Taken.
fork: Taken.
spoon: Taken.

>ask computer about vent
I'm unable to give you any information about vent.

>ask computer about status
The SS Usagi employs a Luna Spacewerks Parsec VI. The shipboard engine is currently non-functional. It needs a replacement JL-758 engine stabilizer.

>ask computer about position
I'm unable to give you any information about position.

>ask computer about navigation
Unable to access navigation system. Please reboot the computer.

>ask computer about trajectory
Unable to access navigation system. Please reboot the computer.

>ask computer about planet
I'm unable to give you any information about planet.

>ask computer about moon
The moon of Earth, often called simply "The Moon", is famously the first extraterrestrial body inhabited by humans.

>ask computer about new da nang
New Da Nang is a moon of Deneb II. It is the home of famous composer Orenascopol Thrax.

* * *

>f
You enter the ship from the airlock. The inner door closes behind you.

Staging Area
This is the staging area of the ship, where marines prepare for missions. It is adjacent to the aft airlock. It houses a number of vac suits in an open locker, and various munitions in locked compartments set into the walls. A ladder leads up into the rest of the ship. 
Through the airlock windows you can see the gangway to Space Station Omicron-5.

What looks like part of an engine is stowed in a corner.

>x window
You can see the aft airlock through a window in the airlock door. Beyond the airlock is the gangway back to Space Station Omicron-5.

>x windows
You can see the aft airlock through a window in the airlock door. Beyond the airlock is the gangway back to Space Station Omicron-5.

>y
There's no one here to talk to.

>u
You climb the la--

***BOOM***

Press any key...

A gigantic force grabs the ship, knocking you off the ladder and sending you flying against an aft bulkhead. The inertial dampers are probably all that saved you from being smashed to jelly rather than just banged up. 

Press any key...

Some time later you find yourself lying on the floor of the staging area with a throbbing headache. Gingerly you push yourself to your knees and stand up. The vac suit locker has detached from its mounting and lies face down on the floor.

[Thank god I wasn't in the way of that.]

Looking outside --

[Holy -- ]

[Where's the station?].

Where Space Station Omicron-5 was, is now an expanding sphere of rubble, dimly lit by the blue light of far-off Deneb. The rubble is clearly receding behind the ship. [We're moving!]

[How am I going to get off this ship?]

Press any key...

Crash
An Interactive Disaster by Phil Riley
Release 18 / Serial number 221124 / Inform 7 build 6M62 (I6/v6.34 lib 6/12N) SD

Staging Area
This is the staging area of the ship, where marines prepare for missions. It is adjacent to the aft airlock. Locked compartments set into the walls hold various munitions. A ladder leads up into the rest of the ship. 

An equipment locker is sprawled across the room, with its door to the ground.
 
Through the airlock windows you see the blank space left by the destruction of Space Station Omicron-5.

What looks like part of an engine is stowed in a corner.

A vac suit is here, lying prone as if it were some malformed yellow person knocked unconscious by the shaking of the ship.

[What now?]

[I think I spit out my gum.]

* * *

>take all
sticky note: Taken.
slippers: As you lean to take the slippers, you notice something under the bed.

>p
Junction
This is a busy place when the ship is populated. To port and starboard are the crew quarters, aft is the closed door to the captain's private quarters, and fore is the galley. A ladder leads down to the staging area.

>f
Galley
This narrow space is barely enough room for two Marines to prepare and eat a meal. There is a counter with a drawer, and two stools, a microwave oven, and a large closet here. Pots and pans hang from hooks in the ceiling. A ladder leads up through the midship door, and you can leave aft.

On the starboard wall is a panel on which is a blue button. Tacked to the panel is the operator's manual for the midship door.

You faintly hear someone speaking above.

>take pot
You can't see any such thing.

>take pots
The pots and pans are not something you need to fix the ship.

* * *

>undo
Space Station Gangway
[Previous turn undone.]

* * *

>x air
Isn't it nice there's so much of it?

>x air
Isn't it nice there's so much of it?

>fill air
You aren't wearing a vac suit.

* * *

Crash
An Interactive Disaster by Phil Riley
Release 19 / Serial number 230101 / Inform 7 build 6M62 (I6/v6.34 lib 6/12N) SD

Space Station Gangway
This is the pressurized bridge from Space Station Omicron-5 to the SS Usagi. Behind you is the familiar bulk of the huge station, largest outpost of the Space Authority in Deneb Sector. Before you is the aft airlock of the Usagi, beckoning you in.

[Better get a move on], you think.

>fill air
You can't see any such thing.

>f
You pass into the aft airlock, the outer door closing behind you.

The Second Law of Thermodynamics, in one formulation, states that disorganization always increases in the absence of some outside force. A corollary is that things will always break down in the absence of someone to fix them. As a member of the repair corps of Space Station Omicron-5, you're that someone.

Your last assignment of the day, on the SS Usagi, a Space Marines fighting ship, looks routine enough. Fix the microwave and a jammed cabinet door, and then you're off for the day.

Aft Airlock
You are in the aft airlock. Outside is the gangway back to Space Station Omicron-5. Forward leads into the ship.

A pleasant androgynous voice says, "Welcome to the SS Usagi. This is the shipboard computer. Please feel free to call upon me for any information you may need. Use the command 'computer, help' for more information."

>fill air
The broken vac suits aren't important.

>f
You enter the ship from the airlock. The inner door closes behind you.

Staging Area
This is the staging area of the ship, where marines prepare for missions. It is adjacent to the aft airlock. It houses a number of vac suits in an open locker, and various munitions in locked compartments set into the walls. A ladder leads up into the rest of the ship. 
Through the airlock windows you can see the gangway to Space Station Omicron-5.

What looks like part of an engine is stowed in a corner.

>fill air
The broken vac suits aren't important.

>u
You climb the la--

***BOOM***

Press any key...

A gigantic force grabs the ship, knocking you off the ladder and sending you flying against an aft bulkhead. The inertial dampers are probably all that saved you from being smashed to jelly rather than just banged up. 

Press any key...

Some time later you find yourself lying on the floor of the staging area with a throbbing headache. Gingerly you push yourself to your knees and stand up. The vac suit locker has detached from its mounting and lies face down on the floor.

[Thank god I wasn't in the way of that.]

Looking outside --

[Holy -- ]

[Where's the station?].

Where Space Station Omicron-5 was, is now an expanding sphere of rubble, dimly lit by the blue light of far-off Deneb. The rubble is clearly receding behind the ship. [We're moving!]

[How am I going to get off this ship?]

Press any key...

Crash
An Interactive Disaster by Phil Riley
Release 18 / Serial number 221124 / Inform 7 build 6M62 (I6/v6.34 lib 6/12N) SD

Staging Area
This is the staging area of the ship, where marines prepare for missions. It is adjacent to the aft airlock. Locked compartments set into the walls hold various munitions. A ladder leads up into the rest of the ship. 

An equipment locker is sprawled across the room, with its door to the ground.
 
Through the airlock windows you see the blank space left by the destruction of Space Station Omicron-5.

What looks like part of an engine is stowed in a corner.

A vac suit is here, lying prone as if it were some malformed yellow person knocked unconscious by the shaking of the ship.

[What now?]

[I think I spit out my gum.]

>fill air
The broken vac suits aren't important.

Attention all crew: command functions are offline and the computer is running with decreased capabilities. Full system reboot required. There is also an oxygen leak due to a jammed vent cover on the external hull.

You add an item ("close the vent") to your to-do list.

>action
I'm not sure what you're trying to say. I might just not recognize the words you're using.

>actions
Actions listing on.

>fill air
[recharging Air]
[(1) recharging the banged-up suit]
The broken vac suits aren't important.

[(1) recharging the banged-up suit - failed]

[recharging Air - failed]

* * *

Crash
An Interactive Disaster by Phil Riley
Release 19 / Serial number 230101 / Inform 7 build 6M62 (I6/v6.34 lib 6/12N) SD

Space Station Gangway
This is the pressurized bridge from Space Station Omicron-5 to the SS Usagi. Behind you is the familiar bulk of the huge station, largest outpost of the Space Authority in Deneb Sector. Before you is the aft airlock of the Usagi, beckoning you in.

[Better get a move on], you think.

>gonear bridge
(the gangway)

The Second Law of Thermodynamics, in one formulation, states that disorganization always increases in the absence of some outside force. A corollary is that things will always break down in the absence of someone to fix them. As a member of the repair corps of Space Station Omicron-5, you're that someone.

Your last assignment of the day, on the SS Usagi, a Space Marines fighting ship, looks routine enough. Fix the microwave and a jammed cabinet door, and then you're off for the day.

Space Station Gangway
This is the pressurized bridge from Space Station Omicron-5 to the SS Usagi. Behind you is the familiar bulk of the huge station, largest outpost of the Space Authority in Deneb Sector. Before you is the aft airlock of the Usagi, beckoning you in.

⇒ Tip: Type "help" to learn about this game, and interactive fiction in general.

>gonear command console
Bridge
This is where the captain, navigator, and pilot all sit. Large viewscreens give a full view of the space around the ship. To port you can see the blue-white disk of Deneb. Astern you can faintly see the fading embers of what was Space Station Omicron-5.
 
The pilot's and navigator's chairs sit before the large helm console. The captain's chair, with command console, sits halfway between them and operations further aft.

You hear someone speaking aft of here.

>x pilot's char
I only understood you as far as wanting to examine the pilot's chair.

>x pilot's chair
An ergonomically-countoured swivel chair designed for hours of stressful work.
[Nice chair.]

>x pilot chair
An ergonomically-countoured swivel chair designed for hours of stressful work.

>x pilots chair
An ergonomically-countoured swivel chair designed for hours of stressful work.

* * *

Crash
An Interactive Disaster by Phil Riley
Release 19 / Serial number 230101 / Inform 7 build 6M62 (I6/v6.34 lib 6/12N) SD

Space Station Gangway
This is the pressurized bridge from Space Station Omicron-5 to the SS Usagi. Behind you is the familiar bulk of the huge station, largest outpost of the Space Authority in Deneb Sector. Before you is the aft airlock of the Usagi, beckoning you in.

[Better get a move on], you think.

>gonear engineering deck
The Second Law of Thermodynamics, in one formulation, states that disorganization always increases in the absence of some outside force. A corollary is that things will always break down in the absence of someone to fix them. As a member of the repair corps of Space Station Omicron-5, you're that someone.

Your last assignment of the day, on the SS Usagi, a Space Marines fighting ship, looks routine enough. Fix the microwave and a jammed cabinet door, and then you're off for the day.

Engineering Deck
The engineering crew is responsible for keeping the physical ship operating. They are in charge of every physical aspect of the ship, from the engines to hull integrity to the life support system.

The engineering deck consists of a large console giving a comprehensive view of the physical status of the ship. There is an airlock to starboard. The operations deck continues forward from here, and there are doorways aft and port, to the engine room and machine room respectively.

You hear someone speaking to fore.

A device labeled "Suit Recharging Station" is here. It is shaped like a chair with nozzles protruding from either arm.

>purloin vac suit
Which do you mean, Vacuum-suit, a vac suit, the banged-up suit, or the special vac suit?

>special vac suit
[Purloined.]

>wear it
You put on the special vac suit.

>charge air
You can't see any such thing.

>l
Engineering Deck
The engineering crew is responsible for keeping the physical ship operating. They are in charge of every physical aspect of the ship, from the engines to hull integrity to the life support system.

The engineering deck consists of a large console giving a comprehensive view of the physical status of the ship. There is an airlock to starboard. The operations deck continues forward from here, and there are doorways aft and port, to the engine room and machine room respectively.

You hear someone speaking to fore.

A device labeled "Suit Recharging Station" is here. It is shaped like a chair with nozzles protruding from either arm.

* * *

Crash
An Interactive Disaster by Phil Riley
Release 19 / Serial number 230101 / Inform 7 build 6M62 (I6/v6.34 lib 6/12N) SD

Space Station Gangway
This is the pressurized bridge from Space Station Omicron-5 to the SS Usagi. Behind you is the familiar bulk of the huge station, largest outpost of the Space Authority in Deneb Sector. Before you is the aft airlock of the Usagi, beckoning you in.

[Better get a move on], you think.

>gonear starboard
Which do you mean, the starboard, Starboard-Side Crew Quarters, the starboard-side equipment cabinet, the crew personal storage unit, the keypad, the starboard wires, the display, the top drawer, the bottom drawer, or the starboard keyhole?

>quarters
The Second Law of Thermodynamics, in one formulation, states that disorganization always increases in the absence of some outside force. A corollary is that things will always break down in the absence of someone to fix them. As a member of the repair corps of Space Station Omicron-5, you're that someone.

Your last assignment of the day, on the SS Usagi, a Space Marines fighting ship, looks routine enough. Fix the microwave and a jammed cabinet door, and then you're off for the day.

Starboard-Side Crew Quarters
All crew members who aren't the captain sleep in this or the opposite-side bunk room. This one sleeps two in a bunk bed, done up with military precision. There is a large cabinet here, stretching almost to the ceiling. It is closed. Mounted in the wall is a crew personal storage unit. The sole exit is to port.

In a shocking lapse of military precision, there is a sticky note attached to the bed post.

A pair of slippers peeks out from under the bed.

>purloin knife
[Purloined.]

>open cabinet with knife
That's just likely to bend the knife.

>restart
Are you sure you want to restart?

* * *

>y
Crash
An Interactive Disaster by Phil Riley
Release 18 / Serial number 221124 / Inform 7 build 6M62 (I6/v6.34 lib 6/12N) SD

Space Station Gangway
This is the pressurized bridge from Space Station Omicron-5 to the SS Usagi. Behind you is the familiar bulk of the huge station, largest outpost of the Space Authority in Deneb Sector. Before you is the aft airlock of the Usagi, beckoning you in.

[Better get a move on], you think.

>f
You pass into the aft airlock, the outer door closing behind you.

The Second Law of Thermodynamics, in one formulation, states that disorganization always increases in the absence of some outside force. A corollary is that things will always break down in the absence of someone to fix them. As a member of the repair corps of Space Station Omicron-5, you're that someone.

Your last assignment of the day, on the SS Usagi, a Space Marines fighting ship, looks routine enough. Fix the microwave and a jammed cabinet door, and then you're off for the day.

Aft Airlock
You are in the aft airlock. Outside is the gangway back to Space Station Omicron-5. Forward leads into the ship.

A pleasant androgynous voice says, "Welcome to the SS Usagi. This is the shipboard computer. Please feel free to call upon me for any information you may need. Use the command 'computer, help' for more information."

* * *

>f
You enter the ship from the airlock. The inner door closes behind you.

Staging Area
This is the staging area of the ship, where marines prepare for missions. It is adjacent to the aft airlock. It houses a number of vac suits in an open locker, and various munitions in locked compartments set into the walls. A ladder leads up into the rest of the ship. 
Through the airlock windows you can see the gangway to Space Station Omicron-5.

What looks like part of an engine is stowed in a corner.

>x symbols
You can't see any such thing.

>s door
I only understood you as far as wanting to (go) s.

>x door
The airlock door is an imposing solid barrier between vacuum and safety. It is colored yellow with red warning symbols on it. Above the door is a panel of electronic components.

>x symbols
You can't see any such thing.

* * *

Crash
An Interactive Disaster by Phil Riley
Release 19 / Serial number 230101 / Inform 7 build 6M62 (I6/v6.34 lib 6/12N) SD

Space Station Gangway
This is the pressurized bridge from Space Station Omicron-5 to the SS Usagi. Behind you is the familiar bulk of the huge station, largest outpost of the Space Authority in Deneb Sector. Before you is the aft airlock of the Usagi, beckoning you in.

[Better get a move on], you think.

>jfb
I'm not sure what you're trying to say. I might just not recognize the words you're using.

>jrb
Reboot complete.

The Second Law of Thermodynamics, in one formulation, states that disorganization always increases in the absence of some outside force. A corollary is that things will always break down in the absence of someone to fix them. As a member of the repair corps of Space Station Omicron-5, you're that someone.

Your last assignment of the day, on the SS Usagi, a Space Marines fighting ship, looks routine enough. Fix the microwave and a jammed cabinet door, and then you're off for the day.

Operations Deck
This is where all of the support activity for the bridge occurs. There are large consoles for environmental controls (which include gravity, temperature, and pressure), communications, and power systems here. The bridge continues forward from here, and engineering is aft. There is a door set in the floor with a ladder leading through it. Set in the frame of the door is a blue button.

⇒ You can always find out the current status by asking Arvax about the ship.

A large equipment trunk lies on the midship door, blocking it.

>f
Bridge
This is where the captain, navigator, and pilot all sit. Large viewscreens give a full view of the space around the ship. To port you can see the blue-white disk of Deneb. Astern you can faintly see the fading embers of what was Space Station Omicron-5.
 
The pilot's and navigator's chairs sit before the large helm console. The captain's chair, with command console, sits halfway between them and operations further aft.

You hear someone speaking aft of here.

>computer, hello
The shipboard computer has better things to do.

>computer, help
Helpful commands: 

 - ask computer about <subject>
 - computer, emergency protocols: activates the ship's emergency protocols (needs authorization)
 - computer, reboot: restarts all ship functions (needs authorization)
 - computer, access code <code>: authorizes user

>ask computer about ship
(the ss usagi)
The SS Usagi is a light frigate in the Deneb system, with a crew of five including the captain. It is currently helmed by Captain Jane Mulgrew. The ship's main drive is a Luna Spacewerks Parsec VI.

>computer, reboot
You've already rebooted once. That's enough.

>computer, emergency protocols
You've already rebooted the system. Your chance to invoke the emergency protocols is gone.

* * *

Crash
An Interactive Disaster by Phil Riley
Release 19 / Serial number 230101 / Inform 7 build 6M62 (I6/v6.34 lib 6/12N) SD

Space Station Gangway
This is the pressurized bridge from Space Station Omicron-5 to the SS Usagi. Behind you is the familiar bulk of the huge station, largest outpost of the Space Authority in Deneb Sector. Before you is the aft airlock of the Usagi, beckoning you in.

[Better get a move on], you think.

>jrb
Reboot complete.

The Second Law of Thermodynamics, in one formulation, states that disorganization always increases in the absence of some outside force. A corollary is that things will always break down in the absence of someone to fix them. As a member of the repair corps of Space Station Omicron-5, you're that someone.

Your last assignment of the day, on the SS Usagi, a Space Marines fighting ship, looks routine enough. Fix the microwave and a jammed cabinet door, and then you're off for the day.

Operations Deck
This is where all of the support activity for the bridge occurs. There are large consoles for environmental controls (which include gravity, temperature, and pressure), communications, and power systems here. The bridge continues forward from here, and engineering is aft. There is a door set in the floor with a ladder leading through it. Set in the frame of the door is a blue button.

⇒ You can always find out the current status by asking Arvax about the ship.

A large equipment trunk lies on the midship door, blocking it.

>ask arvax about the ship
(the ss usagi)
You should say hello first.

>hello
(addressing the caller)
You call out "Yes! I'm here! I'm here! What's going on?"

The caller responds, "Ahoy there, SS Usagi, good to hear from you. Seems like you're a bit out of sorts, and we'd like to help you out. But before we get into that, who am I speaking to? Tell me about yourself."

You tell the caller that you're from the repair corps.

"Alright then, Sergeant Screwdriver, I'll fill you in. Space Station Omicron-5 was bombed by separatists from Deneb IV. By some miracle the Usagi was spared the worst of the blast; you were thrown clear of the station. Only problem is now you're hurtling towards New Da Nang, a heavily-populated moon of Deneb II. An impact there would kill not only you but potentially thousands of people more.

 "So we've got some work to do. I'm Master Sergeant R. Mu Arvax -- you can ask the ship computer about me. I'm going to try and help you get this ship under control again. First we have to establish, though, what the ship is currently doing. Normally, I'd be able to tap into the ship diagnostics and controls from here on Deneb III, but something seems to have gone wrong. So I'm going to need your help. Are you up to the task?"

[Sergeant Screwdriver, guy thinks he's funny.]

"Yes sir!" you proclaim, despite his lame joke.

"Great, great. Now let's get to work.

 "The first thing I need you to do is reboot the system, using the computer. Once you do that, hopefully I'll be able to access ship controls. You'll have to use my access code: say 'compu--"

Master Sergeant R. Mu Arvax's voice breaks up and another voice comes over comms. "SS Usagi, this is Captain Jane Mulgrew, please come in. Repeat, this is Captain Mulgrew of the SS Usagi, Usagi come in."

[Somebody else?]

* * *

>f
Bridge
This is where the captain, navigator, and pilot all sit. Large viewscreens give a full view of the space around the ship. To port you can see the blue-white disk of Deneb. Astern you can faintly see the fading embers of what was Space Station Omicron-5.
 
The pilot's and navigator's chairs sit before the large helm console. The captain's chair, with command console, sits halfway between them and operations further aft.

You hear someone speaking aft of here.

>computer, hello
Please present hand print to command console in order to activate command mode.

* * *

>f
Bridge
This is where the captain, navigator, and pilot all sit. Large viewscreens give a full view of the space around the ship. To port you can see the blue-white disk of Deneb. Astern you can faintly see the fading embers of what was Space Station Omicron-5.
 
The pilot's and navigator's chairs sit before the large helm console. The captain's chair, with command console, sits halfway between them and operations further aft.

You hear someone speaking aft of here.

>x ember
You can't see any such thing.

>x embers
You can't see any such thing.

>x explosion
You can't see any such thing.

>s
The only obvious exit is aft (to operations deck).

>a
Operations Deck
This is where all of the support activity for the bridge occurs. There are large consoles for environmental controls (which include gravity, temperature, and pressure), communications, and power systems here. The bridge continues forward from here, and engineering is aft. There is a door set in the floor with a ladder leading through it. Set in the frame of the door is a blue button.

⇒ You can always find out the current status by asking Arvax about the ship.

A large equipment trunk lies on the midship door, blocking it.

>press blue button
A loud buzzer sounds and a red light flashes on the door, which stays resolutely shut.

caller: "You there, Usagi? We don't have much time."

>a
Engineering Deck
The engineering crew is responsible for keeping the physical ship operating. They are in charge of every physical aspect of the ship, from the engines to hull integrity to the life support system.

The engineering deck consists of a large console giving a comprehensive view of the physical status of the ship. There is an airlock to starboard. The operations deck continues forward from here, and there are doorways aft and port, to the engine room and machine room respectively.

You hear someone speaking to fore.

A device labeled "Suit Recharging Station" is here. It is shaped like a chair with nozzles protruding from either arm.

>x conole
You can't see any such thing.

>x console
The engineering console is huge, boasting an incomprehensible array of controls and monitors of the physical state of the ship. You dare not mess with it.

>x controls
Without a degree in starship engineering, trying to understand these controls is pointless.

>f
Operations Deck
This is where all of the support activity for the bridge occurs. There are large consoles for environmental controls (which include gravity, temperature, and pressure), communications, and power systems here. The bridge continues forward from here, and engineering is aft. There is a door set in the floor with a ladder leading through it. Set in the frame of the door is a blue button.

⇒ You can always find out the current status by asking Arvax about the ship.

A large equipment trunk lies on the midship door, blocking it.

caller: "You there, Usagi? We don't have much time."

>open trunk
It seems to be locked.

Attention: current trajectory intersects the moon New Da Nang. Please correct course.

>open trunk
It seems to be locked.

caller: "You there, Usagi? We don't have much time."

>open trunk
⇒ Really, the equipment trunk isn't important to the story.

>push it
You push the trunk clear of the door.

caller: "You there, Usagi? We don't have much time."

* * *

>hello
(addressing the caller)
"You're back! Great job rebooting the computer -- I'm getting telemetry now."

>ask arvax about ship
(the ss usagi)
"I'm trying to divert the ship from its collision course with New Da Nang, but there are some problems: there is some physical issue with the engine and the fuel injection specification for the fusion engine is incorrect."

You add an item ("adjust fuel injection specification") to your to-do list.

You add an item ("fix the engine") to your to-do list.

>ask arvax about ship
(the ss usagi)
"I'm trying to divert the ship from its collision course with New Da Nang, but there's a problem: the fuel injection specification for the fusion engine is incorrect."

>read list
You have the following items on your to-do list: fix the microwave, fix the cabinet, and adjust fuel injection specification.

>a
Engineering Deck
The engineering crew is responsible for keeping the physical ship operating. They are in charge of every physical aspect of the ship, from the engines to hull integrity to the life support system.

The engineering deck consists of a large console giving a comprehensive view of the physical status of the ship. There is an airlock to starboard. The operations deck continues forward from here, and there are doorways aft and port, to the engine room and machine room respectively.

You hear someone speaking to fore.

A device labeled "Suit Recharging Station" is here. It is shaped like a chair with nozzles protruding from either arm.

* * *

>a
Engine Room
This where the combustion process is controlled. The aft wall is dominated by the operating panel section of the fusion engine. Monitoring electronics and controls cover the other two walls. A doorway opens forward to the Engineering Deck.

There is a large diagram of the fuel injection process on the forward wall. There is a large button below the diagram labeled "Test".

>x diagram
This is a diagram of the fuel injection process for the fusion engine. Printed above it is the label "Delphi Engine Controls Aleph-Null". Below that is a representation of the various inputs and the products created during the fuel injection process. Each input has a touch-sensitive surface which can be used to alter the diagram's settings.

       Input: 2 --  3 --  4 --
                ||    ||    ||
             ===vv====vv====vv===
Input 1:     -- >> -- >> -- >> --  Output
             ====================

        FUEL INJECTION SPECIFICATION INCOMPLETE

Key:    --   empty input or output
        AH   Anti-Helium
        LC   Liquid Copernicium*
        Og   Oganesson
        RM   Red Matter            
        TC   Tachyon Crystals
        Un   Unobtainium
        VM   Void Matter*

        * this substance can only be produced, not input.

⇒ Use "substance > input" to set each input. For instance, "Un > 3" sets input 3 to Unobtainium. You may also use "set <input> to <substance>" for the same effect. Use "disconnect <input>" to disconnect an input.

>Og > 1
This is a diagram of the fuel injection process for the fusion engine. Printed above it is the label "Delphi Engine Controls Aleph-Null". Below that is a representation of the various inputs and the products created during the fuel injection process. Each input has a touch-sensitive surface which can be used to alter the diagram's settings.

       Input: 2 --  3 --  4 --
                ||    ||    ||
             ===vv====vv====vv===
Input 1:     Og >> -- >> -- >> --  Output
             ====================

        FUEL INJECTION SPECIFICATION INCOMPLETE

Key:    --   empty input or output
        AH   Anti-Helium
        LC   Liquid Copernicium*
        Og   Oganesson
        RM   Red Matter            
        TC   Tachyon Crystals
        Un   Unobtainium
        VM   Void Matter*

        * this substance can only be produced, not input.

⇒ Use "substance > input" to set each input. For instance, "Un > 3" sets input 3 to Unobtainium. You may also use "set <input> to <substance>" for the same effect. Use "disconnect <input>" to disconnect an input.

>rm > 2
This is a diagram of the fuel injection process for the fusion engine. Printed above it is the label "Delphi Engine Controls Aleph-Null". Below that is a representation of the various inputs and the products created during the fuel injection process. Each input has a touch-sensitive surface which can be used to alter the diagram's settings.

       Input: 2 RM  3 --  4 --
                ||    ||    ||
             ===vv====vv====vv===
Input 1:     Og >> -- >> -- >> --  Output
             ====================

        FUEL INJECTION SPECIFICATION INCOMPLETE

Key:    --   empty input or output
        AH   Anti-Helium
        LC   Liquid Copernicium*
        Og   Oganesson
        RM   Red Matter            
        TC   Tachyon Crystals
        Un   Unobtainium
        VM   Void Matter*

        * this substance can only be produced, not input.

⇒ Use "substance > input" to set each input. For instance, "Un > 3" sets input 3 to Unobtainium. You may also use "set <input> to <substance>" for the same effect. Use "disconnect <input>" to disconnect an input.

Attention: current trajectory intersects the moon New Da Nang. Please correct course.

>ah > 2
This is a diagram of the fuel injection process for the fusion engine. Printed above it is the label "Delphi Engine Controls Aleph-Null". Below that is a representation of the various inputs and the products created during the fuel injection process. Each input has a touch-sensitive surface which can be used to alter the diagram's settings.

       Input: 2 AH  3 --  4 --
                ||    ||    ||
             ===vv====vv====vv===
Input 1:     Og >> Un >> -- >> --  Output
             ====================

        FUEL INJECTION SPECIFICATION INCOMPLETE

Key:    --   empty input or output
        AH   Anti-Helium
        LC   Liquid Copernicium*
        Og   Oganesson
        RM   Red Matter            
        TC   Tachyon Crystals
        Un   Unobtainium
        VM   Void Matter*

        * this substance can only be produced, not input.

⇒ Use "substance > input" to set each input. For instance, "Un > 3" sets input 3 to Unobtainium. You may also use "set <input> to <substance>" for the same effect. Use "disconnect <input>" to disconnect an input.

>rm > 3
This is a diagram of the fuel injection process for the fusion engine. Printed above it is the label "Delphi Engine Controls Aleph-Null". Below that is a representation of the various inputs and the products created during the fuel injection process. Each input has a touch-sensitive surface which can be used to alter the diagram's settings.

       Input: 2 AH  3 RM  4 --
                ||    ||    ||
             ===vv====vv====vv===
Input 1:     Og >> Un >> -- >> --  Output
             ====================

        FUEL INJECTION SPECIFICATION INCOMPLETE

Key:    --   empty input or output
        AH   Anti-Helium
        LC   Liquid Copernicium*
        Og   Oganesson
        RM   Red Matter            
        TC   Tachyon Crystals
        Un   Unobtainium
        VM   Void Matter*

        * this substance can only be produced, not input.

⇒ Use "substance > input" to set each input. For instance, "Un > 3" sets input 3 to Unobtainium. You may also use "set <input> to <substance>" for the same effect. Use "disconnect <input>" to disconnect an input.

>tc > 3
This is a diagram of the fuel injection process for the fusion engine. Printed above it is the label "Delphi Engine Controls Aleph-Null". Below that is a representation of the various inputs and the products created during the fuel injection process. Each input has a touch-sensitive surface which can be used to alter the diagram's settings.

       Input: 2 AH  3 TC  4 --
                ||    ||    ||
             ===vv====vv====vv===
Input 1:     Og >> Un >> RM >> --  Output
             ====================

        FUEL INJECTION SPECIFICATION INCOMPLETE

Key:    --   empty input or output
        AH   Anti-Helium
        LC   Liquid Copernicium*
        Og   Oganesson
        RM   Red Matter            
        TC   Tachyon Crystals
        Un   Unobtainium
        VM   Void Matter*

        * this substance can only be produced, not input.

⇒ Use "substance > input" to set each input. For instance, "Un > 3" sets input 3 to Unobtainium. You may also use "set <input> to <substance>" for the same effect. Use "disconnect <input>" to disconnect an input.

>og  > 4
This is a diagram of the fuel injection process for the fusion engine. Printed above it is the label "Delphi Engine Controls Aleph-Null". Below that is a representation of the various inputs and the products created during the fuel injection process. Each input has a touch-sensitive surface which can be used to alter the diagram's settings.

       Input: 2 AH  3 TC  4 Og
                ||    ||    ||
             ===vv====vv====vv===
Input 1:     Og >> Un >> RM >> LC  Output
             ====================

        FUEL INJECTION SPECIFICATION VALID

Key:    --   empty input or output
        AH   Anti-Helium
        LC   Liquid Copernicium*
        Og   Oganesson
        RM   Red Matter            
        TC   Tachyon Crystals
        Un   Unobtainium
        VM   Void Matter*

        * this substance can only be produced, not input.

⇒ Use "substance > input" to set each input. For instance, "Un > 3" sets input 3 to Unobtainium. You may also use "set <input> to <substance>" for the same effect. Use "disconnect <input>" to disconnect an input.

You cross out an item ("adjust fuel injection specification") on your to-do list.

[Your score has just gone up by one point.]

>f
Engineering Deck
The engineering crew is responsible for keeping the physical ship operating. They are in charge of every physical aspect of the ship, from the engines to hull integrity to the life support system.

The engineering deck consists of a large console giving a comprehensive view of the physical status of the ship. There is an airlock to starboard. The operations deck continues forward from here, and there are doorways aft and port, to the engine room and machine room respectively.

You hear someone speaking to fore.

A device labeled "Suit Recharging Station" is here. It is shaped like a chair with nozzles protruding from either arm.

>f
Operations Deck
This is where all of the support activity for the bridge occurs. There are large consoles for environmental controls (which include gravity, temperature, and pressure), communications, and power systems here. The bridge continues forward from here, and engineering is aft. There is a door set in the floor with a ladder leading through it. Set in the frame of the door is a blue button.

⇒ You can always find out the current status by asking Arvax about the ship.

A large equipment trunk lies on the midship door, blocking it.

caller: "You there, Usagi? We don't have much time."

>ask arvax about ship
(the ss usagi)
"Looks like the ship is ready to fly! Quick! I've plotted evasive maneuvers but the command needs to be given from the bridge! Get to the bridge and touch the command console to activate command mode! Say 'computer, execute'"
[Not much time!]

Impact in 9.

>x list
You have the following items on your to-do list: fix the microwave and fix the cabinet. You have finished the following: adjust fuel injection specification.

Impact in 8.

>undo
Operations Deck
[Previous turn undone.]

>undo
Engineering Deck
[Previous turn undone.]

>a
Engine Room
This where the combustion process is controlled. The aft wall is dominated by the operating panel section of the fusion engine. Monitoring electronics and controls cover the other two walls. A doorway opens forward to the Engineering Deck.

There is a large diagram of the fuel injection process on the forward wall. There is a large button below the diagram labeled "Test".

>x engine
(the fusion engine)
The portion of the engine directly accessible from the engine room is a formidable machine. You wouldn't dare touch any of the various dials, components, hatches, etc. that adorn the surface.

>x panel
Without a degree in fusion propulsion, trying to understand these controls is pointless.

>x electronics
Without a degree in fusion propulsion, trying to understand these controls is pointless.

>gonear staging area
Staging Area
This is the staging area of the ship, where marines prepare for missions. It is adjacent to the aft airlock. It houses a number of vac suits in an open locker, and various munitions in locked compartments set into the walls. A ladder leads up into the rest of the ship. 
Through the airlock windows you can see the gangway to Space Station Omicron-5.

What looks like part of an engine is stowed in a corner.

Attention: current trajectory intersects the moon New Da Nang. Please correct course.

>ask computer about engine
(the brand-new JL-758)
The JL-758 is a widely-used model of engine stabilizer produced by Luna Spacewerks.

>ask computer about engine status
The SS Usagi employs a Luna Spacewerks Parsec VI. The shipboard engine is functioning normally.

* * *

>ask arvax about ship
(the ss usagi)
"I'm trying to divert the ship from its collision course with New Da Nang, but there are some problems: there is some physical issue with the engine and the fuel injection specification for the fusion engine is incorrect."

You add an item ("adjust fuel injection specification") to your to-do list.

You add an item ("fix the engine") to your to-do list.

>l
Operations Deck
This is where all of the support activity for the bridge occurs. There are large consoles for environmental controls (which include gravity, temperature, and pressure), communications, and power systems here. The bridge continues forward from here, and engineering is aft. There is a door set in the floor with a ladder leading through it. Set in the frame of the door is a blue button.

⇒ You can always find out the current status by asking Arvax about the ship.

A large equipment trunk lies on the midship door, blocking it.

>move trunk
You push the trunk clear of the door.

caller: "You there, Usagi? We don't have much time."

>l
Operations Deck
This is where all of the support activity for the bridge occurs. There are large consoles for environmental controls (which include gravity, temperature, and pressure), communications, and power systems here. The bridge continues forward from here, and engineering is aft. There is a door set in the floor with a ladder leading through it. Set in the frame of the door is a blue button.

⇒ You can always find out the current status by asking Arvax about the ship.

You can see an equipment trunk (closed) here.

* * *

>l
Operations Deck
This is where all of the support activity for the bridge occurs. There are large consoles for environmental controls (which include gravity, temperature, and pressure), communications, and power systems here. The bridge continues forward from here, and engineering is aft. There is a door set in the floor with a ladder leading through it. Set in the frame of the door is a blue button.

⇒ You can always find out the current status by asking Arvax about the ship.

A large equipment trunk lies on the midship door, blocking it.

>l
Operations Deck
This is where all of the support activity for the bridge occurs. There are large consoles for environmental controls (which include gravity, temperature, and pressure), communications, and power systems here. The bridge continues forward from here, and engineering is aft. There is a door set in the floor with a ladder leading through it. Set in the frame of the door is a blue button.

⇒ You can always find out the current status by asking Arvax about the ship.

A large equipment trunk lies on the midship door, blocking it.

caller: "You there, Usagi? We don't have much time."

>hello
(addressing the caller)
"You're back! Great job rebooting the computer -- I'm getting telemetry now."

>l
Operations Deck
This is where all of the support activity for the bridge occurs. There are large consoles for environmental controls (which include gravity, temperature, and pressure), communications, and power systems here. The bridge continues forward from here, and engineering is aft. There is a door set in the floor with a ladder leading through it. Set in the frame of the door is a blue button.

⇒ You can always find out the current status by asking Arvax about the ship.

A large equipment trunk lies on the midship door, blocking it.

* * *

>move trunk
You push the trunk clear of the door.

>l
Operations Deck
This is where all of the support activity for the bridge occurs. There are large consoles for environmental controls (which include gravity, temperature, and pressure), communications, and power systems here. The bridge continues forward from here, and engineering is aft. There is a door set in the floor with a ladder leading through it. Set in the frame of the door is a blue button.

⇒ You can always find out the current status by asking Arvax about the ship.

You can see an equipment trunk (closed) here.

caller: "You there, Usagi? We don't have much time."

>ask arvax about ship
(the ss usagi)
"I'm trying to divert the ship from its collision course with New Da Nang, but there are some problems: there is some physical issue with the engine and the fuel injection specification for the fusion engine is incorrect."

You add an item ("adjust fuel injection specification") to your to-do list.

You add an item ("fix the engine") to your to-do list.

>l
Operations Deck
This is where all of the support activity for the bridge occurs. There are large consoles for environmental controls (which include gravity, temperature, and pressure), communications, and power systems here. The bridge continues forward from here, and engineering is aft. There is a door set in the floor with a ladder leading through it. Set in the frame of the door is a blue button.

⇒ You can always find out the current status by asking Arvax about the ship.

You can see an equipment trunk (closed) here.

Attention: current trajectory intersects the moon New Da Nang. Please correct course.

>x console
Which do you mean, the communications console, the environmental console, or the power systems console?

>environmental
The environmental console contains the controls that deal with the comfort of the occupants, including temperature, pressure, and gravity. The gravity dial can be set from 1 to 10. It is set to 5.

caller: "You there, Usagi? We don't have much time."

>x dial
The gravity dial can be set from 1 to 10. It is set to 5.

>set dial to 1
You dial the gravity to 1.

caller: "You there, Usagi? We don't have much time."

>ask computer about gravity
The gravity is currently set to 1.

>x temperature
It's a comfortable 295 degrees Kelvin.

caller: "You there, Usagi? We don't have much time."

>x pressure
The pressure is right in the middle of safe territory at 30 inHg.

>x comms
The communications console is used for all communications, including long-range subspace and short-range radio communications. A readout displays the connections on each channel: "channel 1 -- Deneb III Marine Command, channel 2 -- No Connection, channel 3 -- No Connection."

caller: "You there, Usagi? We don't have much time."

>x connections
You can't see any such thing.

>x command
You can't see any such thing.

>x arvax
The caller is not here.

>x captain
You can't see any such thing.

>x console
Which do you mean, the communications console, the environmental console, or the power systems console?

>x power
The power systems console controls the power for the entire craft allowing, for instance, for power to be rerouted away from non-essential systems and to more essential systems such as life support or defensive systems.

caller: "You there, Usagi? We don't have much time."

>set power
I'm not sure what you're trying to say. I might just not recognize the words you're using.

>reroute power
You lack the necessary expertise to do that safely.

Attention: current trajectory intersects the moon New Da Nang. Please correct course.

>route power
I'm not sure what you're trying to say. I might just not recognize the words you're using.

* * *

>open trunk
It seems to be locked.

>open trunk
It seems to be locked.

caller: "You there, Usagi? We don't have much time."

>open trunk
⇒ Really, the equipment trunk isn't important to the story, other than it blocks the door.

>undo
Operations Deck
[Previous turn undone.]

>push trunk
You push the trunk clear of the door.

>open trunk
⇒ Really, the equipment trunk isn't important to the story.

caller: "You there, Usagi? We don't have much time."

>open door
You can't open that with your bare hands.

>touch console
Which do you mean, the communications console, the environmental console, or the power systems console?

>power systems
You feel nothing unexpected.

caller: "You there, Usagi? We don't have much time."

>a
Engineering Deck
The engineering crew is responsible for keeping the physical ship operating. They are in charge of every physical aspect of the ship, from the engines to hull integrity to the life support system.

The engineering deck consists of a large console giving a comprehensive view of the physical status of the ship. There is an airlock to starboard. The operations deck continues forward from here, and there are doorways aft and port, to the engine room and machine room respectively.

You hear someone speaking to fore.

A device labeled "Suit Recharging Station" is here. It is shaped like a chair with nozzles protruding from either arm.

>reroute power
You lack the necessary expertise to do that safely.

* * *

>x comms
The communications console is used for all communications, including long-range subspace and short-range radio communications. A readout displays the connections on each channel: "channel 1 -- Deneb III Marine Command, channel 2 -- No Connection, channel 3 -- No Connection."

>touch coms
You can't see any such thing.

>touch comms
The communications console will pick up and relay communications automatically. No reason to do anything with it.

caller: "You there, Usagi? We don't have much time."

>eat it
The communications console will pick up and relay communications automatically. No reason to do anything with it.

>set comms
I'm not sure what you're trying to say. I might just not recognize the words you're using.

>reset comms
I'm not sure what you're trying to say. I might just not recognize the words you're using.

>s
The obvious exits are fore, aft and down.

caller: "You there, Usagi? We don't have much time."

>l
Operations Deck
This is where all of the support activity for the bridge occurs. There are large consoles for environmental controls (which include gravity, temperature, and pressure), communications, and power systems here. The bridge continues forward from here, and engineering is aft. There is a door set in the floor with a ladder leading through it. Set in the frame of the door is a blue button.

⇒ You can always find out the current status by asking Arvax about the ship.

A large equipment trunk lies on the midship door, blocking it.

>a
Engineering Deck
The engineering crew is responsible for keeping the physical ship operating. They are in charge of every physical aspect of the ship, from the engines to hull integrity to the life support system.

The engineering deck consists of a large console giving a comprehensive view of the physical status of the ship. There is an airlock to starboard. The operations deck continues forward from here, and there are doorways aft and port, to the engine room and machine room respectively.

You hear someone speaking to fore.

A device labeled "Suit Recharging Station" is here. It is shaped like a chair with nozzles protruding from either arm.

>l
Engineering Deck
The engineering crew is responsible for keeping the physical ship operating. They are in charge of every physical aspect of the ship, from the engines to hull integrity to the life support system.

The engineering deck consists of a large console giving a comprehensive view of the physical status of the ship. There is an airlock to starboard. The operations deck continues forward from here, and there are doorways aft and port, to the engine room and machine room respectively.

You hear someone speaking to fore.

A device labeled "Suit Recharging Station" is here. It is shaped like a chair with nozzles protruding from either arm.

>shout
You make some noise. You feel a lot better now.

>jump
You jump on the spot.

Attention: current trajectory intersects the moon New Da Nang. Please correct course.

* * *

>x trunk
It's a large black trunk with an electronic lock. Generally you need a special RF device to open one of these.

>open it
It seems to be locked.

caller: "You there, Usagi? We don't have much time."

>f
Bridge
This is where the captain, navigator, and pilot all sit. Large viewscreens give a full view of the space around the ship. To port you can see the blue-white disk of Deneb. Astern you can faintly see the fading embers of what was Space Station Omicron-5.
 
The pilot's and navigator's chairs sit before the large helm console. The captain's chair, with command console, sits halfway between them and operations further aft.

You hear someone speaking aft of here.

>x embers
You can't see any such thing.

>station
I'm not sure what you're trying to say. I might just not recognize the words you're using.

>x station
Space Station Omicron-5 is a huge spindle-shaped structure, spinning eternally to generate the coriolis force that simulates gravity.

>x usagi
The SS Usagi is quiet except for the hum of its life support system.

* * *

Crash
An Interactive Disaster by Phil Riley
Release 19 / Serial number 230101 / Inform 7 build 6M62 (I6/v6.34 lib 6/12N) SD

Space Station Gangway
This is the pressurized bridge from Space Station Omicron-5 to the SS Usagi. Behind you is the familiar bulk of the huge station, largest outpost of the Space Authority in Deneb Sector. Before you is the aft airlock of the Usagi, beckoning you in.

[Better get a move on], you think.

>jump
You jump on the spot.

>f
You pass into the aft airlock, the outer door closing behind you.

The Second Law of Thermodynamics, in one formulation, states that disorganization always increases in the absence of some outside force. A corollary is that things will always break down in the absence of someone to fix them. As a member of the repair corps of Space Station Omicron-5, you're that someone.

Your last assignment of the day, on the SS Usagi, a Space Marines fighting ship, looks routine enough. Fix the microwave and a jammed cabinet door, and then you're off for the day.

Aft Airlock
You are in the aft airlock. Outside is the gangway back to Space Station Omicron-5. Forward leads into the ship.

A pleasant androgynous voice says, "Welcome to the SS Usagi. This is the shipboard computer. Please feel free to call upon me for any information you may need. Use the command 'computer, help' for more information."

>jup
I'm not sure what you're trying to say. I might just not recognize the words you're using.

>jump
You jump on the spot.

>l
Aft Airlock
You are in the aft airlock. Outside is the gangway back to Space Station Omicron-5. Forward leads into the ship.

>a
Your work is in the ship, not outside.

>n
I'm not sure what you're trying to say. I might just not recognize the words you're using.

>a
Your work is in the ship, not outside.

>l
Aft Airlock
You are in the aft airlock. Outside is the gangway back to Space Station Omicron-5. Forward leads into the ship.

>x locker
You can't see any such thing.

>f
You enter the ship from the airlock. The inner door closes behind you.

Staging Area
This is the staging area of the ship, where marines prepare for missions. It is adjacent to the aft airlock. It houses a number of vac suits in an open locker, and various munitions in locked compartments set into the walls. A ladder leads up into the rest of the ship. 
Through the airlock windows you can see the gangway to Space Station Omicron-5.

What looks like part of an engine is stowed in a corner.

>x locker
The locker is made of some composite material, all black. It is open.

In the vac suit locker are five vac suits.

>x suits
You can't use multiple objects with that verb.

>take suits
vac suit: In general, the crew's gear is off-limits.

vac suit: In general, the crew's gear is off-limits.

vac suit: In general, the crew's gear is off-limits.

vac suit: In general, the crew's gear is off-limits.

vac suit: In general, the crew's gear is off-limits.

>x suit
A puffy yellow suit with an attached helmet and magnetic boots. The gloves are misshapen things, optimized for carrying weaponry, not precision work. There is a nozzle on the front through which air can be recharged or vented. Lights indicate the boots are currently off. A gauge indicates the suit has 20 units of air left.
[I always wanted one of these.]

⇒ You can vent air by using "vent suit."

>vent suit
You don't have a vac suit.

>close locker
You close the vac suit locker.

>i
You are carrying:
  some chewing gum (being chewed)
  a To-Do list
  a repair corps uniform (being worn)
  a toolbox

>l
Staging Area
This is the staging area of the ship, where marines prepare for missions. It is adjacent to the aft airlock. It houses a number of vac suits in a closed locker, and various munitions in locked compartments set into the walls. A ladder leads up into the rest of the ship. 
Through the airlock windows you can see the gangway to Space Station Omicron-5.

What looks like part of an engine is stowed in a corner.

>x compartments
The munitions compartment is a glass-fronted, horizontal cabinet mounted in the wall. It is closed, and holds an array of offensive weapons, including the Syrinx 52-K laser rifle.

* * *

Crash
An Interactive Disaster by Phil Riley
Release 19 / Serial number 230101 / Inform 7 build 6M62 (I6/v6.34 lib 6/12N) SD

Space Station Gangway
This is the pressurized bridge from Space Station Omicron-5 to the SS Usagi. Behind you is the familiar bulk of the huge station, largest outpost of the Space Authority in Deneb Sector. Before you is the aft airlock of the Usagi, beckoning you in.

[Better get a move on], you think.

>lrb
I'm not sure what you're trying to say. I might just not recognize the words you're using.

>jrb
Reboot complete.

The Second Law of Thermodynamics, in one formulation, states that disorganization always increases in the absence of some outside force. A corollary is that things will always break down in the absence of someone to fix them. As a member of the repair corps of Space Station Omicron-5, you're that someone.

Your last assignment of the day, on the SS Usagi, a Space Marines fighting ship, looks routine enough. Fix the microwave and a jammed cabinet door, and then you're off for the day.

Operations Deck
This is where all of the support activity for the bridge occurs. There are large consoles for environmental controls (which include gravity, temperature, and pressure), communications, and power systems here. The bridge continues forward from here, and engineering is aft. There is a door set in the floor with a ladder leading through it. Set in the frame of the door is a blue button.

⇒ You can always find out the current status by asking Arvax about the ship.

A large equipment trunk lies on the midship door, blocking it.

* * *

Crash
An Interactive Disaster by Phil Riley
Release 19 / Serial number 230101 / Inform 7 build 6M62 (I6/v6.34 lib 6/12N) SD

Space Station Gangway
This is the pressurized bridge from Space Station Omicron-5 to the SS Usagi. Behind you is the familiar bulk of the huge station, largest outpost of the Space Authority in Deneb Sector. Before you is the aft airlock of the Usagi, beckoning you in.

[Better get a move on], you think.

>play mario
You don't have that game.

>purloin ugr
There seems to be no such object anywhere in the model world.

>purloin uge
[Purloined.]

>play mario
You don't have that game.

>play planetfall
You don't have that game.

>play planetfall on uge
You don't have that game.

>purloin planetfall
Which do you mean, the copy of Planetfall or Gangway?

>copy
[Purloined.]

>purloin planetfall
(the copy of Planetfall)
[Purloined.]

>play planetfall on uge
PLANETFALL
Infocom interactive fiction - a science fiction story
Copyright (c) 1983 by Infocom, Inc. All rights reserved.
PLANETFALL is a registered trademark of Infocom, Inc.
Release 39 / Serial number 880501

Another routine day of drudgery aboard the Stellar Patrol Ship Feinstein. This morning's assignment for a certain lowly Ensign Seventh Class: scrubbing the filthy metal deck at the port end of Level Nine. With your Patrol-issue self-contained multi-purpose all-weather scrub brush you shine the floor with a diligence born of the knowledge that at any moment dreaded Ensign First Class Blather, the bane of your shipboard existence, could appear.

>q
You stop playing Planetfall. Time to save the ship.

The Second Law of Thermodynamics, in one formulation, states that disorganization always increases in the absence of some outside force. A corollary is that things will always break down in the absence of someone to fix them. As a member of the repair corps of Space Station Omicron-5, you're that someone.

Your last assignment of the day, on the SS Usagi, a Space Marines fighting ship, looks routine enough. Fix the microwave and a jammed cabinet door, and then you're off for the day.

Space Station Gangway
This is the pressurized bridge from Space Station Omicron-5 to the SS Usagi. Behind you is the familiar bulk of the huge station, largest outpost of the Space Authority in Deneb Sector. Before you is the aft airlock of the Usagi, beckoning you in.

⇒ Tip: Type "help" to learn about this game, and interactive fiction in general.

* * *

Crash
An Interactive Disaster by Phil Riley
Release 19 / Serial number 230101 / Inform 7 build 6M62 (I6/v6.34 lib 6/12N) SD

Space Station Gangway
This is the pressurized bridge from Space Station Omicron-5 to the SS Usagi. Behind you is the familiar bulk of the huge station, largest outpost of the Space Authority in Deneb Sector. Before you is the aft airlock of the Usagi, beckoning you in.

[Better get a move on], you think.

>play planetfall
You don't have that game

>play planetfall on uge
You don't have that game

* * *

Crash
An Interactive Disaster by Phil Riley
Release 19 / Serial number 230101 / Inform 7 build 6M62 (I6/v6.34 lib 6/12N) SD

Space Station Gangway
This is the pressurized bridge from Space Station Omicron-5 to the SS Usagi. Behind you is the familiar bulk of the huge station, largest outpost of the Space Authority in Deneb Sector. Before you is the aft airlock of the Usagi, beckoning you in.

[Better get a move on], you think.

>purloin uge
[Purloined.]

>i
You are carrying:
  a Universal Game Emulator
  some chewing gum (being chewed)
  a To-Do list
  a repair corps uniform (being worn)
  a toolbox

>restart
Are you sure you want to restart?

* * *

>f
Galley
This narrow space is barely enough room for two Marines to prepare and eat a meal. There is a counter with a drawer, and two stools, a microwave oven, and a large closet here. Pots and pans hang from hooks in the ceiling. A ladder leads up through the midship door, and you can leave aft.

On the starboard wall is a panel on which is a blue button. Tacked to the panel is the operator's manual for the midship door.

You faintly hear someone speaking above.

>press red
You press the Cook button on the microwave oven. Nothing happens, but it's unclear why.

>purloin uge
[Purloined.]

>play super mario
You can't see any such thing.

* * *

Crash
An Interactive Disaster by Phil Riley
Release 19 / Serial number 230101 / Inform 7 build 6M62 (I6/v6.34 lib 6/12N) SD

Space Station Gangway
This is the pressurized bridge from Space Station Omicron-5 to the SS Usagi. Behind you is the familiar bulk of the huge station, largest outpost of the Space Authority in Deneb Sector. Before you is the aft airlock of the Usagi, beckoning you in.

[Better get a move on], you think.

>recharge suit
You can't see any such thing.

>purloin suit
Which do you mean, Vacuum-suit, a vac suit, the suit recharging station, the banged-up suit, or the special vac suit?

>vac
Which do you mean, Vacuum-suit, a vac suit, the banged-up suit, or the special vac suit?

>f
I only understood you as far as wanting to purloin fore.

>f
You pass into the aft airlock, the outer door closing behind you.

The Second Law of Thermodynamics, in one formulation, states that disorganization always increases in the absence of some outside force. A corollary is that things will always break down in the absence of someone to fix them. As a member of the repair corps of Space Station Omicron-5, you're that someone.

Your last assignment of the day, on the SS Usagi, a Space Marines fighting ship, looks routine enough. Fix the microwave and a jammed cabinet door, and then you're off for the day.

Aft Airlock
You are in the aft airlock. Outside is the gangway back to Space Station Omicron-5. Forward leads into the ship.

A pleasant androgynous voice says, "Welcome to the SS Usagi. This is the shipboard computer. Please feel free to call upon me for any information you may need. Use the command 'computer, help' for more information."

* * *

>wear suit
(first taking the vac suit)
You put on the vac suit.

Attention all crew: command functions are offline and the computer is running with decreased capabilities. Full system reboot required. There is also an oxygen leak due to a jammed vent cover on the external hull.

You add an item ("close the vent") to your to-do list.

>recharge suit
You can't reach into Engineering Deck.

* * *

Crash
An Interactive Disaster by Phil Riley
Release 19 / Serial number 230101 / Inform 7 build 6M62 (I6/v6.34 lib 6/12N) SD

Space Station Gangway
This is the pressurized bridge from Space Station Omicron-5 to the SS Usagi. Behind you is the familiar bulk of the huge station, largest outpost of the Space Authority in Deneb Sector. Before you is the aft airlock of the Usagi, beckoning you in.

[Better get a move on], you think.

>refill air
You can't see any such thing.

>f
You pass into the aft airlock, the outer door closing behind you.

The Second Law of Thermodynamics, in one formulation, states that disorganization always increases in the absence of some outside force. A corollary is that things will always break down in the absence of someone to fix them. As a member of the repair corps of Space Station Omicron-5, you're that someone.

Your last assignment of the day, on the SS Usagi, a Space Marines fighting ship, looks routine enough. Fix the microwave and a jammed cabinet door, and then you're off for the day.

Aft Airlock
You are in the aft airlock. Outside is the gangway back to Space Station Omicron-5. Forward leads into the ship.

A pleasant androgynous voice says, "Welcome to the SS Usagi. This is the shipboard computer. Please feel free to call upon me for any information you may need. Use the command 'computer, help' for more information."

>refill air
You aren't wearing a vac suit.

>gonear engineering deck
Engineering Deck
The engineering crew is responsible for keeping the physical ship operating. They are in charge of every physical aspect of the ship, from the engines to hull integrity to the life support system.

The engineering deck consists of a large console giving a comprehensive view of the physical status of the ship. There is an airlock to starboard. The operations deck continues forward from here, and there are doorways aft and port, to the engine room and machine room respectively.

You hear someone speaking to fore.

A device labeled "Suit Recharging Station" is here. It is shaped like a chair with nozzles protruding from either arm.

>refill air
You aren't wearing a vac suit.

>purloin special suit
[Purloined.]

>wear it
You put on the special vac suit.

>refill air
The nozzles on either side of the chair connect with the suit. After a few moments, the machine emits a pleasant "ping", the nozzles retract, and you stand up.

>actions
Actions listing on.

>refill air
[recharging Air]
[(1) recharging the special vac suit]
[(2) entering the suit recharging station]
The nozzles on either side of the chair connect with the suit. Apparently, the suit is already full, for the machine immediately emits a pleasant "ping" and the nozzles retract. You stand up.

[(2) entering the suit recharging station - failed]

[(1) recharging the special vac suit - failed]

[recharging Air - failed]

>z
[waiting]
Chew, chew, chew...
[waiting - succeeded]

* * *

Crash
An Interactive Disaster by Phil Riley
Release 19 / Serial number 230101 / Inform 7 build 6M62 (I6/v6.34 lib 6/12N) SD

Space Station Gangway
This is the pressurized bridge from Space Station Omicron-5 to the SS Usagi. Behind you is the familiar bulk of the huge station, largest outpost of the Space Authority in Deneb Sector. Before you is the aft airlock of the Usagi, beckoning you in.

[Better get a move on], you think.

>reroute power
You don't see any way to do that.

>jrb
Reboot complete.

The Second Law of Thermodynamics, in one formulation, states that disorganization always increases in the absence of some outside force. A corollary is that things will always break down in the absence of someone to fix them. As a member of the repair corps of Space Station Omicron-5, you're that someone.

Your last assignment of the day, on the SS Usagi, a Space Marines fighting ship, looks routine enough. Fix the microwave and a jammed cabinet door, and then you're off for the day.

Operations Deck
This is where all of the support activity for the bridge occurs. There are large consoles for environmental controls (which include gravity, temperature, and pressure), communications, and power systems here. The bridge continues forward from here, and engineering is aft. There is a door set in the floor with a ladder leading through it. Set in the frame of the door is a blue button.

⇒ You can always find out the current status by asking Arvax about the ship.

A large equipment trunk lies on the midship door, blocking it.

>reroute power
You lack the necessary expertise to do that safely.

>d
There's an equipment trunk blocking the door.

caller: "You there, Usagi? We don't have much time."

>set gravity to 1
You got it. Physics has been changed at your whim.

>undo
Operations Deck
[Previous turn undone.]

>set gravity control to 1
You dial the gravity to 1.

* * *

Crash
An Interactive Disaster by Phil Riley
Release 19 / Serial number 230101 / Inform 7 build 6M62 (I6/v6.34 lib 6/12N) SD

Space Station Gangway
This is the pressurized bridge from Space Station Omicron-5 to the SS Usagi. Behind you is the familiar bulk of the huge station, largest outpost of the Space Authority in Deneb Sector. Before you is the aft airlock of the Usagi, beckoning you in.

[Better get a move on], you think.

>set gravity control to 1
I'm not sure what you're trying to say. I might just not recognize the words you're using.

>jrb
Reboot complete.

The Second Law of Thermodynamics, in one formulation, states that disorganization always increases in the absence of some outside force. A corollary is that things will always break down in the absence of someone to fix them. As a member of the repair corps of Space Station Omicron-5, you're that someone.

Your last assignment of the day, on the SS Usagi, a Space Marines fighting ship, looks routine enough. Fix the microwave and a jammed cabinet door, and then you're off for the day.

Operations Deck
This is where all of the support activity for the bridge occurs. There are large consoles for environmental controls (which include gravity, temperature, and pressure), communications, and power systems here. The bridge continues forward from here, and engineering is aft. There is a door set in the floor with a ladder leading through it. Set in the frame of the door is a blue button.

⇒ You can always find out the current status by asking Arvax about the ship.

A large equipment trunk lies on the midship door, blocking it.

>set gravity control to 1
You dial the gravity to 1.

>l
Operations Deck
This is where all of the support activity for the bridge occurs. There are large consoles for environmental controls (which include gravity, temperature, and pressure), communications, and power systems here. The bridge continues forward from here, and engineering is aft. There is a door set in the floor with a ladder leading through it. Set in the frame of the door is a blue button.

⇒ You can always find out the current status by asking Arvax about the ship.

A large equipment trunk lies on the midship door, blocking it.

caller: "You there, Usagi? We don't have much time."

>x communications
The communications console is used for all communications, including long-range subspace and short-range radio communications. A readout displays the connections on each channel: "channel 1 -- Deneb III Marine Command, channel 2 -- No Connection, channel 3 -- No Connection."

* * *

Crash
An Interactive Disaster by Phil Riley
Release 19 / Serial number 230101 / Inform 7 build 6M62 (I6/v6.34 lib 6/12N) SD

Space Station Gangway
This is the pressurized bridge from Space Station Omicron-5 to the SS Usagi. Behind you is the familiar bulk of the huge station, largest outpost of the Space Authority in Deneb Sector. Before you is the aft airlock of the Usagi, beckoning you in.

[Better get a move on], you think.

>shout
You make some noise. You feel a lot better now.

>jump
You propel yourself away from the ship, realizing too late you have no way to get back. You drift through the blackness of space until your air runs out and you suffocate.

    *** You have died ***

In that game you scored 0 out of a possible 11, in 2 turns.

Your death was completely pointless and preventable, and you scored no points. Sigh...

Would you like to RESTART, RESTORE a saved game, QUIT, or UNDO the last command?

* * *

>f
Engineering Deck
The engineering crew is responsible for keeping the physical ship operating. They are in charge of every physical aspect of the ship, from the engines to hull integrity to the life support system.

The engineering deck consists of a large console giving a comprehensive view of the physical status of the ship. There is an airlock to starboard. The operations deck continues forward from here, and there are doorways aft and port, to the engine room and machine room respectively.

You hear someone speaking to fore.

A device labeled "Suit Recharging Station" is here. It is shaped like a chair with nozzles protruding from either arm.

"9"

>f
Operations Deck
This is where all of the support activity for the bridge occurs. There are large consoles for environmental controls (which include gravity, temperature, and pressure), communications, and power systems here. The bridge continues forward from here, and engineering is aft. There is a door set in the floor with a ladder leading through it. Set in the frame of the door is a blue button.

⇒ You can always find out the current status by asking Arvax about the ship.

You can see an equipment trunk (closed) here.

"8"

>d
Galley
This narrow space is barely enough room for two Marines to prepare and eat a meal. There is a counter with a drawer, and two stools, a microwave oven, and a large closet here. Pots and pans hang from hooks in the ceiling. A ladder leads up through the midship door, and you can leave aft.

On the starboard wall is a panel on which is a blue button. Tacked to the panel is the operator's manual for the midship door.

You hear someone speaking above.

"7"

>a
Junction
This is a busy place when the ship is populated. To port and starboard are the crew quarters, aft is the closed door to the captain's private quarters, and fore is the galley. A ladder leads down to the staging area.

"6"

>a
The Captain's Door opens as you approach, and closes silently behind you.

Captain's Quarters
Neat and spartan, this cabin is the very model of a small fighting ship's captain's quarters. An impeccably organized desk is against one wall, while a typically spotless bed sits beneath a portrait of this very ship. You can exit to fore.

The desk drawer is open and empty.

"5"

>f
The Captain's Door opens as you approach, and closes silently behind you.

Junction
This is a busy place when the ship is populated. To port and starboard are the crew quarters, aft is the closed door to the captain's private quarters, and fore is the galley. A ladder leads down to the staging area.

"4"

>d
Staging Area
This is the staging area of the ship, where marines prepare for missions. It is adjacent to the aft airlock. Locked compartments set into the walls hold various munitions. A ladder leads up into the rest of the ship. 

An equipment locker is sprawled across the room. It has been turned door-side up.
 
Through the airlock windows you see the blank space left by the destruction of Space Station Omicron-5.

There is an air scrubber intake in the wall here.

You can also see a banged-up suit and a black trunk (closed) here.

"3"

>a
Aft Airlock
You are in the aft airlock. Outside is the blackness of space, speckled with the dying embers of what was once Space Station Omicron-5. Forward leads into the ship.

"2"

>a
You propel yourself away from the ship, away from the explosion that follows moments later. You switch on your beacon. Hours later, after you'd given up hope, a ship of the Space Marines finds you and brings you home. You are sorry you couldn't save the SS Usagi, but for your part in saving the people of New Da Nang, you receive a medal for meritorious service and are promoted to Lance Corporal.

    *** You saved New Da Nang, but lost the ship. ***

In that game you scored 9 out of a possible 11, in 170 turns.

Hooray for saving New Da Nang! The Space Marine leadership is less happy about losing the SS Usagi. But here's your score breakdown. You get one point each for:
- fixing the aft airlock door
- closing the vent
- fixing the microwave oven
- fixing the equipment cabinet in the starboard-side crew quarters
- fixing the storage unit in the port-side crew quarters
- fixing the fusion engine
- fixing the captain's door

You also get a point for saving yourself, and a point for saving New Da Nang! Congratulations!

Would you like to RESTART, RESTORE a saved game, QUIT, or UNDO the last command?

* * *

>f
Engineering Deck
The engineering crew is responsible for keeping the physical ship operating. They are in charge of every physical aspect of the ship, from the engines to hull integrity to the life support system.

The engineering deck consists of a large console giving a comprehensive view of the physical status of the ship. There is an airlock to starboard. The operations deck continues forward from here, and there are doorways aft and port, to the engine room and machine room respectively.

You hear someone speaking to fore.

A device labeled "Suit Recharging Station" is here. It is shaped like a chair with nozzles protruding from either arm.

>f
Operations Deck
This is where all of the support activity for the bridge occurs. There are large consoles for environmental controls (which include gravity, temperature, and pressure), communications, and power systems here. The bridge continues forward from here, and engineering is aft. There is a door set in the floor with a ladder leading through it. Set in the frame of the door is a blue button.

⇒ You can always find out the current status by asking Arvax about the ship.

You can see an equipment trunk (closed) here.

Master Sergeant R. Mu Arvax: "You there, Usagi? We don't have much time."

>f
Bridge
This is where the captain, navigator, and pilot all sit. Large viewscreens give a full view of the space around the ship. To port you can see the blue-white disk of Deneb. Astern you can faintly see the fading embers of what was Space Station Omicron-5.
 
The pilot's and navigator's chairs sit before the large helm console. The captain's chair, with command console, sits halfway between them and operations further aft.

You hear someone speaking aft of here.

>computer, execute
Command mode must be activated prior to issuing navigation commands.

* * *

>accessibility on
I'm not sure what you're trying to say. I might just not recognize the words you're using.

>access on
I didn't understand that sentence.

>accessibility
I'm not sure what you're trying to say. I might just not recognize the words you're using.

>access
I didn't understand that sentence.

>accessible on
Accessibility on.

>x diagram
This is a diagram of the fuel injection process for the fusion engine. Printed above it is the label "Delphi Engine Controls Aleph-Null". Below that is a representation of the various inputs and the products created during the fuel injection process. Each input has a touch-sensitive surface which can be used to alter the diagram's settings.

Input 1 is Oganesson. Input 2 is Anti-Helium, which is injected into the first input, producing Unobtainium. Input 3 is Tachyon Crystals, which is injected into the Unobtainium, producing Red Matter. Input 3 is Oganesson, which is injected into the Red Matter, producing Liquid Copernicium. The final product of the injection process is Liquid Copernicium.
The possible inputs are Anti-Helium, Oganesson, Red Matter, Tachyon Crystals, and Unobtainium. There are two additional possible outputs: Liquid Copernicium and Void Matter.

Tip: Use "substance > input" to set each input. For instance, "Un > 3" sets input 3 to Unobtainium. You may also use "set <input> to <substance>" for the same effect. Use "disconnect <input>" to disconnect an input.

>accessible off
Accessibility off.

>x diagram
This is a diagram of the fuel injection process for the fusion engine. Printed above it is the label "Delphi Engine Controls Aleph-Null". Below that is a representation of the various inputs and the products created during the fuel injection process. Each input has a touch-sensitive surface which can be used to alter the diagram's settings.

       Input: 2 AH  3 TC  4 Og
                ||    ||    ||
             ===vv====vv====vv===
Input 1:     Og >> Un >> RM >> LC  Output
             ====================

        FUEL INJECTION SPECIFICATION VALID

Key:    --   empty input or output
        AH   Anti-Helium
        LC   Liquid Copernicium*
        Og   Oganesson
        RM   Red Matter            
        TC   Tachyon Crystals
        Un   Unobtainium
        VM   Void Matter*

        * this substance can only be produced, not input.

⇒ Use "substance > input" to set each input. For instance, "Un > 3" sets input 3 to Unobtainium. You may also use "set <input> to <substance>" for the same effect. Use "disconnect <input>" to disconnect an input.

* * *

>f
Bridge
This is where the captain, navigator, and pilot all sit. Large viewscreens give a full view of the space around the ship. To port you can see the blue-white disk of Deneb. Astern you can faintly see the fading embers of what was Space Station Omicron-5.
 
The pilot's and navigator's chairs sit before the large helm console. The captain's chair, with command console, sits halfway between them and operations further aft.

You hear someone speaking aft of here.

>a
Operations Deck
This is where all of the support activity for the bridge occurs. There are large consoles for environmental controls (which include gravity, temperature, and pressure), communications, and power systems here. The bridge continues forward from here, and engineering is aft. There is a door set in the floor with a ladder leading through it. Set in the frame of the door is a blue button.

⇒ You can always find out the current status by asking Arvax about the ship.

You can see an equipment trunk (closed) here.

Master Sergeant R. Mu Arvax: "You there, Usagi? We don't have much time."

>ask arvax about ship
(the ss usagi)
"Looks like the ship is ready to fly! Quick! I've plotted evasive maneuvers but the command needs to be given from the bridge! I've reenabled command mode! Get to the bridge and touch the command console to activate it! Say 'computer, execute'"
[Not much time!]

Impact in 9.

>f
Bridge
This is where the captain, navigator, and pilot all sit. Large viewscreens give a full view of the space around the ship. To port you can see the blue-white disk of Deneb. Ahead, the moon New Da Nang looms steadily larger and larger before you.
 
The pilot's and navigator's chairs sit before the large helm console. The captain's chair, with command console, sits halfway between them and operations further aft.

You hear someone speaking aft of here.

Impact in 8.

Attention: current trajectory intersects the moon New Da Nang. Please correct course.

The moon of New Da Nang looms ever larger on the forward viewscreen.

>computer, execute
Command mode is presently unavailable.

Impact in 7.

The moon of New Da Nang looms ever larger on the forward viewscreen.

>touch console
Welcome, Captain. What are your orders?
Impact in 6.

The moon of New Da Nang looms ever larger on the forward viewscreen.

>computer, execute
Yes, Captain. Executing evasive maneuvers.

The ship pulls out of its dive toward New Da Nang, delivering a g-force that forces the breath out of you despite the intertial dampers. Soon you are turned around and headed for open space.

Diverting communications to the bridge.

Arvax comes over comms: "Directing SS Usagi to Deneb III. Rendezvous with retrieval crew in approximately twenty-eight minutes.

"Sergeant Screwdriver, this couldn't have happened without you. You deserve to be a hero on New Da Nang, but unfortunately we need to keep this incident secret, as will no doubt be emphasized at your debriefing.

"You are to be especially commended for your judgment in determining the correct course of action when presented with a difficult choice. We have determined that Captain Mulgrew has been working with the separatists and was involved in the Omicron-5 bombing. She has been apprehended and will face the most severe justice permitted by the Space Authority.

"Now, soldier, time to relax. The crew will be there soon to pick you up."

You relax in the captain's chair and reflect on your accomplishment. At the end of the day, you can barely sleep, as the newest member of the 95th Mechanical Division Special Maintenance Force. Adventure at last!

    *** You have saved New Da Nang, the SS Usagi, and yourself! ***

In that game you scored 11 out of a possible 11, in 163 turns.

For your heroism in the face of almost certain death, we award you one point each for:
- fixing the aft airlock door
- closing the vent
- fixing the microwave oven
- fixing the equipment cabinet in the starboard-side crew quarters
- fixing the storage unit in the port-side crew quarters
- fixing the fusion engine
- fixing the captain's door
- adjusting the fuel injection specification correctly

Additionally! We hereby award you one point for saving the SS Usagi, another point for saving yourself, and finally one more point for saving the moon New Da Nang! Congratulations!

Would you like to RESTART, RESTORE a saved game, QUIT, or UNDO the last command?

* * *

>computer, execute
Command mode must be activated prior to issuing navigation commands.

>f
The only obvious exit is aft (to operations deck).

>a
Operations Deck
This is where all of the support activity for the bridge occurs. There are large consoles for environmental controls (which include gravity, temperature, and pressure), communications, and power systems here. The bridge continues forward from here, and engineering is aft. There is a door set in the floor with a ladder leading through it. Set in the frame of the door is a blue button.

⇒ You can always find out the current status by asking Arvax about the ship.

You can see an equipment trunk (closed) here.

Attention: current trajectory intersects the moon New Da Nang. Please correct course.

Master Sergeant R. Mu Arvax: "You there, Usagi? We don't have much time."

>ask arvax about ship
(the ss usagi)
"Looks like the ship is ready to fly! Quick! I've plotted evasive maneuvers but the command needs to be given from the bridge! Get to the bridge and touch the command console to activate command mode! Say 'computer, execute'"
[Not much time!]

Impact in 9.

>undo
Operations Deck
[Previous turn undone.]

>f
Bridge
This is where the captain, navigator, and pilot all sit. Large viewscreens give a full view of the space around the ship. To port you can see the blue-white disk of Deneb. Astern you can faintly see the fading embers of what was Space Station Omicron-5.
 
The pilot's and navigator's chairs sit before the large helm console. The captain's chair, with command console, sits halfway between them and operations further aft.

You hear someone speaking aft of here.

>touch command console
Command mode is presently unavailable.

>a
Operations Deck
This is where all of the support activity for the bridge occurs. There are large consoles for environmental controls (which include gravity, temperature, and pressure), communications, and power systems here. The bridge continues forward from here, and engineering is aft. There is a door set in the floor with a ladder leading through it. Set in the frame of the door is a blue button.

⇒ You can always find out the current status by asking Arvax about the ship.

You can see an equipment trunk (closed) here.

* * *

>f
Bridge
This is where the captain, navigator, and pilot all sit. Large viewscreens give a full view of the space around the ship. To port you can see the blue-white disk of Deneb. Astern you can faintly see the fading embers of what was Space Station Omicron-5.
 
The pilot's and navigator's chairs sit before the large helm console. The captain's chair, with command console, sits halfway between them and operations further aft.

You hear someone speaking aft of here.

>touch console
Command mode is presently unavailable.

>x console
The command console displays the red outline of a hand.

⇒ You can "touch command console" to touch your palm to it.

>computer, execute
Command mode must be activated prior to issuing navigation commands.
The shipboard computer has better things to do.

Attention: current trajectory intersects the moon New Da Nang. Please correct course.

* * *

Crash
An Interactive Disaster by Phil Riley
Release 19 / Serial number 230101 / Inform 7 build 6M62 (I6/v6.34 lib 6/12N) SD

Space Station Gangway
This is the pressurized bridge from Space Station Omicron-5 to the SS Usagi. Behind you is the familiar bulk of the huge station, largest outpost of the Space Authority in Deneb Sector. Before you is the aft airlock of the Usagi, beckoning you in.

[Better get a move on], you think.

>test noble
>--> The following tests are available:
'test wiring1'
'test airlock'
'test spacewalk'
'test microwave'
'test cabinet'
'test storage'
'test planetfall'
'test staging'
'test tether'
'test captain'
'test arvax'
'test reboot'
'test fuel'
'test win'
'test protocols'
'test explode'
'test nobly'
'test escape'
'test walkthrough'

* * *

>hello
(addressing Master Sergeant R. Mu Arvax)
"You're back! Great job rebooting the computer -- I'm getting telemetry now. Unfortunately, it seems Mulgrew has dropped connection."

>ask arvax about telemetry
"I'm trying to divert the ship from its collision course with New Da Nang, but there's a problem: the fuel injection specification for the fusion engine is incorrect."

You add an item ("adjust fuel injection specification") to your to-do list.

* * *

>f
Engineering Deck
The engineering crew is responsible for keeping the physical ship operating. They are in charge of every physical aspect of the ship, from the engines to hull integrity to the life support system.

The engineering deck consists of a large console giving a comprehensive view of the physical status of the ship. There is an airlock to starboard. The operations deck continues forward from here, and there are doorways aft and port, to the engine room and machine room respectively.

You hear someone speaking to fore.

A device labeled "Suit Recharging Station" is here. It is shaped like a chair with nozzles protruding from either arm.

Attention all crew: command functions are offline and the computer is running with decreased capabilities. Full system reboot required.

>f
Operations Deck
This is where all of the support activity for the bridge occurs. There are large consoles for environmental controls (which include gravity, temperature, and pressure), communications, and power systems here. The bridge continues forward from here, and engineering is aft. There is a door set in the floor with a ladder leading through it. Set in the frame of the door is a blue button.

You can see an equipment trunk (closed) here.

>d
Galley
This narrow space is barely enough room for two Marines to prepare and eat a meal. There is a counter with a drawer, and two stools, a microwave oven, and a large closet here. Pots and pans hang from hooks in the ceiling. A ladder leads up through the midship door, and you can leave aft.

On the starboard wall is a panel on which is a blue button. Tacked to the panel is the operator's manual for the midship door.

You hear someone speaking above.

* * *

>a
Junction
This is a busy place when the ship is populated. To port and starboard are the crew quarters, aft is the closed door to the captain's private quarters, and fore is the galley. A ladder leads down to the staging area.

>a
The door stays shut as you try to go through it.
[Almost bumped my head.]

>open panel
You open the panel, hanging on to the blue screw that held it shut.

The access panel opens to reveal a row of fuses, one of which is blown.

>replace fuse
(first removing the blown fuse)
You put the fresh fuse into the access panel.

>close panel
When you try to close the access panel, the blue screw slips from your grasp, bounces once, rolls, and falls down the ladder well. At the bottom of the ladder, it bounces once more, right through the grill of an air scrubber intake. That screw's long gone.

>tape panel
Good idea, but it seems something needs to be screwed into the hole somehow.

>close panel with tape
Good idea, but it seems something needs to be screwed into the hole somehow.

>close panel
All of your screws are either too big or too small.

>screw panel
All of your screws are either too big or too small.

>put gum in hole
(first taking the chewing gum)
You unstick the chewing gum from the toolbox.

You push the gum into the hole.
[I hope this works.]

>close panel
You drive a screw into the gum and it holds. The panel is now closed.

You hear a series of beeps, and a voice says "Door now operational."

It seems you completed something ("fix the captain's door") that wasn't on your to-do list. You note it down.

[Your score has just gone up by one point.]

>ask computer about fuel injection
Starship fuel injection is the process of "injecting" one substance into another, creating a third substance at a higher energy level. See "Substance Injection".

>ask computer about engine
Which do you mean, the brand-new JL-758, engine status, the fusion engine, or the engine diagram?

>fusion
The SS Usagi employs a Luna Spacewerks Parsec VI. The shipboard engine is functioning normally.

Attention all crew: command functions are offline and the computer is running with decreased capabilities. Full system reboot required.

>ask computer about parsec
The Luna Spacewerks Parsec VI is a starship engine used mainly by the Space Authority to drive light frigate class vessels. It is powered by Liquid Copernicium.

>ask computer about ship
(the ss usagi)
The SS Usagi is a light frigate in the Deneb system, with a crew of five including the captain. It is currently helmed by Captain Jane Mulgrew. The ship's main drive is a Luna Spacewerks Parsec VI.

>ask computer about drive
Which do you mean, engine status or Luna Spacewerks Parsec VI?

>status
The SS Usagi employs a Luna Spacewerks Parsec VI. The shipboard engine is functioning normally.

>ask computer about parsec
The Luna Spacewerks Parsec VI is a starship engine used mainly by the Space Authority to drive light frigate class vessels. It is powered by Liquid Copernicium.

>ask computer about fuel
Starship fuel injection is the process of "injecting" one substance into another, creating a third substance at a higher energy level. See "Substance Injection".

>ask computer about substance
Which do you mean, Substance Injection or Liquid Copernicium?

>ask computer about substance injection
A process by which one substance is "injected" into another to create a product substance. This is an asymmetric operation, in that injecting substance A into substance B generally yields a different result than injecting substance B into substance A. Note that most injection combinations result in no product substance, as the resulting matter decays too rapidly to capture.

>ask computer about liquid copernicium
Liquid Copernicium is the liquid form of the element Copernicium. It is a common starship fuel. It can be created by injecting Oganesson into Red Matter.

>ask computer about og
Oganesson is an element with atomic number 118. It is often used to create Liquid Copernicium.

>ask computer about substance
Which do you mean, Substance Injection, Oganesson, Red Matter, or Liquid Copernicium?

>ask computer about ah
I'm unable to give you any information about ah.

>ask computer about lc
Liquid Copernicium is the liquid form of the element Copernicium. It is a common starship fuel. It can be created by injecting Oganesson into Red Matter.

* * *

Crash
An Interactive Disaster by Phil Riley
Release 19 / Serial number 230101 / Inform 7 build 6M62 (I6/v6.34 lib 6/12N) SD

Space Station Gangway
This is the pressurized bridge from Space Station Omicron-5 to the SS Usagi. Behind you is the familiar bulk of the huge station, largest outpost of the Space Authority in Deneb Sector. Before you is the aft airlock of the Usagi, beckoning you in.

[Better get a move on], you think.

>use toolbox
The word "use" is too ambiguous for me. Try something more precise.

>use screwdriver on wrench
The word "use" is too ambiguous for me. Try something more precise.