Crash
An Interactive Disaster by Phil Riley
Release 6 / Serial number 220730 / Inform 7 build 6M62 (I6/v6.34 lib 6/12N) SD

Space Station Gangway
This is the pressurized bridge from Space Station Omicron-5 to the SS Usagi. Behind you is the familiar bulk of the huge station, largest outpost of the Space Authority in Deneb Sector. Before you is the aft airlock of the Usagi, beckoning you in.

[Better get a move on], you think.

>f
You pass into the aft airlock, the outer door closing behind you.

The Second Law of Thermodynamics, in one formulation, states that disorganization always increases in the absence of some outside force. A corollary is that things will always break down in the absence of someone to fix them. As a member of the repair corps of Space Station Omicron-5, you're that someone.

Your last assignment of the day, on the SS Usagi, a Space Marines fighting ship, looks routine enough. Fix the microwave and a jammed locker door, and then you're off for the day.

Aft Airlock
You are in the aft airlock. Outside is the gangway back to Space Station Omicron-5. Forward leads into the ship.

A pleasant androgynous voice says, "Welcome to the SS Usagi. This is the shipboard computer. Please feel free to call upon me for any information you may need. Use the command 'computer, help' for more information."

>ask computer about gravity
The gravity is currently set to 5.

>set gravity to 0
You got it. Physics has been changed at your whim.

>ask computer about gravity
The gravity is currently set to 0.

>set gravity to 10
You got it. Physics has been changed at your whim.

>ask computer about gravity
The gravity is currently set to 10.

* * *

>ask computer about khotpanya
I'm unable to give you any information about khotpanya.

>f
You enter the ship from the airlock. The inner door closes behind you.

Staging Area
This is the staging area of the ship, where marines prepare for missions. It is adjacent to the aft airlock. It houses a number of vac suits in an open locker, and various munitions in locked compartments set into the walls. A ladder leads up into the rest of the ship. 
Through the airlock windows you can see the gangway to Space Station Omicron-5.

What looks like part of an engine is stowed in a corner.

>u
You climb the la--

***BOOM***

Press any key...

A gigantic force grabs the ship, knocking you off the ladder and sending you flying against an aft bulkhead. The inertial dampers are probably all that saved you from being smashed to jelly rather than just banged up. 

Press any key...

Some time later you find yourself lying on the floor of the staging area with a throbbing headache. Gingerly you push yourself to your knees and stand up. The vac suit locker has detached from its mounting and slammed into the airlock door.

[Thank god I wasn't in the way of that.]

Looking outside --

[Holy -- ]

[Where's the station?].

Where Space Station Omicron-5 was, is now an expanding sphere of rubble, dimly lit by the blue light of far-off Deneb. The rubble is clearly receding behind the ship. [We're moving!]

[How am I going to get off this ship?]

Press any key...

Staging Area
This is the staging area of the ship, where marines prepare for missions. It is adjacent to the aft airlock. Locked compartments set into the walls hold various munitions. A ladder leads up into the rest of the ship. 

An equipment locker is sprawled across the room, with its door to the ground.
 
Through the airlock windows you see the blank space left by the destruction of Space Station Omicron-5.

What looks like part of an engine is stowed in a corner.

A vac suit is here, lying prone as if it were some malformed yellow person knocked unconscious by the shaking of the ship. It has chewing gum stuck to it.

[What now?]

[I think I spit out my gum.]

Crash
An Interactive Disaster by Phil Riley
Release 6 / Serial number 220730 / Inform 7 build 6M62 (I6/v6.34 lib 6/12N) SD

>u
Junction
This is a busy place when the ship is populated. To port and starboard are the crew quarters, aft is the closed door to the captain's private quarters, and fore is the galley. A ladder leads down to the staging area.

⇒ You can enter "hints" at any time for help in progressing in the game.

>p
Port-Side Crew Quarters
All crew members who aren't the captain sleep in this or the opposite-side bunk room. This one sleeps two in a bunk bed, done up with military precision. There is a large cabinet here, stretching almost to the ceiling. It is closed. Mounted in the wall is a crew personal storage unit. The sole exit is to starboard.

>ask computer about khotpanya
I'm unable to give you any information about khotpanya.

>look at top drawer
The top drawer is labeled "Franck". It is closed.

>look at bottom drawer
The bottom drawer is labeled "Khotpanya". The bottom drawer is closed.

>ask computer about khotpanya
I'm unable to give you any information about khotpanya.

>x bottom drawer
The bottom drawer is labeled "Khotpanya". The bottom drawer is closed.

>ask computer about khotpanya
I'm unable to give you any information about khotpanya.

>s
Junction
This is a busy place when the ship is populated. To port and starboard are the crew quarters, aft is the closed door to the captain's private quarters, and fore is the galley. A ladder leads down to the staging area.

>s
Starboard-Side Crew Quarters
All crew members who aren't the captain sleep in this or the opposite-side bunk room. This one sleeps two in a bunk bed, done up with military precision. There is a large cabinet here, stretching almost to the ceiling. It is closed. Mounted in the wall is a crew personal storage unit. The sole exit is to port.

In a shocking lapse of military precision, there is a sticky note attached to the bed post.

A pair of slippers peeks out from under the bed.

>x top drawer
The top drawer is labeled "Jäger". It is closed.

>ask computer about khotpanya
I'm unable to give you any information about khotpanya.

>x bottom drqawer
I only understood you as far as wanting to examine the bottom drawer.

>x bottom drawer
The bottom drawer is labeled "Abimbola". It is closed.

>ask computer about khotpanya
Gunnery Sergeant Somchai Khotpanya is deployed on the SS Usagi. For further information, contact the Enlistment Office on Space Station Omicron-5.

* * *

>f
You enter the ship from the airlock. The inner door closes behind you.

Staging Area
This is the staging area of the ship, where marines prepare for missions. It is adjacent to the aft airlock. It houses a number of vac suits in an open locker, and various munitions in locked compartments set into the walls. A ladder leads up into the rest of the ship. 
Through the airlock windows you can see the gangway to Space Station Omicron-5.

What looks like part of an engine is stowed in a corner.

>i
You are carrying:
  some chewing gum (being chewed)
  a To-Do list
  a repair corps uniform (being worn)
  a toolbox

>u
You climb the la--

***BOOM***

Press any key...

A gigantic force grabs the ship, knocking you off the ladder and sending you flying against an aft bulkhead. The inertial dampers are probably all that saved you from being smashed to jelly rather than just banged up. 

Press any key...

Some time later you find yourself lying on the floor of the staging area with a throbbing headache. Gingerly you push yourself to your knees and stand up. The vac suit locker has detached from its mounting and slammed into the airlock door.

[Thank god I wasn't in the way of that.]

Looking outside --

[Holy -- ]

[Where's the station?].

Where Space Station Omicron-5 was, is now an expanding sphere of rubble, dimly lit by the blue light of far-off Deneb. The rubble is clearly receding behind the ship. [We're moving!]

[How am I going to get off this ship?]

Press any key...

Staging Area
This is the staging area of the ship, where marines prepare for missions. It is adjacent to the aft airlock. Locked compartments set into the walls hold various munitions. A ladder leads up into the rest of the ship. 

An equipment locker is sprawled across the room, with its door to the ground.
 
Through the airlock windows you see the blank space left by the destruction of Space Station Omicron-5.

What looks like part of an engine is stowed in a corner.

A vac suit is here, lying prone as if it were some malformed yellow person knocked unconscious by the shaking of the ship. It has chewing gum stuck to it.

[What now?]

[I think I spit out my gum.]

Crash
An Interactive Disaster by Phil Riley
Release 6 / Serial number 220730 / Inform 7 build 6M62 (I6/v6.34 lib 6/12N) SD

>wear suit
(first taking the vac suit)
You put on the vac suit.

>u
Junction
This is a busy place when the ship is populated. To port and starboard are the crew quarters, aft is the closed door to the captain's private quarters, and fore is the galley. A ladder leads down to the staging area.

⇒ You can enter "hints" at any time for help in progressing in the game.

* * *

>p
Port-Side Crew Quarters
All crew members who aren't the captain sleep in this or the opposite-side bunk room. This one sleeps two in a bunk bed, done up with military precision. There is a large cabinet here, stretching almost to the ceiling. It is closed. Mounted in the wall is a crew personal storage unit. The sole exit is to starboard.

>open cabinet
You open the port-side equipment cabinet, revealing an engineering uniform and an Universal Game Emulator.

>wear uniform
(the repair corps uniform)
You can't put a uniform on over a vac suit. Try the other way around

* * *

>f
You enter the ship from the airlock. The inner door closes behind you.

Staging Area
This is the staging area of the ship, where marines prepare for missions. It is adjacent to the aft airlock. It houses a number of vac suits in an open locker, and various munitions in locked compartments set into the walls. A ladder leads up into the rest of the ship. 
Through the airlock windows you can see the gangway to Space Station Omicron-5.

What looks like part of an engine is stowed in a corner.

>u
You climb the la--

***BOOM***

Press any key...

A gigantic force grabs the ship, knocking you off the ladder and sending you flying against an aft bulkhead. The inertial dampers are probably all that saved you from being smashed to jelly rather than just banged up. 

Press any key...

Some time later you find yourself lying on the floor of the staging area with a throbbing headache. Gingerly you push yourself to your knees and stand up. The vac suit locker has detached from its mounting and slammed into the airlock door.

[Thank god I wasn't in the way of that.]

Looking outside --

[Holy -- ]

[Where's the station?].

Where Space Station Omicron-5 was, is now an expanding sphere of rubble, dimly lit by the blue light of far-off Deneb. The rubble is clearly receding behind the ship. [We're moving!]

[How am I going to get off this ship?]

Press any key...

Staging Area
This is the staging area of the ship, where marines prepare for missions. It is adjacent to the aft airlock. Locked compartments set into the walls hold various munitions. A ladder leads up into the rest of the ship. 

An equipment locker is sprawled across the room, with its door to the ground.
 
Through the airlock windows you see the blank space left by the destruction of Space Station Omicron-5.

What looks like part of an engine is stowed in a corner.

A vac suit is here, lying prone as if it were some malformed yellow person knocked unconscious by the shaking of the ship. It has chewing gum stuck to it.

[What now?]

[I think I spit out my gum.]

Crash
An Interactive Disaster by Phil Riley
Release 6 / Serial number 220729 / Inform 7 build 6M62 (I6/v6.34 lib 6/12N) SD

>l
Staging Area
This is the staging area of the ship, where marines prepare for missions. It is adjacent to the aft airlock. Locked compartments set into the walls hold various munitions. A ladder leads up into the rest of the ship. 

An equipment locker is sprawled across the room, with its door to the ground.
 
Through the airlock windows you see the blank space left by the destruction of Space Station Omicron-5.

What looks like part of an engine is stowed in a corner.

A vac suit is here, lying prone as if it were some malformed yellow person knocked unconscious by the shaking of the ship. It has chewing gum stuck to it.

* * *

>take dum
You can't see any such thing.

>take gum
You unstick the chewing gum from the vac suit.

The chewing gum has become stuck to the toolbox.

>chew gum
You can't chew the gum when it's stuck to the toolbox.

>wear suit
(first taking the vac suit)
You put on the vac suit.

>a
You try to enter the airlock, but the automatic door fails to open for you.
[It's always just opened in the past.]

You add an item ("fix the airlock door") to your to-do list.

>u
Junction
This is a busy place when the ship is populated. To port and starboard are the crew quarters, aft is the closed door to the captain's private quarters, and fore is the galley. A ladder leads down to the staging area.

⇒ You can enter "hints" at any time for help in progressing in the game.

>s
Starboard-Side Crew Quarters
All crew members who aren't the captain sleep in this or the opposite-side bunk room. This one sleeps two in a bunk bed, done up with military precision. There is a large cabinet here, stretching almost to the ceiling. It is closed. Mounted in the wall is a crew personal storage unit. The sole exit is to port.

In a shocking lapse of military precision, there is a sticky note attached to the bed post.

A pair of slippers peeks out from under the bed.

>look under bed
You find a black trunk and move it out from under the bottom bunk.

Starboard-Side Crew Quarters
All crew members who aren't the captain sleep in this or the opposite-side bunk room. This one sleeps two in a bunk bed, done up with military precision. There is a large cabinet here, stretching almost to the ceiling. It is closed. Mounted in the wall is a crew personal storage unit. The sole exit is to port.

In a shocking lapse of military precision, there is a sticky note attached to the bed post.

A pair of slippers peeks out from under the bed.

You can also see a black trunk (closed) here.

>open trunk
You open the black trunk, revealing a present.

>open present
[I'll go to hell for this, but here goes...]

You rip off the wrapping paper and open the box. Inside is a stuffed bear you recognize as Bertie the Bear™. You discard the paper and box.

>x bear
Bertie the Bear™ is a massively popular toy. It accepts voice commands, and its eyes, actually advanced optical sensors, can differentiate between individuals. This bear's blindly staring eyes are unnerving.

>x eye
You can't see any such thing.

>x eyes
They're well disguised, but the eyes are clearly top-of-the-line optical sensors that you might see in more serious uses, such as in facial recognition devices.

>take eyes
[Am I really going to do this? Yes, yes, I am, apparently.]

You grasp one of the eyes and give it a tug, first softly then harder. Eventually it gives and you extract the eye from the bear. Upon examination you discover that the eye is in fact an optical sensor in camouflage. It looks like you didn't pull it carefully enough, however, because the connector at the end has been damaged.

You try again more carefully with the second eye, and manage to produce an undamaged optical sensor.

>take trunk
Taken.

>p
Junction
This is a busy place when the ship is populated. To port and starboard are the crew quarters, aft is the closed door to the captain's private quarters, and fore is the galley. A ladder leads down to the staging area.

>d
Staging Area
This is the staging area of the ship, where marines prepare for missions. It is adjacent to the aft airlock. Locked compartments set into the walls hold various munitions. A ladder leads up into the rest of the ship. 

An equipment locker is sprawled across the room, with its door to the ground.
 
Through the airlock windows you see the blank space left by the destruction of Space Station Omicron-5.

What looks like part of an engine is stowed in a corner.

>drop trunk
Dropped.

>stand on trunk
(first closing the black trunk)
You get onto the black trunk.

>x airlock door
The airlock door is an imposing solid barrier between vacuum and safety. It is colored yellow with red warning symbols on it. Above the door is a panel of electronic components.

>x components
The prominent features of the panel are two optical sensors. One of them has become partially detached and looks broken.

>x sensor
(the new optical sensor)
The optical sensor is a small component with a two-pronged connecter on the back and a blue metallic circle on the other.

>take broken sensor
You remove the broken sensor from the panel.

>put optical sensor in components
You insert the fresh sensor into the empty socket.
[There. That should do it.]

You cross out an item ("fix the airlock door") on your to-do list.

[Your score has just gone up by one point.]

>a
(first getting off the black trunk)

Aft Airlock
You are in the aft airlock. Outside is the blackness of space, speckled with the dying embers of what was once Space Station Omicron-5. Forward leads into the ship.

>a
It's dangerous out there. I recommend saving the game first...
⇒ Use "save" to save the game, or go "out" again to continue without saving.

>turn on boots
You switch the Magnetic boots on.

>a
Outside the Aft Airlock (vacuum)
You are standing on the hull of the ship, outside the aft airlock, secured by your vac suit's mag boots. Most of the hull is taken up by the protrusions of various machinery, antennae, radio dishes, and heat sinks. There is a clear path to fore among the obstructions. You can also go in to the airlock.

A hook protrudes from the hull next to the airlock door.

Your vac suit pings gently to indicate you have expended a unit of air.

>f
Hull of the Usagi (vacuum)
Here the path runs aft to the aft airlock and starboard to the engineering airlock. Your path to starboard is blocked by a piece of debris lodged in the hull. [Whatever happened, this was part of it. It's fortunate it didn't penetrate further into the hull.] It's going to be tough to get over; it doesn't look magnetic, so your mag boots won't stick to it. You'll need to be careful.

There is a hook set in the hull here.

It looks like you could break off a small piece of debris.

Your vac suit pings gently to indicate you have expended a unit of air.

>s
You attempt to climb over the debris. Just when you think you're over, your foot catches, and you lose your hold. The result: you're floating about a foot from the hull, unable to make contact with your mag boots to pull yourself down. You're barely moving relative to the hull, but you're stuck here. The bright side? You broke down the debris enough that it's no longer a barrier.

[Okay, stay calm. Don't freak out.]

Hull of the Usagi (vacuum, floating)
Here the path runs aft to the aft airlock and starboard to the engineering airlock. Where there used to be a large embedded chunk of debris blocking the path, now there is a scattering of rubble.

There is a hook set in the hull here.

Your vac suit pings gently to indicate you have expended a unit of air.

>x suit
A puffy yellow suit with an attached helmet and magnetic boots. The gloves are misshapen things, optimized for carrying weaponry, not precision work. There is a nozzle on the front through which air can be recharged or vented. Lights indicate the boots are currently on. A gauge indicates the suit has 12 units of air left.
[I always wanted one of these.]

⇒ You can vent air by using "vent suit"

Your vac suit pings gently to indicate you have expended a unit of air.

>vent air
You vent a bit of air from your suit. It propels you just a tiny amount toward the hull, but it's enough. One agonizing minute later, you're attached to the hull again.

[Oh thank god! I thought I was a goner.]

Hull of the Usagi (vacuum)
Here the path runs aft to the aft airlock and starboard to the engineering airlock. Where there used to be a large embedded chunk of debris blocking the path, now there is a scattering of rubble.

There is a hook set in the hull here.

Your vac suit pings gently to indicate you have expended a unit of air.

>s
Outside the Engineering Airlock (vacuum)
You are standing on the hull of the ship, outside the engineering airlock, secured by your vac suit's mag boots. Most of the hull is taken up by the protrusions of various machinery, antennae, radio dishes, and heat sinks. There is a clear path to port among the obstructions. You can also go in to the airlock.

A hook protrudes from the hull next to the airlock door.

Your vac suit pings gently to indicate you have expended a unit of air.

>in
Engineering Airlock
You are in the engineering airlock. Outside, the space to starboard looks so empty and peaceful it's hard to imagine the awful sight astern.

⇒ astern: behind or toward the rear of a ship, spaceship or aircraft.

>in
Engineering Deck
The engineering crew is responsible for keeping the physical ship operating. They are in charge of every physical aspect of the ship, from the engines to hull integrity to the life support system.

The engineering deck consists of a large console giving a comprehensive view of the physical status of the ship. There is an airlock to starboard. The operations deck continues forward from here, and there are other exits to aft and port.

A device labeled "Suit Recharging Station" is here. It is shaped like a chair with nozzles protruding from either arm.

>sit in station
The nozzles on either side of the chair connect with the suit. After a few moments, the machine emits a pleasant "ping", the nozzles retract, and you stand up.

You hear someone speaking forward of here.

>ask computer about reboot
Rebooting the ship's computer during a mission is a risky operation that should only be attempted when absolutely necessary. It can be accomplished the ship computer given the necessary authorization. Due to the risk of short-term shutdown of critical systems during a reboot, vac suits should always be worn during the operation.

>f
Operations Deck
This is where all of the support activity for the bridge occurs. There are large consoles for environmental controls (which include gravity, temperature, and pressure), communications, and power systems here. The bridge continues forward from here, and engineering is aft. There is a door set in the floor with a ladder leading through it. Set in the frame of the door is a blue button.

A large equipment trunk lies on the midship door, blocking it.

A man's voice comes over comms: "Usagi, are you there?"

[Finally, another person! I'm saved!]

⇒ By the way... you can get help about speaking to other characters by typing "help speech".

>hello
(addressing the caller)
You call out "Yes! I'm here! I'm here! What's going on?"

The caller responds, "Ahoy there, SS Usagi, good to hear from you. Seems like you're a bit out of sorts, and we'd like to help you out. But before we get into that, who am I speaking to? Tell me about yourself."

>move trunk
You push the trunk clear of the door.

>d
(first opening Midship Door)
You can't open that with your bare hands.

"Come in Usagi!"

>a
Engineering Deck
The engineering crew is responsible for keeping the physical ship operating. They are in charge of every physical aspect of the ship, from the engines to hull integrity to the life support system.

The engineering deck consists of a large console giving a comprehensive view of the physical status of the ship. There is an airlock to starboard. The operations deck continues forward from here, and there are other exits to aft and port.

A device labeled "Suit Recharging Station" is here. It is shaped like a chair with nozzles protruding from either arm.

>p
Machine Room
The machine room is where the physical work of Engineering takes place; for instance, machining new parts. There is a large counter lined with drawers here, as well as numerous saws, drills, and other pieces of equipment. You can leave to starboard.

There's a hand vac sitting on the counter.

>s
Engineering Deck
The engineering crew is responsible for keeping the physical ship operating. They are in charge of every physical aspect of the ship, from the engines to hull integrity to the life support system.

The engineering deck consists of a large console giving a comprehensive view of the physical status of the ship. There is an airlock to starboard. The operations deck continues forward from here, and there are other exits to aft and port.

A device labeled "Suit Recharging Station" is here. It is shaped like a chair with nozzles protruding from either arm.

>f
Operations Deck
This is where all of the support activity for the bridge occurs. There are large consoles for environmental controls (which include gravity, temperature, and pressure), communications, and power systems here. The bridge continues forward from here, and engineering is aft. There is a door set in the floor with a ladder leading through it. Set in the frame of the door is a blue button.

You can see an equipment trunk (closed) here.

"You still there?"

>press button
The door slides open.

>d
Galley
This narrow space is barely enough room for two Marines to prepare and eat a meal. There is a counter with a drawer, and two stools, a microwave oven, and a large closet here. Pots and pans hang from hooks in the ceiling. A ladder leads up through the midship door, and you can leave aft.

On the starboard wall is a panel on which is a blue button. Tacked to the panel is the operator's manual for the midship door.

You hear someone speaking above.

>a
Junction
This is a busy place when the ship is populated. To port and starboard are the crew quarters, aft is the closed door to the captain's private quarters, and fore is the galley. A ladder leads down to the staging area.

>p
Port-Side Crew Quarters
All crew members who aren't the captain sleep in this or the opposite-side bunk room. This one sleeps two in a bunk bed, done up with military precision. There is a large cabinet here, stretching almost to the ceiling. It is closed. Mounted in the wall is a crew personal storage unit. The sole exit is to starboard.

>open unit
That can only be opened by typing the correct code on the keypad.

>type 9467 on keypad
As you press a key, the storage unit starts buzzing continuously. The display lights up with random characters, and you smell the distinct odor of burning wires. The bottom storage drawer pops out a centimeter or two.

You add an item ("fix the storage unit") to your to-do list.

>purloin key
Which do you mean, Access key or the small key?

>small
[Purloined.]

>unlock unit with key
You may be trying to unlock the keypad, which has a keyhole in it. Or you may be trying to unlock a drawer, which can only be done by typing the correct code on the keypad.

>unlock keypad with key
You open the front panel of the keypad, revealing a bundle of wiring. You can see the problem immediately -- two wires with worn insulation are in contact, causing a short-circuit.

>purloin tape
[Purloined.]

>tape wires
You wrap the wires in electrical tape and close the keypad.

You cross out an item ("fix the storage unit") on your to-do list.

[Your score has just gone up by one point.]

>type 9467 on keypad
The display flashes "Close Drawer".

>type 9467 on keypad
The display flashes "Close Drawer".

* * *

>take suit
Taken.

>wear it
You put on the vac suit.

>take gum
You can't reach the gum with the vac suit on top of your uniform.

>restart
Are you sure you want to restart?

>y
Crash
An Interactive Disaster by Phil Riley
Release 5 / Serial number 220727 / Inform 7 build 6M62 (I6/v6.34 lib 6/12N) SD

Space Station Gangway
This is the pressurized bridge from Space Station Omicron-5 to the SS Usagi. Behind you is the familiar bulk of the huge station, largest outpost of the Space Authority in Deneb Sector. Before you is the aft airlock of the Usagi, beckoning you in.

[Better get a move on], you think.

* * *

>put gum in hole
You push the gum into the hole.
[I hope this works.]

>undo
Junction
[Previous turn undone.]

>take gum
You can't reach the gum with the vac suit on top of your uniform.

>x me
Not much to see other than the vac suit.

>x uniform
The repair corps uniform is a smart hunter green color, with a patch featuring a hammer and a wrench, crossed. It would look impressive if it weren't for the chewing gum stuck to it.

>x me
Not much to see other than the vac suit.

>i
You are carrying:
  a blown fuse
  a knife
  a hex-shaped tool
  a roll of electrical tape
  a small key
  a portable hand-held vacuum cleaner
  a broken sensor
  Bertie the Bear™
  some pair of slippers
  a vac suit (being worn)
  a To-Do list
  a repair corps uniform (being worn) with chewing gum stuck to it
  a toolbox

>rules
Rules tracing now switched on. Type "rules off" to switch it off again, or "rules all" to include even rules which do not apply.

[Rule "reset report text rule" applies.]

>x uniform
[Rule "After reading a command" applies.]
[Rule "After deciding the scope of the player when the current stuck thing of the chewing gum is not the player" applies.]
[Rule "computer is everywhere rule" applies.]
[Rule "declare everything initially unmentioned rule" applies.]
[Rule "announce items from multiple object lists rule" applies.]
[Rule "set pronouns from items from multiple object lists rule" applies.]
[Rule "before stage rule" applies.]
[Rule "Before" applies.]
[Rule "can't act in the dark rule" applies.]
[Rule "new instead stage rule" applies.]
[Rule "Instead of examining the repair corps uniform" applies.]
The repair corps uniform is a smart hunter green color, with a patch featuring a hammer and a wrench, crossed. It would look impressive if it weren't for the chewing gum stuck to it.

[Rule "pre-report rule" applies.]
[Rule "post-report rule" applies.]
[Rule "A first turn sequence rule" applies.]
[Rule "post-report rule" applies.]
[Rule "every turn stage rule" applies.]
[Rule "Every turn when talking about asking mulgrew questions and computer-rebooting is false and protocols-in-progress is false" applies.]
[Rule "reset protocol rule" applies.]
[Rule "Every turn" applies.]
[Rule "close open doors rule" applies.]
[Rule "A last turn sequence rule" applies.]
[Rule "notify score changes rule" applies.]
[Rule "reset report text rule" applies.]

* * *

>u
Junction
This is a busy place when the ship is populated. To port and starboard are the crew quarters, aft is the closed door to the captain's private quarters, and fore is the galley. A ladder leads down to the staging area.

⇒ You can enter "hints" at any time for help in progressing in the game.

>d
Staging Area
This is the staging area of the ship, where marines prepare for missions. It is adjacent to the aft airlock. Locked compartments set into the walls hold various munitions. A ladder leads up into the rest of the ship. 

An equipment locker is sprawled across the room, with its door to the ground.
 
Through the airlock windows you see the blank space left by the destruction of Space Station Omicron-5.

What looks like part of an engine is stowed in a corner.

A vac suit is here, lying prone as if it were some malformed yellow person knocked unconscious by the shaking of the ship.

>purloin tether
[Purloined.]

>set gravity to 1
You got it. Physics has been changed at your whim.

>push engine a
You try to enter the airlock, but the automatic door fails to open for you.
[It's always just opened in the past.]

You add an item ("fix the airlock door") to your to-do list.

>purloin chest
[Purloined.]

>drop it
Dropped.

>stand on it
You get onto the black trunk.

>purloin optical sensor
Which do you mean, the new optical sensor or the eyes?

>eyes
[Can't move eyes: it's part of Bertie the Bear™.]

* * *

>purloin optical sensor
Which do you mean, the new optical sensor or the eyes?

>new
[Purloined.]

>take broken sensor
You remove the broken sensor from the panel.

>put new sensor in panel
You insert the fresh sensor into the empty socket.
[There. That should do it.]

You cross out an item ("fix the airlock door") on your to-do list.

[Your score has just gone up by one point.]

>push engine a
(first getting off the black trunk)
You push the JL-758 to Aft Airlock.

Aft Airlock
You are in the aft airlock. Outside is the blackness of space, speckled with the dying embers of what was once Space Station Omicron-5. Forward leads into the ship.

You can see a JL-758 here.

>push engine a
I wouldn't do that. The JL-758 is likely to float away and you won't be able to stop it.

>a
Not without a vac suit, you aren't.

>f
Staging Area
This is the staging area of the ship, where marines prepare for missions. It is adjacent to the aft airlock. Locked compartments set into the walls hold various munitions. A ladder leads up into the rest of the ship. 

An equipment locker is sprawled across the room, with its door to the ground.
 
Through the airlock windows you see the blank space left by the destruction of Space Station Omicron-5.

A vac suit is here, lying prone as if it were some malformed yellow person knocked unconscious by the shaking of the ship.

You can also see a black trunk (closed) here.

>wear vac suit
(first taking the vac suit)
You put on the vac suit.

>a
Aft Airlock
You are in the aft airlock. Outside is the blackness of space, speckled with the dying embers of what was once Space Station Omicron-5. Forward leads into the ship.

You can see a JL-758 here.

>a
It's dangerous out there. I recommend saving the game first...
⇒ Use "save" to save the game, or go "out" again to continue without saving.

>a
You take a step on the hull of the ship, and keep going, and going... Should have turned those mag boots on.
[Oops.]

    *** You float forever in the vastness of space ***

In that game you scored 1 out of a possible 10, in 19 turns.

Your death was completely pointless and preventable. All the same we grudgingly award you one point each for what you did accomplish, which was:
- fixing the aft airlock door

Would you like to RESTART, RESTORE a saved game, QUIT, or UNDO the last command?

>undo
Aft Airlock
[Previous turn undone.]

>turn on boots
You switch the Magnetic boots on.

>out
Outside the Aft Airlock (vacuum)
You are standing on the hull of the ship, outside the aft airlock, secured by your vac suit's mag boots. Most of the hull is taken up by the protrusions of various machinery, antennae, radio dishes, and heat sinks. There is a clear path to fore among the obstructions. You can also go in to the airlock.

A hook protrudes from the hull next to the airlock door.

Your vac suit pings gently to indicate you have expended a unit of air.

>tie tether to hook
You attach the tether to the hook.
[One...]

Your vac suit pings gently to indicate you have expended a unit of air.

>in
There's no reason to bring the tether inside. You leave it behind.

Aft Airlock
You are in the aft airlock. Outside is the blackness of space, speckled with the dying embers of what was once Space Station Omicron-5. Forward leads into the ship.

You can see a JL-758 here.

>out
Outside the Aft Airlock (vacuum)
You are standing on the hull of the ship, outside the aft airlock, secured by your vac suit's mag boots. Most of the hull is taken up by the protrusions of various machinery, antennae, radio dishes, and heat sinks. There is a clear path to fore among the obstructions. You can also go in to the airlock.

A hook protrudes from the hull next to the airlock door.

The tether is attached to the hook. The other end floats in a loose coil nearby.

Your vac suit pings gently to indicate you have expended a unit of air.

>take tether
Taken.

Your vac suit pings gently to indicate you have expended a unit of air.

>f
Hull of the Usagi (vacuum)
Here the path runs aft to the aft airlock and starboard to the engineering airlock. Your path to starboard is blocked by a piece of debris lodged in the hull. [Whatever happened, this was part of it. It's fortunate it didn't penetrate further into the hull.] It's going to be tough to get over; it doesn't look magnetic, so your mag boots won't stick to it. You'll need to be careful.

There is a hook set in the hull here.

It looks like you could break off a small piece of debris.

You are holding one end of the tether, which runs aft from here.

Your vac suit pings gently to indicate you have expended a unit of air.

>tie tether to hook
You attach the tether to the hook.
[Two...]

Your vac suit pings gently to indicate you have expended a unit of air.

>l
Hull of the Usagi (vacuum)
Here the path runs aft to the aft airlock and starboard to the engineering airlock. Your path to starboard is blocked by a piece of debris lodged in the hull.  It's going to be tough to get over; it doesn't look magnetic, so your mag boots won't stick to it. You'll need to be careful.

There is a hook set in the hull here.

It looks like you could break off a small piece of debris.

You are holding one end of the tether, which is attached to the hook here, and then runs aft.

Your vac suit pings gently to indicate you have expended a unit of air.

>f
The obvious exits are aft (to outside the aft airlock (vacuum)), starboard and outside.

Your vac suit pings gently to indicate you have expended a unit of air.

>s
You attempt to climb over the debris. Just when you think you're over, your foot catches, and you lose your hold. The result: you're floating about a foot from the hull, unable to make contact with your mag boots to pull yourself down. You're barely moving relative to the hull, but you're stuck here. The bright side? You broke down the debris enough that it's no longer a barrier.

[Okay, stay calm. Don't freak out.]

Hull of the Usagi (vacuum, floating)
Here the path runs aft to the aft airlock and starboard to the engineering airlock. Where there used to be a large embedded chunk of debris blocking the path, now there is a scattering of rubble.

There is a hook set in the hull here.

You are holding one end of the tether, which is attached to the hook here, and then runs aft.

Your vac suit pings gently to indicate you have expended a unit of air.

>vent air
You vent a bit of air from your suit. It propels you just a tiny amount toward the hull, but it's enough. One agonizing minute later, you're attached to the hull again.

[Oh thank god! I thought I was a goner.]

Hull of the Usagi (vacuum)
Here the path runs aft to the aft airlock and starboard to the engineering airlock. Where there used to be a large embedded chunk of debris blocking the path, now there is a scattering of rubble.

There is a hook set in the hull here.

You are holding one end of the tether, which is attached to the hook here, and then runs aft.

A stern voice in your helmet intones "Air levels critical. Seek a pressurized location immediately."

>recharge
I'm not sure what you're trying to say. I might just not recognize the words you're using.

>refill
Your vac suit pings gently to indicate you have expended a unit of air.

>attach tether to hook
The tether is already attached to the hook.

Your vac suit pings gently to indicate you have expended a unit of air.

>s
Outside the Engineering Airlock (vacuum)
You are standing on the hull of the ship, outside the engineering airlock, secured by your vac suit's mag boots. Most of the hull is taken up by the protrusions of various machinery, antennae, radio dishes, and heat sinks. There is a clear path to port among the obstructions. You can also go in to the airlock.

A hook protrudes from the hull next to the airlock door.

You're holding one end of the tether, which runs to port from here.

Your vac suit pings gently to indicate you have expended a unit of air.

>attach tether to hook
You make the final attachment, letting go of the tether.
[Three! That was a bit of work. Hope it's useful.]

Your vac suit pings gently to indicate you have expended a unit of air.

>p
Hull of the Usagi (vacuum)
Here the path runs aft to the aft airlock and starboard to the engineering airlock. Where there used to be a large embedded chunk of debris blocking the path, now there is a scattering of rubble.

There is a hook set in the hull here.

The tether is attached to the hook, and extends aft and starboard from here.

Your vac suit pings gently to indicate you have expended a unit of air.

>a
Outside the Aft Airlock (vacuum)
You are standing on the hull of the ship, outside the aft airlock, secured by your vac suit's mag boots. Most of the hull is taken up by the protrusions of various machinery, antennae, radio dishes, and heat sinks. There is a clear path to fore among the obstructions. You can also go in to the airlock.

A hook protrudes from the hull next to the airlock door.

The tether is attached to the hook, and from there runs forward.

Your vac suit pings gently to indicate you have expended a unit of air.

>in
Aft Airlock
You are in the aft airlock. Outside is the blackness of space, speckled with the dying embers of what was once Space Station Omicron-5. Forward leads into the ship.

You can see a JL-758 here.

>put jl-758 out
You can't see any such thing.

>push jl-758 out
(the JL-758 outside)
You clip the JL-758 to the tether.

You push the JL-758 to Outside the Aft Airlock (vacuum).

Outside the Aft Airlock (vacuum)
You are standing on the hull of the ship, outside the aft airlock, secured by your vac suit's mag boots. Most of the hull is taken up by the protrusions of various machinery, antennae, radio dishes, and heat sinks. There is a clear path to fore among the obstructions. You can also go in to the airlock.

A hook protrudes from the hull next to the airlock door.

The JL-758 is floating here, clipped to the tether.

The tether is attached to the hook, and from there runs forward.

Your vac suit pings gently to indicate you have expended a unit of air.

>undo
Aft Airlock
[Previous turn undone.]

>undo
Aft Airlock
[Previous turn undone.]

>undo
Outside the Aft Airlock (vacuum)
[Previous turn undone.]

>i
You are carrying:
  a vac suit (being worn)
  a broken sensor
  a To-Do list
  a repair corps uniform (being worn) with chewing gum stuck to it
  a toolbox

Your vac suit pings gently to indicate you have expended a unit of air.

>undo
Outside the Aft Airlock (vacuum)
[Previous turn undone.]

>undo
Hull of the Usagi (vacuum)
[Previous turn undone.]

>i
You are carrying:
  a vac suit (being worn)
  a broken sensor
  a To-Do list
  a repair corps uniform (being worn) with chewing gum stuck to it
  a toolbox

Your vac suit pings gently to indicate you have expended a unit of air.

>l
Hull of the Usagi (vacuum)
Here the path runs aft to the aft airlock and starboard to the engineering airlock. Where there used to be a large embedded chunk of debris blocking the path, now there is a scattering of rubble.

There is a hook set in the hull here.

The tether is attached to the hook, and extends aft and starboard from here.

Your vac suit pings gently to indicate you have expended a unit of air.

>undo
Hull of the Usagi (vacuum)
[Previous turn undone.]

>undo
Hull of the Usagi (vacuum)
[Previous turn undone.]

>undo
Outside the Engineering Airlock (vacuum)
[Previous turn undone.]

>l
Outside the Engineering Airlock (vacuum)
You are standing on the hull of the ship, outside the engineering airlock, secured by your vac suit's mag boots. Most of the hull is taken up by the protrusions of various machinery, antennae, radio dishes, and heat sinks. There is a clear path to port among the obstructions. You can also go in to the airlock.

A hook protrudes from the hull next to the airlock door.

The tether is attached to the hook, and from there runs to port.

Your vac suit pings gently to indicate you have expended a unit of air.

>undo
Outside the Engineering Airlock (vacuum)
[Previous turn undone.]

>undo
Outside the Engineering Airlock (vacuum)
[Previous turn undone.]

>l
Outside the Engineering Airlock (vacuum)
You are standing on the hull of the ship, outside the engineering airlock, secured by your vac suit's mag boots. Most of the hull is taken up by the protrusions of various machinery, antennae, radio dishes, and heat sinks. There is a clear path to port among the obstructions. You can also go in to the airlock.

A hook protrudes from the hull next to the airlock door.

You're holding one end of the tether, which runs to port from here.

Your vac suit pings gently to indicate you have expended a unit of air.

>out
The mag boots keep you firmly attached to the hull.

Your vac suit pings gently to indicate you have expended a unit of air.

>turn off boots
You switch the Magnetic boots off.

Your vac suit pings gently to indicate you have expended a unit of air.

>out
You propel yourself away from the ship, realizing too late you have no way to get back. You drift through the blackness of space until your air runs out and you suffocate.

    *** You have died ***

In that game you scored 1 out of a possible 10, in 37 turns.

Your death was completely pointless and preventable. All the same we grudgingly award you one point each for what you did accomplish, which was:
- fixing the aft airlock door

Would you like to RESTART, RESTORE a saved game, QUIT, or UNDO the last command?

>undo
Outside the Engineering Airlock (vacuum)
[Previous turn undone.]

* * *

>u
Junction
This is a busy place when the ship is populated. To port and starboard are the crew quarters, aft is the closed door to the captain's private quarters, and fore is the galley. A ladder leads down to the staging area.

⇒ You can enter "hints" at any time for help in progressing in the game.

>f
Galley
This narrow space is barely enough room for two Marines to prepare and eat a meal. There is a counter with a drawer, and two stools, a microwave oven, and a large closet here. Pots and pans hang from hooks in the ceiling. A ladder leads up through the midship door, and you can leave aft.

On the starboard wall is a panel on which is a blue button. Tacked to the panel is the operator's manual for the midship door.

You faintly hear someone speaking above.

>open drawer
You open the kitchen drawer, revealing a knife, a fork, and a spoon.

>take knife
Taken.

You faintly hear someone speaking above.

>a
Junction
This is a busy place when the ship is populated. To port and starboard are the crew quarters, aft is the closed door to the captain's private quarters, and fore is the galley. A ladder leads down to the staging area.

* * *

>p
Port-Side Crew Quarters
All crew members who aren't the captain sleep in this or the opposite-side bunk room. This one sleeps two in a bunk bed, done up with military precision. There is a large cabinet here, stretching almost to the ceiling. It is closed. Mounted in the wall is a crew personal storage unit. The sole exit is to starboard.

>type 234
As you press a key, the storage unit starts buzzing continuously. The display lights up with random characters, and you smell the distinct odor of burning wires. The bottom storage drawer pops out a centimeter or two.

You add an item ("fix the storage unit") to your to-do list.

>pry bottom drawer
What do you want to pry the bottom drawer with?

>knife
You wedge the knife into the seam and lever the drawer open, revealing the red access card.

>close drawer
Which do you mean, the top drawer or the bottom drawer?

>bottom
You close the bottom drawer.

>s
Junction
This is a busy place when the ship is populated. To port and starboard are the crew quarters, aft is the closed door to the captain's private quarters, and fore is the galley. A ladder leads down to the staging area.

* * *

>s
Starboard-Side Crew Quarters
All crew members who aren't the captain sleep in this or the opposite-side bunk room. This one sleeps two in a bunk bed, done up with military precision. There is a large cabinet here, stretching almost to the ceiling. It is closed. Mounted in the wall is a crew personal storage unit. The sole exit is to port.

In a shocking lapse of military precision, there is a sticky note attached to the bed post.

A pair of slippers peeks out from under the bed.

>type 9467
The storage unit buzzes and the display lights up "ERROR".

>p
Junction
This is a busy place when the ship is populated. To port and starboard are the crew quarters, aft is the closed door to the captain's private quarters, and fore is the galley. A ladder leads down to the staging area.

>p
Port-Side Crew Quarters
All crew members who aren't the captain sleep in this or the opposite-side bunk room. This one sleeps two in a bunk bed, done up with military precision. There is a large cabinet here, stretching almost to the ceiling. It is closed. Mounted in the wall is a crew personal storage unit. The sole exit is to starboard.

>x unit
The storage unit consists of top and bottom drawers, with an attached keypad and display. There is a keyhole under the keypad. Both drawers are closed.

>type 8979 on keypad
The storage unit seems to be broken.

* * *

>p
Port-Side Crew Quarters
All crew members who aren't the captain sleep in this or the opposite-side bunk room. This one sleeps two in a bunk bed, done up with military precision. There is a large cabinet here, stretching almost to the ceiling. It is closed. Mounted in the wall is a crew personal storage unit. The sole exit is to starboard.

>s
Junction
This is a busy place when the ship is populated. To port and starboard are the crew quarters, aft is the closed door to the captain's private quarters, and fore is the galley. A ladder leads down to the staging area.

* * *

>s
Starboard-Side Crew Quarters
All crew members who aren't the captain sleep in this or the opposite-side bunk room. This one sleeps two in a bunk bed, done up with military precision. There is a large cabinet here, stretching almost to the ceiling. It is closed. Mounted in the wall is a crew personal storage unit. The sole exit is to port.

In a shocking lapse of military precision, there is a sticky note attached to the bed post.

A pair of slippers peeks out from under the bed.

>get on bottom bunk
You get onto the bottom bunk.

>get on top bunk
(getting off the bottom bunk)
You get onto the top bunk.

>x door
You can see the problem from up here: the top hinge of the cabinet door has a crooked screw, probably from the door being slammed too many times. You'll have to replace it.

>take screw
Taken.

>l
Starboard-Side Crew Quarters (in the bunk bed)
All crew members who aren't the captain sleep in this or the opposite-side bunk room. This one sleeps two in a bunk bed, done up with military precision. There is a large cabinet here, stretching almost to the ceiling. It is closed. Mounted in the wall is a crew personal storage unit. The sole exit is to port.

In a shocking lapse of military precision, there is a sticky note attached to the bed post.

A pair of slippers peeks out from under the bed.

>x door
You can see the problem from up here: the top hinge of the cabinet door has a crooked screw, probably from the door being slammed too many times. You'll have to replace it.

* * *

>p
Port-Side Crew Quarters
All crew members who aren't the captain sleep in this or the opposite-side bunk room. This one sleeps two in a bunk bed, done up with military precision. There is a large cabinet here, stretching almost to the ceiling. It is closed. Mounted in the wall is a crew personal storage unit. The sole exit is to starboard.

>type
What do you want to type on?

>keypad
As you press a key, the storage unit starts buzzing continuously. The display lights up with random characters, and you smell the distinct odor of burning wires. The bottom storage drawer pops out a centimeter or two.

You add an item ("fix the storage unit") to your to-do list.

>x unit
The storage unit consists of top and bottom drawers, with an attached keypad and display. There is a keyhole under the keypad. The top drawer is closed; the bottom drawer juts out by a couple of centimeters.

>x keyhole
A pretty typical heyhole, maybe smaller than most.

* * *

>p
Port-Side Crew Quarters
All crew members who aren't the captain sleep in this or the opposite-side bunk room. This one sleeps two in a bunk bed, done up with military precision. There is a large cabinet here, stretching almost to the ceiling. It is closed. Mounted in the wall is a crew personal storage unit. The sole exit is to starboard.

>type 95465
As you press a key, the storage unit starts buzzing continuously. The display lights up with random characters, and you smell the distinct odor of burning wires. The bottom storage drawer pops out a centimeter or two.

You add an item ("fix the storage unit") to your to-do list.

>purloin small key
[Purloined.]

>unlock drawer
Which do you mean, the top drawer or the bottom drawer?

>top
What do you want to unlock the top drawer with?

>key
You may be trying to unlock the keypad, which has a keyhole in it.

* * *

>p
Port-Side Crew Quarters
All crew members who aren't the captain sleep in this or the opposite-side bunk room. This one sleeps two in a bunk bed, done up with military precision. There is a large cabinet here, stretching almost to the ceiling. It is closed. Mounted in the wall is a crew personal storage unit. The sole exit is to starboard.

>type on keypad
As you press a key, the storage unit starts buzzing continuously. The display lights up with random characters, and you smell the distinct odor of burning wires. The bottom storage drawer pops out a centimeter or two.

You add an item ("fix the storage unit") to your to-do list.

>unlock unit
What do you want to unlock the crew personal storage unit with?

>toolbox
That doesn't seem to be something you can unlock.

* * *

>s
Starboard-Side Crew Quarters
All crew members who aren't the captain sleep in this or the opposite-side bunk room. This one sleeps two in a bunk bed, done up with military precision. There is a large cabinet here, stretching almost to the ceiling. It is closed. Mounted in the wall is a crew personal storage unit. The sole exit is to port.

In a shocking lapse of military precision, there is a sticky note attached to the bed post.

A pair of slippers peeks out from under the bed.

>get on bed
You get onto the top bunk.

>unscrew screw
You unscrew the old screw and replace it with a new one.

You cross out an item ("fix the cabinet") on your to-do list.

[Your score has just gone up by one point.]

>take screw
You can't see any such thing.

>take screwdriver
That seems to be a part of the toolbox.

* * *

>get on bed
You get onto the top bunk.

>x cabinet
You can see the problem from up here: the top hinge of the cabinet door has a crooked screw, probably from the door being slammed too many times. You'll have to replace it.

>fix it
You unscrew the old screw and replace it with a new one.

You cross out an item ("fix the cabinet") on your to-do list.

[Your score has just gone up by one point.]

>undo
Starboard-Side Crew Quarters
[Previous turn undone.]

>fix screw
You can't see any such thing.

* * *

>s
Starboard-Side Crew Quarters
All crew members who aren't the captain sleep in this or the opposite-side bunk room. This one sleeps two in a bunk bed, done up with military precision. There is a large cabinet here, stretching almost to the ceiling. It is closed. Mounted in the wall is a crew personal storage unit. The sole exit is to port.

In a shocking lapse of military precision, there is a sticky note attached to the bed post.

A pair of slippers peeks out from under the bed.

>get on bunk
You get onto the top bunk.

>take screw
You unscrew the old screw and replace it with a new one.

You cross out an item ("fix the cabinet") on your to-do list.

[Your score has just gone up by one point.]

>unscrew screw
You can't see any such thing.

>restart
Are you sure you want to restart?

>y
Crash
An Interactive Disaster by Phil Riley
Release 5 / Serial number 220726 / Inform 7 build 6M62 (I6/v6.34 lib 6/12N) SD

Space Station Gangway
This is the pressurized bridge from Space Station Omicron-5 to the SS Usagi. Behind you is the familiar bulk of the huge station, largest outpost of the Space Authority in Deneb Sector. Before you is the aft airlock of the Usagi, beckoning you in.

[Better get a move on], you think.

>f
You pass into the aft airlock, the outer door closing behind you.

The Second Law of Thermodynamics, in one formulation, states that disorganization always increases in the absence of some outside force. A corollary is that things will always break down in the absence of someone to fix them. As a member of the repair corps of Space Station Omicron-5, you're that someone.

Your last assignment of the day, on the SS Usagi, a Space Marines fighting ship, looks routine enough. Fix the microwave and a jammed locker door, and then you're off for the day.

Aft Airlock
You are in the aft airlock. Outside is the gangway back to Space Station Omicron-5. Forward leads into the ship.

A pleasant androgynous voice says, "Welcome to the SS Usagi. This is the shipboard computer. Please feel free to call upon me for any information you may need. Use the command 'computer, help' for more information."

* * *

>f
You enter the ship from the airlock. The inner door closes behind you.

Staging Area
This is the staging area of the ship, where marines prepare for missions. It is adjacent to the aft airlock. It houses a number of vac suits in an open locker, and various munitions in locked compartments set into the walls. A ladder leads up into the rest of the ship. 
Through the airlock windows you can see the gangway to Space Station Omicron-5.

What looks like part of an engine is stowed in a corner.

>u
You climb the la--

***BOOM***

Press any key...

A gigantic force grabs the ship, knocking you off the ladder and sending you flying against an aft bulkhead. The inertial dampers are probably all that saved you from being smashed to jelly rather than just banged up. 

Press any key...

Some time later you find yourself lying on the floor of the staging area with a throbbing headache. Gingerly you push yourself to your knees and stand up. The vac suit locker has detached from its mounting and slammed into the airlock door.

[Thank god I wasn't in the way of that.]

Looking outside --

[Holy -- ]

[Where's the station?].

Where Space Station Omicron-5 was, is now an expanding sphere of rubble, dimly lit by the blue light of far-off Deneb. The rubble is clearly receding behind the ship. [We're moving!]

[How am I going to get off this ship?]

Press any key...

Staging Area
This is the staging area of the ship, where marines prepare for missions. It is adjacent to the aft airlock. Locked compartments set into the walls hold various munitions. A ladder leads up into the rest of the ship. 

An equipment locker is sprawled across the room, with its door to the ground.
 
Through the airlock windows you see the blank space left by the destruction of Space Station Omicron-5.

What looks like part of an engine is stowed in a corner.

A vac suit is here, lying prone as if it were some malformed yellow person knocked unconscious by the shaking of the ship.

[What now?]

[I think I spit out my gum.]

Crash
An Interactive Disaster by Phil Riley
Release 5 / Serial number 220726 / Inform 7 build 6M62 (I6/v6.34 lib 6/12N) SD

>u
Junction
This is a busy place when the ship is populated. To port and starboard are the crew quarters, aft is the closed door to the captain's private quarters, and fore is the galley. A ladder leads down to the staging area.

⇒ You can enter "hints" at any time for help in progressing in the game.

* * *

>s
Starboard-Side Crew Quarters
All crew members who aren't the captain sleep in this or the opposite-side bunk room. This one sleeps two in a bunk bed, done up with military precision. There is a large cabinet here, stretching almost to the ceiling. It is closed. Mounted in the wall is a crew personal storage unit. The sole exit is to port.

In a shocking lapse of military precision, there is a sticky note attached to the bed post.

A pair of slippers peeks out from under the bed.

>s
The only obvious exit is port (to junction).

>get on bed
You get onto the top bunk.

>unscrew
What do you want to unscrew?

>unscrew screw
The crooked screw cannot be unscrewed.

* * *

>get on bunk
You get onto the top bunk.

>x door
You can see the problem from up here: the top hinge of the cabinet door has a crooked screw, probably from the door being slammed too many times. You'll have to replace it.

>x screw
The screw is bent beyond repair.

>take screw
That seems to be a part of the cabinet door.

* * *

>open present
[I'll go to hell for this, but here goes...]

You rip off the wrapping paper and open the box. Inside is a stuffed bear you recognize as Bertie the Bear™. You discard the paper and box.

>x sensor
They're well disguised, but these are clearly top-of-the-line optical sensors that you might see in more serious uses, such as in facial recognition devices.

>take sensor
[Am I really going to do this? Yes, yes, I am, apparently.]

You grasp one of the eyes and give it a tug, first softly then harder. Eventually it gives and you extract the eye from the bear. Upon examination you discover that the eye is in fact an optical sensor in camouflage. It looks like you didn't pull it carefully enough, however, because the connector at the end has been damaged.

You try again more carefully with the second eye, and manage to produce an undamaged optical sensor.

>undeo
I'm not sure what you're trying to say. I might just not recognize the words you're using.

>undeo
I'm not sure what you're trying to say. I might just not recognize the words you're using.

>undo
Starboard-Side Crew Quarters
[Previous turn undone.]

>remove sensor from bear
But it isn't there now.

>x bear
Bertie the Bear™ is a massively popular toy. It accepts voice commands, and its eyes, actually advanced optical sensors, can differentiate between individuals. This bear seems to be missing his eyes.

>undo
Starboard-Side Crew Quarters
[Previous turn undone.]

>undo
Starboard-Side Crew Quarters
[Previous turn undone.]

>x bear
Bertie the Bear™ is a massively popular toy. It accepts voice commands, and its eyes, actually advanced optical sensors, can differentiate between individuals. This bear seems to be missing his eyes.

>undo bear
I'm not sure what you're trying to say. I might just not recognize the words you're using.

>undo
Starboard-Side Crew Quarters
[Previous turn undone.]

>x bear
Bertie the Bear™ is a massively popular toy. It accepts voice commands, and its eyes, actually advanced optical sensors, can differentiate between individuals. This bear's blindly staring eyes are unnerving.

>remove sensor from bear
[Am I really going to do this? Yes, yes, I am, apparently.]

You grasp one of the eyes and give it a tug, first softly then harder. Eventually it gives and you extract the eye from the bear. Upon examination you discover that the eye is in fact an optical sensor in camouflage. It looks like you didn't pull it carefully enough, however, because the connector at the end has been damaged.

You try again more carefully with the second eye, and manage to produce an undamaged optical sensor.

* * *

>s
Starboard-Side Crew Quarters
All crew members who aren't the captain sleep in this or the opposite-side bunk room. This one sleeps two in a bunk bed, done up with military precision. There is a large cabinet here, stretching almost to the ceiling. It is closed. Mounted in the wall is a crew personal storage unit. The sole exit is to port.

In a shocking lapse of military precision, there is a sticky note attached to the bed post.

A pair of slippers peeks out from under the bed.

>look under ned
You can't see any such thing.

>look under bed
You find a black trunk and move it out from under the bottom bunk.

Starboard-Side Crew Quarters
All crew members who aren't the captain sleep in this or the opposite-side bunk room. This one sleeps two in a bunk bed, done up with military precision. There is a large cabinet here, stretching almost to the ceiling. It is closed. Mounted in the wall is a crew personal storage unit. The sole exit is to port.

In a shocking lapse of military precision, there is a sticky note attached to the bed post.

A pair of slippers peeks out from under the bed.

You can also see a black trunk (closed) here.

* * *

>open present
[I'll go to hell for this, but here goes...]

You rip off the wrapping paper and open the box. Inside is a stuffed bear you recognize as Bertie the Bear™. You discard the paper and box.

>take eyes
[Am I really going to do this? Yes, yes, I am, apparently.]

You grasp one of the eyes and give it a tug, first softly then harder. Eventually it gives and you extract the eye from the bear. Upon examination you discover that the eye is in fact an optical sensor in camouflage. It looks like you didn't pull it carefully enough, however, because the connector at the end has been damaged.

You try again more carefully with the second eye, and manage to produce an undamaged optical sensor.

>x bear
Bertie the Bear™ is a massively popular toy. It accepts voice commands, and its eyes, actually advanced optical sensors, can differentiate between individuals. This bear seems to be missing his eyes.

* * *

>s
Starboard-Side Crew Quarters
All crew members who aren't the captain sleep in this or the opposite-side bunk room. This one sleeps two in a bunk bed, done up with military precision. There is a large cabinet here, stretching almost to the ceiling. It is closed. Mounted in the wall is a crew personal storage unit. The sole exit is to port.

In a shocking lapse of military precision, there is a sticky note attached to the bed post.

A pair of slippers peeks out from under the bed.

>x slippers
These seem comfy.

>take them
As you lean to take the slippers, you notice something under the bed.

* * *

>wear suit
(first taking the vac suit)
You put on the vac suit.

>take gum
You unstick the chewing gum from the repair corps uniform.

>undo
Staging Area
[Previous turn undone.]

>rules
Rules tracing now switched on. Type "rules off" to switch it off again, or "rules all" to include even rules which do not apply.

[Rule "reset report text rule" applies.]

>take gum
[Rule "After reading a command" applies.]
[Rule "After deciding the scope of the player when the current stuck thing of the chewing gum is not the player" applies.]
[Rule "computer is everywhere rule" applies.]
[Rule "declare everything initially unmentioned rule" applies.]
[Rule "announce items from multiple object lists rule" applies.]
[Rule "set pronouns from items from multiple object lists rule" applies.]
[Rule "before stage rule" applies.]
[Rule "Before" applies.]
[Rule "reaching inside the room of stuff rule" applies.]
[Rule "new instead stage rule" applies.]
[Rule "Instead of taking chewing gum when the chewing gum is stuck to something and the gum is not currently chewed" applies.]
You unstick the chewing gum from the repair corps uniform.

[Rule "pre-report rule" applies.]
[Rule "post-report rule" applies.]
[Rule "A first turn sequence rule" applies.]
[Rule "post-report rule" applies.]
[Rule "every turn stage rule" applies.]
[Rule "Every turn when ( not talking about asking mulgrew questions ) and computer-rebooting is false and protocols-in-progress is false and last-moves is false" applies.]
[Rule "For asking for attention by Arvax while current conversation state is making contact" applies.]
[Rule "reset protocol rule" applies.]
[Rule "Every turn" applies.]
[Rule "close open doors rule" applies.]
[Rule "A last turn sequence rule" applies.]
[Rule "notify score changes rule" applies.]
[Rule "reset report text rule" applies.]

* * *

>wear suit
(first taking the vac suit)
You put on the vac suit.

>vent it
I didn't understand that sentence.

>vent suit
You let a unit of air out of the suit.

* * *

>wear suit
(first taking the vac suit)
You put on the vac suit.

>x gum
You know it's on the repair corps uniform, but you can't see it with the vac suit over it.

>remove suit
You take off the vac suit.

>x gum
It's a used wad of pink chewing gum. It used to taste like grape, but now it tastes of nothing. It's stuck to the repair corps uniform.

It's a used wad of pink chewing gum. It used to taste like grape, but now it tastes of nothing.

* * *

>wear suit
(first taking the vac suit)
You put on the vac suit.

>x uniform
You can't see the uniform when you're wearing the vac suit on top of it.

>x gum
It's a used wad of pink chewing gum. It used to taste like grape, but now it tastes of nothing. It's stuck to the repair corps uniform.

>take it
You can't reach the gum with the vac suit on top of your uniform.

>i
You are carrying:
  a vac suit (being worn)
  a To-Do list
  a repair corps uniform (being worn) with chewing gum stuck to it
  a toolbox

* * *

>wear vac suit
(first taking the vac suit)
You put on the vac suit.

>take off uniform
You can't remove the uniform until you remove the vac suit on top of it.

>take off suit
You take off the vac suit.

>take off uniform
You take off the repair corps uniform.

>wear suit
You put on the vac suit.

>wear uniform
You can't put a uniform on over a vac suit. Try the other way around
You put on the repair corps uniform.

* * *

>knock on door
You can't see any such thing.

>f
You enter the ship from the airlock. The inner door closes behind you.

Staging Area
This is the staging area of the ship, where marines prepare for missions. It is adjacent to the aft airlock. It houses a number of vac suits in an open locker, and various munitions in locked compartments set into the walls. A ladder leads up into the rest of the ship. 
Through the airlock windows you can see the gangway to Space Station Omicron-5.

What looks like part of an engine is stowed in a corner.

>knock on door
There's no point in knocking on that.

>u
You climb the la--

***BOOM***

Press any key...

A gigantic force grabs the ship, knocking you off the ladder and sending you flying against an aft bulkhead. The inertial dampers are probably all that saved you from being smashed to jelly rather than just banged up. 

Press any key...

Some time later you find yourself lying on the floor of the staging area with a throbbing headache. Gingerly you push yourself to your knees and stand up. The vac suit locker has detached from its mounting and slammed into the airlock door.

[Thank god I wasn't in the way of that.]

Looking outside --

[Holy -- ]

[Where's the station?].

Where Space Station Omicron-5 was, is now an expanding sphere of rubble, dimly lit by the blue light of far-off Deneb. The rubble is clearly receding behind the ship. [We're moving!]

[How am I going to get off this ship?]

Press any key...

Staging Area
This is the staging area of the ship, where marines prepare for missions. It is adjacent to the aft airlock. Locked compartments set into the walls hold various munitions. A ladder leads up into the rest of the ship. 

An equipment locker is sprawled across the room, with its door to the ground.
 
Through the airlock windows you see the blank space left by the destruction of Space Station Omicron-5.

What looks like part of an engine is stowed in a corner.

A vac suit is here, lying prone as if it were some malformed yellow person knocked unconscious by the shaking of the ship.

[What now?]

[I think I spit out my gum.]

Crash
An Interactive Disaster by Phil Riley
Release 5 / Serial number 220726 / Inform 7 build 6M62 (I6/v6.34 lib 6/12N) SD

* * *

>u
Junction
This is a busy place when the ship is populated. To port and starboard are the crew quarters, aft is the closed door to the captain's private quarters, and fore is the galley. A ladder leads down to the staging area.

⇒ You can enter "hints" at any time for help in progressing in the game.

>knock on door
You wait a second but no one answers. No one's home, I guess.

>d
Staging Area
This is the staging area of the ship, where marines prepare for missions. It is adjacent to the aft airlock. Locked compartments set into the walls hold various munitions. A ladder leads up into the rest of the ship. 

An equipment locker is sprawled across the room, with its door to the ground.
 
Through the airlock windows you see the blank space left by the destruction of Space Station Omicron-5.

What looks like part of an engine is stowed in a corner.

A vac suit is here, lying prone as if it were some malformed yellow person knocked unconscious by the shaking of the ship.

>knock on door
There's no point in knocking on that.

>a
You try to enter the airlock, but the automatic door fails to open for you.
[It's always just opened in the past.]

You add an item ("fix the airlock door") to your to-do list.

>knock on door
There's no point in knocking on that.

>a
You try to enter the airlock, but the automatic door fails to open for you.
[It's always just opened in the past.]

>gonear aft airlock
Staging Area
This is the staging area of the ship, where marines prepare for missions. It is adjacent to the aft airlock. Locked compartments set into the walls hold various munitions. A ladder leads up into the rest of the ship. 

An equipment locker is sprawled across the room, with its door to the ground.
 
Through the airlock windows you see the blank space left by the destruction of Space Station Omicron-5.

What looks like part of an engine is stowed in a corner.

A vac suit is here, lying prone as if it were some malformed yellow person knocked unconscious by the shaking of the ship.

>showme door
(the Airlock door)
Airlock door - thing
location: in the Staging Area
singular-named, improper-named; unlit, inedible, fixed in place, scenery, seen, familiar, screwed
list grouping key: none
printed name: "Airlock door"
printed plural name: none
indefinite article: none
description: "The airlock door is an imposing solid barrier between vacuum and safety. It is colored yellow with red warning symbols on it. Above the door is a panel of electronic components."
initial appearance: none
last utterance: none
readable text: none
voice locale: yourself

* * *

Crash
An Interactive Disaster by Phil Riley
Release 6 / Serial number 220730 / Inform 7 build 6M62 (I6/v6.34 lib 6/12N) SD

Space Station Gangway
This is the pressurized bridge from Space Station Omicron-5 to the SS Usagi. Behind you is the familiar bulk of the huge station, largest outpost of the Space Authority in Deneb Sector. Before you is the aft airlock of the Usagi, beckoning you in.

[Better get a move on], you think.

>gonear aperture
The Second Law of Thermodynamics, in one formulation, states that disorganization always increases in the absence of some outside force. A corollary is that things will always break down in the absence of someone to fix them. As a member of the repair corps of Space Station Omicron-5, you're that someone.

Your last assignment of the day, on the SS Usagi, a Space Marines fighting ship, looks routine enough. Fix the microwave and a jammed locker door, and then you're off for the day.

Bridge
This is where the captain, navigator, and pilot all sit. Large viewscreens give a full view of the space around the ship. To port you can see the huge blue-white disk of Deneb. Astern you can faintly see the fading embers of what was Space Station Omicron-5.

 The pilot's and navigator's chairs sit before their respective consoles. The captain's chair, with command console, sits halfway between them and operations further aft.

>purloin hex
[Purloined.]

>put hex in aperture
You unlock the pilot's access panel.

>undo
Bridge
[Previous turn undone.]

>put tool in panel
Which do you mean, the hex-shaped tool or the toolbox?

>hex
(the pilot's access panel)
That can't contain things.

* * *

Crash
An Interactive Disaster by Phil Riley
Release 6 / Serial number 220730 / Inform 7 build 6M62 (I6/v6.34 lib 6/12N) SD

Space Station Gangway
This is the pressurized bridge from Space Station Omicron-5 to the SS Usagi. Behind you is the familiar bulk of the huge station, largest outpost of the Space Authority in Deneb Sector. Before you is the aft airlock of the Usagi, beckoning you in.

[Better get a move on], you think.

>gonear bertie
The Second Law of Thermodynamics, in one formulation, states that disorganization always increases in the absence of some outside force. A corollary is that things will always break down in the absence of someone to fix them. As a member of the repair corps of Space Station Omicron-5, you're that someone.

Your last assignment of the day, on the SS Usagi, a Space Marines fighting ship, looks routine enough. Fix the microwave and a jammed locker door, and then you're off for the day.

Room of Stuff
dummy description

A vac suit is here, lying prone as if it were some malformed yellow person knocked unconscious by the shaking of the ship.

You can also see Input 4, Input 3, Input 2, Input 1, Tachyon Crystals, Anti-Helium, Liquid Copernicium, Red Matter, Unobtainium, Oganesson, Void Matter, Empty-space, a brochure, a broken sensor, Typing it on, Captain's Affair, a blue screw, a cooked dinner, subj-rebooting-computer, gravity, Engine status, Irion, Pollux VI, Pollux III, Hull Integrity, Life support, Milky Way, Cygnus, Pluto, Neptune, Uranus, Tethys, Saturn, Europa, Jupiter, Mars, Venus, Mercury, a moon, Earth, a Sun, Access key, New Da Nang, a Deneb separatists, Location of the ship, Pollux star, a Space Force, Space Authority, Deneb III planet, Orion Marine Academy, Delphi Engine Controls LLC, Substance Injection, Element Copernicium, Luna Spacewerks Parsec VI, Delphi Engine Controls Aleph-Null, Operation Dalmatian, a Space Marines, Deneb sector, Deneb II, Deneb IV, Deneb System, a helm, security code, mulgrew's-code, Emergency protocols, Identity of the player, a Pilot, a Navigator, an EVA transport line, a cardboard box (empty), some wrapping paper, Bertie the Bear™, a new optical sensor, a black trunk (closed), a null card, Vacuum-suit, Captain Jane Mulgrew, Fuel injection specification, and a shipboard computer floating here.

"I said to return to your post, Ensign Seventh Class!" bellows Blather, turning a deepening shade of crimson.

>tkaee bertie
I'm not sure what you're trying to say. I might just not recognize the words you're using.

>take bertie
Taken.

"I said to return to your post, Ensign Seventh Class!" bellows Blather, turning a deepening shade of crimson.

>remove eyes
[Am I really going to do this? Yes, yes, I am, apparently.]

You grasp one of the eyes and give it a tug, first softly then harder. Eventually it gives and you extract the eye from the bear. Upon examination you discover that the eye is in fact an optical sensor in camouflage. It looks like you didn't pull it carefully enough, however, because the connector at the end has been damaged.

You try again more carefully with the second eye, and manage to produce an undamaged optical sensor.

"I said to return to your post, Ensign Seventh Class!" bellows Blather, turning a deepening shade of crimson.

>restart
Are you sure you want to restart?

>y
Crash
An Interactive Disaster by Phil Riley
Release 6 / Serial number 220729 / Inform 7 build 6M62 (I6/v6.34 lib 6/12N) SD

Space Station Gangway
This is the pressurized bridge from Space Station Omicron-5 to the SS Usagi. Behind you is the familiar bulk of the huge station, largest outpost of the Space Authority in Deneb Sector. Before you is the aft airlock of the Usagi, beckoning you in.

[Better get a move on], you think.

* * *

Crash
An Interactive Disaster by Phil Riley
Release 6 / Serial number 220730 / Inform 7 build 6M62 (I6/v6.34 lib 6/12N) SD

Space Station Gangway
This is the pressurized bridge from Space Station Omicron-5 to the SS Usagi. Behind you is the familiar bulk of the huge station, largest outpost of the Space Authority in Deneb Sector. Before you is the aft airlock of the Usagi, beckoning you in.

[Better get a move on], you think.

>gonear closet
The Second Law of Thermodynamics, in one formulation, states that disorganization always increases in the absence of some outside force. A corollary is that things will always break down in the absence of someone to fix them. As a member of the repair corps of Space Station Omicron-5, you're that someone.

Your last assignment of the day, on the SS Usagi, a Space Marines fighting ship, looks routine enough. Fix the microwave and a jammed locker door, and then you're off for the day.

Galley
This narrow space is barely enough room for two Marines to prepare and eat a meal. There is a counter with a drawer, and two stools, a microwave oven, and a large closet here. Pots and pans hang from hooks in the ceiling. A ladder leads up through the midship door, and you can leave aft.

On the starboard wall is a panel on which is a blue button. Tacked to the panel is the operator's manual for the midship door.

>open the folding door
You open the closet, revealing ten MREs and a microwavable dinner.

* * *

Crash
An Interactive Disaster by Phil Riley
Release 6 / Serial number 220730 / Inform 7 build 6M62 (I6/v6.34 lib 6/12N) SD

Space Station Gangway
This is the pressurized bridge from Space Station Omicron-5 to the SS Usagi. Behind you is the familiar bulk of the huge station, largest outpost of the Space Authority in Deneb Sector. Before you is the aft airlock of the Usagi, beckoning you in.

[Better get a move on], you think.

>gonear command console
The Second Law of Thermodynamics, in one formulation, states that disorganization always increases in the absence of some outside force. A corollary is that things will always break down in the absence of someone to fix them. As a member of the repair corps of Space Station Omicron-5, you're that someone.

Your last assignment of the day, on the SS Usagi, a Space Marines fighting ship, looks routine enough. Fix the microwave and a jammed locker door, and then you're off for the day.

Bridge
This is where the captain, navigator, and pilot all sit. Large viewscreens give a full view of the space around the ship. To port you can see the huge blue-white disk of Deneb. Astern you can faintly see the fading embers of what was Space Station Omicron-5.

 The pilot's and navigator's chairs sit before their respective consoles. The captain's chair, with command console, sits halfway between them and operations further aft.

>computer, execute
Please present hand print to command console in order to activate command mode.

>touch command console
Unauthorized access attempted. This event has been logged by security.

You hear someone speaking aft of here.

>a
Operations Deck
This is where all of the support activity for the bridge occurs. There are large consoles for environmental controls, communications, and power systems here. The bridge continues forward from here, and engineering is aft. There is a door set in the floor with a ladder leading through it. Set in the frame of the door is a blue button.

A large equipment trunk lies on the midship door, blocking it.

>z
Time passes.

A man's voice comes over comms: "If there's anyone on the Usagi, please respond!"

[Finally, another person! I'm saved!]

⇒ By the way... you can get help about speaking to other characters by typing "help speech".

⇒ You might try saying hello.

* * *

Crash
An Interactive Disaster by Phil Riley
Release 6 / Serial number 220730 / Inform 7 build 6M62 (I6/v6.34 lib 6/12N) SD

Space Station Gangway
This is the pressurized bridge from Space Station Omicron-5 to the SS Usagi. Behind you is the familiar bulk of the huge station, largest outpost of the Space Authority in Deneb Sector. Before you is the aft airlock of the Usagi, beckoning you in.

[Better get a move on], you think.

>gonear communications
The Second Law of Thermodynamics, in one formulation, states that disorganization always increases in the absence of some outside force. A corollary is that things will always break down in the absence of someone to fix them. As a member of the repair corps of Space Station Omicron-5, you're that someone.

Your last assignment of the day, on the SS Usagi, a Space Marines fighting ship, looks routine enough. Fix the microwave and a jammed locker door, and then you're off for the day.

Operations Deck
This is where all of the support activity for the bridge occurs. There are large consoles for environmental controls (which include gravity, temperature, and pressure), communications, and power systems here. The bridge continues forward from here, and engineering is aft. There is a door set in the floor with a ladder leading through it. Set in the frame of the door is a blue button.

A large equipment trunk lies on the midship door, blocking it.

>ask arvax about engine
You can't see any such thing.

>hello
(addressing the caller)
You call out "Yes! I'm here! I'm here! What's going on?"

The caller responds, "Ahoy there, SS Usagi, good to hear from you. Seems like you're a bit out of sorts, and we'd like to help you out. But before we get into that, who am I speaking to? Tell me about yourself."

>ask arvax about engine
"I'm afraid I don't have anything to say about that."

>tell caller about me
You tell the caller that you're from the repair corps.

"Alright then, Sergeant Screwdriver, I'll fill you in. Space Station Omicron-5 was bombed by separatists from Deneb IV. By some miracle the Usagi was spared the worst of the blast; you were thrown clear of the station. Only problem is now you're hurtling towards New Da Nang, a heavily-populated moon of Deneb II. An impact there would kill not only you but potentially thousands of people more.

 "So we've got some work to do. I'm Master Sergeant R. Mu Arvax. I'm going to try and help you get this ship under control again. First we have to establish, though, what the ship is currently doing. Normally, I'd be able to tap into the ship diagnostics and controls from here on Deneb III, but something seems to have gone wrong. So I'm going to need your help. Are you up to the task?"

[Sergeant Screwdriver, guy thinks he's funny.]

* * *

>hello
(addressing the caller)
You call out "Yes! I'm here! I'm here! What's going on?"

The caller responds, "Ahoy there, SS Usagi, good to hear from you. Seems like you're a bit out of sorts, and we'd like to help you out. But before we get into that, who am I speaking to? Tell me about yourself."

>hello, asdf
You are already talking to the caller.

I'm not sure what you're trying to say. I might just not recognize the words you're using.

>actions
Actions listing on.

>hello, asdf
[hailing]
You are already talking to the caller.
[hailing - failed the check what's being hailed rule]

"If you're there, just tell me a little bit about yourself."

I'm not sure what you're trying to say. I might just not recognize the words you're using.

>a, a
[going aft]

Engineering Deck
The engineering crew is responsible for keeping the physical ship operating. They are in charge of every physical aspect of the ship, from the engines to hull integrity to the life support system.

The engineering deck consists of a large console giving a comprehensive view of the physical status of the ship. There is an airlock to starboard. The operations deck continues forward from here, and there are other exits to aft and port.

A device labeled "Suit Recharging Station" is here. It is shaped like a chair with nozzles protruding from either arm.

[going aft - succeeded]

[going aft]

Engine Room
This where the combustion process is controlled. The aft wall is dominated by the operating panel of the fusion engine. Monitoring electronics and controls cover the other two walls. A doorway opens forward to the Engineering Deck.

There is a large screen on the forward wall. It displays nothing right now. There is a large button below the diagram labeled "Test".

[going aft - succeeded]

>f
[going fore]

Engineering Deck
The engineering crew is responsible for keeping the physical ship operating. They are in charge of every physical aspect of the ship, from the engines to hull integrity to the life support system.

The engineering deck consists of a large console giving a comprehensive view of the physical status of the ship. There is an airlock to starboard. The operations deck continues forward from here, and there are other exits to aft and port.

A device labeled "Suit Recharging Station" is here. It is shaped like a chair with nozzles protruding from either arm.

[going fore - succeeded]

>a, fooo, a
[going aft]

Engine Room
This where the combustion process is controlled. The aft wall is dominated by the operating panel of the fusion engine. Monitoring electronics and controls cover the other two walls. A doorway opens forward to the Engineering Deck.

There is a large screen on the forward wall. It displays nothing right now. There is a large button below the diagram labeled "Test".

[going aft - succeeded]

You seem to want to talk to someone, but I can't see whom.

>asdfasdf, as
You seem to want to talk to someone, but I can't see whom.

>f, f
[going fore]

Engineering Deck
The engineering crew is responsible for keeping the physical ship operating. They are in charge of every physical aspect of the ship, from the engines to hull integrity to the life support system.

The engineering deck consists of a large console giving a comprehensive view of the physical status of the ship. There is an airlock to starboard. The operations deck continues forward from here, and there are other exits to aft and port.

A device labeled "Suit Recharging Station" is here. It is shaped like a chair with nozzles protruding from either arm.

[going fore - succeeded]

[going fore]

Operations Deck
This is where all of the support activity for the bridge occurs. There are large consoles for environmental controls (which include gravity, temperature, and pressure), communications, and power systems here. The bridge continues forward from here, and engineering is aft. There is a door set in the floor with a ladder leading through it. Set in the frame of the door is a blue button.

A large equipment trunk lies on the midship door, blocking it.

[going fore - succeeded]

"If you're there, just tell me a little bit about yourself."
⇒ the caller is waiting for you to tell him something about yourself.

* * *

Crash
An Interactive Disaster by Phil Riley
Release 6 / Serial number 220730 / Inform 7 build 6M62 (I6/v6.34 lib 6/12N) SD

Space Station Gangway
This is the pressurized bridge from Space Station Omicron-5 to the SS Usagi. Behind you is the familiar bulk of the huge station, largest outpost of the Space Authority in Deneb Sector. Before you is the aft airlock of the Usagi, beckoning you in.

[Better get a move on], you think.

>gonear engineering deck
The Second Law of Thermodynamics, in one formulation, states that disorganization always increases in the absence of some outside force. A corollary is that things will always break down in the absence of someone to fix them. As a member of the repair corps of Space Station Omicron-5, you're that someone.

Your last assignment of the day, on the SS Usagi, a Space Marines fighting ship, looks routine enough. Fix the microwave and a jammed locker door, and then you're off for the day.

Engineering Deck
The engineering crew is responsible for keeping the physical ship operating. They are in charge of every physical aspect of the ship, from the engines to hull integrity to the life support system.

The engineering deck consists of a large console giving a comprehensive view of the physical status of the ship. There is an airlock to starboard. The operations deck continues forward from here, and there are other exits to aft and port.

You hear someone speaking to fore.

A device labeled "Suit Recharging Station" is here. It is shaped like a chair with nozzles protruding from either arm.

>listen
You can hear someone talking forward from here, but it's unclear if they're male or female. They're talking in short bursts with pauses between them, and no one seems to be answering.

>gonear galley
Galley
This narrow space is barely enough room for two Marines to prepare and eat a meal. There is a counter with a drawer, and two stools, a microwave oven, and a large closet here. Pots and pans hang from hooks in the ceiling. A ladder leads up through the midship door, and you can leave aft.

On the starboard wall is a panel on which is a blue button. Tacked to the panel is the operator's manual for the midship door.

You faintly hear someone speaking above.

You faintly hear someone speaking above.

* * *

Crash
An Interactive Disaster by Phil Riley
Release 6 / Serial number 220730 / Inform 7 build 6M62 (I6/v6.34 lib 6/12N) SD

Space Station Gangway
This is the pressurized bridge from Space Station Omicron-5 to the SS Usagi. Behind you is the familiar bulk of the huge station, largest outpost of the Space Authority in Deneb Sector. Before you is the aft airlock of the Usagi, beckoning you in.

[Better get a move on], you think.

>gonear galley
The Second Law of Thermodynamics, in one formulation, states that disorganization always increases in the absence of some outside force. A corollary is that things will always break down in the absence of someone to fix them. As a member of the repair corps of Space Station Omicron-5, you're that someone.

Your last assignment of the day, on the SS Usagi, a Space Marines fighting ship, looks routine enough. Fix the microwave and a jammed locker door, and then you're off for the day.

Galley
This narrow space is barely enough room for two Marines to prepare and eat a meal. There is a counter with a drawer, and two stools, a microwave oven, and a large closet here. Pots and pans hang from hooks in the ceiling. A ladder leads up through the midship door, and you can leave aft.

On the starboard wall is a panel on which is a blue button. Tacked to the panel is the operator's manual for the midship door.

You faintly hear someone speaking above.

>knock
You must supply a noun.

>knock on door
I only understood you as far as wanting to knock.

* * *

>knock on door
(Midship Door)
Whoever's up there, they didn't hear you apparently.

>f
The obvious exits are aft and up.

You faintly hear someone speaking above.

>knock on door
(Midship Door)
Whoever's up there, they didn't hear you apparently.

>d
The obvious exits are aft and up.

You faintly hear someone speaking above.

>a
Junction
This is a busy place when the ship is populated. To port and starboard are the crew quarters, aft is the closed door to the captain's private quarters, and fore is the galley. A ladder leads down to the staging area.

⇒ You can enter "hints" at any time for help in progressing in the game.

>d
Staging Area
This is the staging area of the ship, where marines prepare for missions. It is adjacent to the aft airlock. It houses a number of vac suits in an open locker, and various munitions in locked compartments set into the walls. A ladder leads up into the rest of the ship. 
Through the airlock windows you can see the gangway to Space Station Omicron-5.

What looks like part of an engine is stowed in a corner.

>u
You climb the la--

***BOOM***

Press any key...

A gigantic force grabs the ship, knocking you off the ladder and sending you flying against an aft bulkhead. The inertial dampers are probably all that saved you from being smashed to jelly rather than just banged up. 

Press any key...

Some time later you find yourself lying on the floor of the staging area with a throbbing headache. Gingerly you push yourself to your knees and stand up. The vac suit locker has detached from its mounting and slammed into the airlock door.

[Thank god I wasn't in the way of that.]

Looking outside --

[Holy -- ]

[Where's the station?].

Where Space Station Omicron-5 was, is now an expanding sphere of rubble, dimly lit by the blue light of far-off Deneb. The rubble is clearly receding behind the ship. [We're moving!]

[How am I going to get off this ship?]

Press any key...

Staging Area
This is the staging area of the ship, where marines prepare for missions. It is adjacent to the aft airlock. Locked compartments set into the walls hold various munitions. A ladder leads up into the rest of the ship. 

An equipment locker is sprawled across the room, with its door to the ground.
 
Through the airlock windows you see the blank space left by the destruction of Space Station Omicron-5.

What looks like part of an engine is stowed in a corner.

A vac suit is here, lying prone as if it were some malformed yellow person knocked unconscious by the shaking of the ship.

[What now?]

[I think I spit out my gum.]

Crash
An Interactive Disaster by Phil Riley
Release 5 / Serial number 220726 / Inform 7 build 6M62 (I6/v6.34 lib 6/12N) SD

>u
Junction
This is a busy place when the ship is populated. To port and starboard are the crew quarters, aft is the closed door to the captain's private quarters, and fore is the galley. A ladder leads down to the staging area.

>knock
What do you want to knock on?

>door
No one's home, I guess.

* * *

>knock on door
(Midship Door)
Whoever's up there, they didn't hear you apparently.

>hit door
(Midship Door)
Violence isn't the answer to this one.

You faintly hear someone speaking above.

>talk to door
(Midship Door)
Midship Door does not respond.

>read door
Which do you mean, Midship Door, the folding door, or the door operations manual?

>manual
Most of the manual is concerned with the technical details of the door, such as installation, maintainance, and repair. There is a small section towards the end detailing its safety features; for example: "To prevent injury, the Portmaster V S-65 will not open when it senses weight pressing upon it from above. In this case, an audible signal and a red warning light will indicate that an obstruction exists."

You faintly hear someone speaking above.

* * *

>knock on door
(Midship Door)
Whoever's up there, they didn't hear you apparently.

>midship
Whoever's up there, they didn't hear you apparently.

* * *

>l
Galley
This narrow space is barely enough room for two Marines to prepare and eat a meal. There is a counter with a drawer, and two stools, a microwave oven, and a large closet here. Pots and pans hang from hooks in the ceiling. A ladder leads up through the midship door, and you can leave aft.

On the starboard wall is a panel on which is a blue button. Tacked to the panel is the operator's manual for the midship door.

You faintly hear someone speaking above.

>z
Time passes.

>z
Time passes.

* * *

>listen
You can hear someone talking above you, but it's unclear if they're male or female. They're talking in short bursts with pauses between them, and no one seems to be answering.

>unplug microwave
(the microwave oven)
You unplug the microwave oven.

You faintly hear someone speaking above.

>x it
The microwave is closed. It's plugged into a socket inset in the countertop. The front display is black. A large button below the display says "Start".

* * *

>open closet
You open the closet, revealing ten MREs and a microwavable dinner.

>take dinner
Taken.

You faintly hear someone speaking above.

>take microwave
(the microwave oven)
That's hardly portable.

>unplug microwave
(the microwave oven)
You unplug the microwave oven.

You faintly hear someone speaking above.

>open microwave
(the microwave oven)
You open the microwave oven.

>put microwave into microwave
(the microwave oven into the microwave oven)
That's not something you can heat in the microwave.

You faintly hear someone speaking above.

>put dinner into microwave
(the microwave oven)
You put the microwavable dinner into the microwave oven.

* * *

>read door
(the door operations manual)
Most of the manual is concerned with the technical details of the door, such as installation, maintainance, and repair. There is a small section towards the end detailing its safety features; for example: "To prevent injury, the Portmaster V S-65 will not open when it senses weight pressing upon it from above. In this case, an audible signal and a red warning light will indicate that an obstruction exists."

>open closet
You open the closet, revealing ten MREs and a microwavable dinner.

You faintly hear someone speaking above.

>take dinner
Taken.

>take microwave
(the microwavable dinner)
You already have that.

You faintly hear someone speaking above.

* * *

>sit on stool
You get onto the stools.

* * *

>unplug microwave
(the microwave oven)
You unplug the microwave oven.

>x socket
It's an ordinary grounded wall socket. Upon close inspection, you notice that it's clogged up with dust.

You faintly hear someone speaking above.

>clean socket
You rub the wall socket.

* * *

>unplug oven
You unplug the microwave oven.

>x socket
It's an ordinary grounded wall socket. Upon close inspection, you notice that it's clogged up with dust.

You faintly hear someone speaking above.

>clean socket
Your fingers won't fit into the socket to reach the dust.

>open drawer
You open the kitchen drawer, revealing a knife, a fork, and a spoon.

You faintly hear someone speaking above.

>take knife
Taken.

>stick knife in socket
I didn't understand that sentence.

>put knife in socket
No.

⇒ Hey kids, never stick anything into an electrical outlet!

You faintly hear someone speaking above.

>dust socket
Your fingers won't fit into the socket to reach the dust.

>listen to door
(Midship Door)
You can hear someone talking above you, but it's unclear if they're male or female. They're talking in short bursts with pauses between them, and no one seems to be answering.

You faintly hear someone speaking above.

>knock
(on Midship Door)
Whoever's up there, they didn't hear you apparently.

* * *

>x microwave
(the microwave oven)
The microwave is closed. It's plugged into a socket inset in the countertop. The front display is black. A large button below the display says "Start".

>unplug it
You unplug the microwave oven.

You faintly hear someone speaking above.

>x microwave
(the microwave oven)
The microwave is closed. Its cord is unplugged. The front display is black. A large button below the display says "Start".

>plug it in
You plug in the microwave oven, but nothing happens.

You faintly hear someone speaking above.

>x microwave
(the microwave oven)
The microwave is closed. It's plugged into a socket inset in the countertop. The front display is black. A large button below the display says "Start".

* * *

>x stool
Which do you mean, the left stool or the right stool?

>left
A tall bar-type stool, bolted to the floor.

* * *

>x stools
You can't use multiple objects with that verb.

>sit on stool
Which do you mean, the left stool or the right stool?

>left
You get onto the left stool.

>x counter
A standard kitchen counter.

You faintly hear someone speaking above.

>x stool
Which do you mean, the left stool or the right stool?

>left
You see nothing special about the left stool.

* * *

>x stools
You can't use multiple objects with that verb.

>x stool
You see nothing special about the stool.

>sit on stool
You get onto the stool.

You faintly hear someone speaking above.

* * *

Crash
An Interactive Disaster by Phil Riley
Release 6 / Serial number 220730 / Inform 7 build 6M62 (I6/v6.34 lib 6/12N) SD

Space Station Gangway
This is the pressurized bridge from Space Station Omicron-5 to the SS Usagi. Behind you is the familiar bulk of the huge station, largest outpost of the Space Authority in Deneb Sector. Before you is the aft airlock of the Usagi, beckoning you in.

[Better get a move on], you think.

>gonear pilot's console
The Second Law of Thermodynamics, in one formulation, states that disorganization always increases in the absence of some outside force. A corollary is that things will always break down in the absence of someone to fix them. As a member of the repair corps of Space Station Omicron-5, you're that someone.

Your last assignment of the day, on the SS Usagi, a Space Marines fighting ship, looks routine enough. Fix the microwave and a jammed locker door, and then you're off for the day.

Bridge
This is where the captain, navigator, and pilot all sit. Large viewscreens give a full view of the space around the ship. To port you can see the huge blue-white disk of Deneb. Astern you can faintly see the fading embers of what was Space Station Omicron-5.

 The pilot's and navigator's chairs sit before their respective consoles. The captain's chair, with command console, sits halfway between them and operations further aft.

>purloin tool
(the toolbox)
[Purloined.]

>purloin hex
[Purloined.]

>i
You are carrying:
  a hex-shaped tool
  a toolbox
  some chewing gum (being chewed)
  a To-Do list
  a repair corps uniform (being worn)

>x pilot's console
The pilot's console is a sloped table covered with cryptic readouts and touch controls. In the back is an access panel which is closed. A hex-shaped aperture is probably the locking mechanism.

You hear someone speaking aft of here.

>open panel
(the pilot's access panel)
It seems to be locked.

>put tool in aperture
Which do you mean, the hex-shaped tool or the toolbox?

>hex
You can't see any such thing.

* * *

Crash
An Interactive Disaster by Phil Riley
Release 6 / Serial number 220730 / Inform 7 build 6M62 (I6/v6.34 lib 6/12N) SD

Space Station Gangway
This is the pressurized bridge from Space Station Omicron-5 to the SS Usagi. Behind you is the familiar bulk of the huge station, largest outpost of the Space Authority in Deneb Sector. Before you is the aft airlock of the Usagi, beckoning you in.

[Better get a move on], you think.

>gonear port-side unit
The Second Law of Thermodynamics, in one formulation, states that disorganization always increases in the absence of some outside force. A corollary is that things will always break down in the absence of someone to fix them. As a member of the repair corps of Space Station Omicron-5, you're that someone.

Your last assignment of the day, on the SS Usagi, a Space Marines fighting ship, looks routine enough. Fix the microwave and a jammed locker door, and then you're off for the day.

Port-Side Crew Quarters
All crew members who aren't the captain sleep in this or the opposite-side bunk room. This one sleeps two in a bunk bed, done up with military precision. There is a large cabinet here, stretching almost to the ceiling. It is closed. Mounted in the wall is a crew personal storage unit. The sole exit is to starboard.

>unlock unit
What do you want to unlock the crew personal storage unit with?

>uniform
You may be trying to unlock the keypad, which has a keyhole in it.

>purloin small key
[Purloined.]

>put key in keyhole
You open the front panel of the keypad, revealing a bundle of wiring.

* * *

Crash
An Interactive Disaster by Phil Riley
Release 6 / Serial number 220730 / Inform 7 build 6M62 (I6/v6.34 lib 6/12N) SD

Space Station Gangway
This is the pressurized bridge from Space Station Omicron-5 to the SS Usagi. Behind you is the familiar bulk of the huge station, largest outpost of the Space Authority in Deneb Sector. Before you is the aft airlock of the Usagi, beckoning you in.

[Better get a move on], you think.

>purloin engine
Which do you mean, the JL-758, Delphi Engine Controls Aleph-Null, Delphi Engine Controls LLC, Engine status, Engine Room, the engine diagram, the fusion engine, the engine room monitors, or the broken JL-758?

* * *

Crash
An Interactive Disaster by Phil Riley
Release 6 / Serial number 220730 / Inform 7 build 6M62 (I6/v6.34 lib 6/12N) SD

Space Station Gangway
This is the pressurized bridge from Space Station Omicron-5 to the SS Usagi. Behind you is the familiar bulk of the huge station, largest outpost of the Space Authority in Deneb Sector. Before you is the aft airlock of the Usagi, beckoning you in.

[Better get a move on], you think.

>purloin journal
Which do you mean, the captain's journal or Captain's Affair?

>captain's
Which do you mean, the captain's journal or Captain's Affair?

>gonear desk
(the desk drawer)

The Second Law of Thermodynamics, in one formulation, states that disorganization always increases in the absence of some outside force. A corollary is that things will always break down in the absence of someone to fix them. As a member of the repair corps of Space Station Omicron-5, you're that someone.

Your last assignment of the day, on the SS Usagi, a Space Marines fighting ship, looks routine enough. Fix the microwave and a jammed locker door, and then you're off for the day.

Captain's Quarters
Neat and spartan, this cabin is the very model of a small fighting ship's captain's quarters. An impeccably organized desk is against one wall, while a typically spotless bed sits beneath a portrait of this very ship. You can exit to fore.

>open desk
(the captain's desk)
You open the desk drawer, revealing the captain's journal.

>take journal
Taken.

>gonear operations deck
Operations Deck
This is where all of the support activity for the bridge occurs. There are large consoles for environmental controls, communications, and power systems here. The bridge continues forward from here, and engineering is aft. There is a door set in the floor with a ladder leading through it. Set in the frame of the door is a blue button.

A large equipment trunk lies on the midship door, blocking it.

>hello
(addressing the caller)
You call out "Yes! I'm here! I'm here! What's going on?"

The caller responds, "Ahoy there, SS Usagi, good to hear from you. Seems like you're a bit out of sorts, and we'd like to help you out. But before we get into that, who am I speaking to? Tell me about yourself."

>tell him about me
I'm not sure what 'him' refers to.

>tell caller about me
You tell the caller that you're from the repair corps.

"Alright then, Sergeant Screwdriver, I'll fill you in. Space Station Omicron-5 was bombed by separatists from Deneb IV. By some miracle the Usagi was spared the worst of the blast; you were thrown clear of the station. Only problem is now you're hurtling towards New Da Nang, a heavily-populated moon of Deneb II. An impact there would kill not only you but potentially thousands of people more.

 "So we've got some work to do. I'm Master Sergeant R. Mu Arvax. I'm going to try and help you get this ship under control again. First we have to establish, though, what the ship is currently doing. Normally, I'd be able to tap into the ship diagnostics and controls from here on Deneb III, but something seems to have gone wrong. So I'm going to need your help. Are you up to the task?"

[Sergeant Screwdriver, guy thinks he's funny.]

>ask arvax about journal
"I'm afraid I don't have anything to say about that."

>yes
"Great, great. Now let's get to work.

 "The first thing I need you to do is reboot the system, using the computer. Once you do that, hopefully I'll be able to access ship controls. You'll have to use my access code: say 'compu--"

Master Sergeant R. Mu Arvax's voice breaks up and another voice comes over comms. "SS Usagi, this is Captain Jane Mulgrew, please come in. Repeat, this is Captain Mulgrew of the SS Usagi, Usagi come in."

[Somebody else?]

>ask mulgrew about journal
You can't see any such thing.

>hello
(addressing Captain Jane Mulgrew)
Captain Mulgrew responds, "Hello there, Usagi. That's my ship you've got there. Be careful with her.

"We've been listening in and we've heard your communications with Arvax. He had us jammed for a while, but we managed to break through and here we are. Now it's very important that you understand this: Arvax is not your friend. His allegiances lie with Deneb IV, not with the Space Authority. He would like nothing more than to see this ship wipe out a few neighborhoods on New Da Nang.

"So what we need you to do is deny Arvax by shutting down any access to the ship's controls from the outside by invoking the emergency protocols. That will put the ship in a state where we can board and take control of the ship. What do you say? Do you have any questions?"

Master Sergeant R. Mu Arvax's voice comes back over the radio: "You there still, Usagi? I think I lost you for a second."

[Oh no, who should I trust?]

>ask mulgrew about journal
"I'm afraid I don't have anything to say about that."

>journal, password charon
The journal chimes pleasantly and the screen fills with text.

>read journal
[I never thought it would come to this, eavesdropping on someone's personal thoughts.]

You page through the journal, skimming over the boring parts detailing the running of the ship. Eventually you come across something more interesting:

"I screwed up last night. I let them spend the night and I think someone noticed. If this got out my career would be over."

A few pages later:

"I'm being blackmailed. I don't know who, but someone messaged me telling me all they know. They know a lot. They made it clear they expect my 'cooperation'."

Numerous later passages detail this cooperation, ranging from simple intelligence gathering to actively working to harm the Space Authority.

[My god...]

Captain Mulgrew: "Did I lose you, Usagi?"

>ask mulgrew about journal
(the captain's journal)
"Lies. Filthy lies. I don't know what you're talking about. And reading my private journal! What kind of person are you?"

Captain Mulgrew cuts the connection.

>ask arvax about journal
(the captain's journal)
"I'm afraid I don't have anything to say about that."

* * *

Crash
An Interactive Disaster by Phil Riley
Release 6 / Serial number 220730 / Inform 7 build 6M62 (I6/v6.34 lib 6/12N) SD

Space Station Gangway
This is the pressurized bridge from Space Station Omicron-5 to the SS Usagi. Behind you is the familiar bulk of the huge station, largest outpost of the Space Authority in Deneb Sector. Before you is the aft airlock of the Usagi, beckoning you in.

[Better get a move on], you think.

>purloin tether
[Purloined.]

>x it
The EVA transport line is a strong rope, maybe 16 meters long. It has a hook at either end. One extends the line between two or more points, and then transits the payload along it.

>gonear pilot's console
(the pilot's console wiriting)

The Second Law of Thermodynamics, in one formulation, states that disorganization always increases in the absence of some outside force. A corollary is that things will always break down in the absence of someone to fix them. As a member of the repair corps of Space Station Omicron-5, you're that someone.

Your last assignment of the day, on the SS Usagi, a Space Marines fighting ship, looks routine enough. Fix the microwave and a jammed locker door, and then you're off for the day.

Room of Stuff
dummy description

A vac suit is here, lying prone as if it were some malformed yellow person knocked unconscious by the shaking of the ship.

You can also see Input 4, Input 3, Input 2, Input 1, Tachyon Crystals, Anti-Helium, Liquid Copernicium, Red Matter, Unobtainium, Oganesson, Void Matter, Empty-space, a brochure, a broken sensor, Typing it on, Captain's Affair, a blue screw, a cooked dinner, a pilot's console wiriting, subj-rebooting-computer, Engine status, Irion, Pollux VI, Pollux III, Hull Integrity, Life support, Milky Way, Cygnus, Pluto, Neptune, Uranus, Tethys, Saturn, Europa, Jupiter, Mars, Venus, Mercury, a moon, Earth, a Sun, Access key, New Da Nang, a Deneb separatists, Location of the ship, Pollux star, a Space Force, Space Authority, Deneb III planet, Orion Marine Academy, Delphi Engine Controls LLC, Substance Injection, Element Copernicium, Luna Spacewerks Parsec VI, Delphi Engine Controls Aleph-Null, Operation Dalmatian, a Space Marines, Deneb sector, Deneb II, Deneb IV, Deneb System, a helm, security code, mulgrew's-code, Emergency protocols, Identity of the player, a Pilot, a Navigator, a cardboard box (empty), some wrapping paper, Bertie the Bear™, a new optical sensor, a black trunk (closed), a null card, Vacuum-suit, Captain Jane Mulgrew, Fuel injection specification, and a shipboard computer floating here.

"I said to return to your post, Ensign Seventh Class!" bellows Blather, turning a deepening shade of crimson.

* * *

Crash
An Interactive Disaster by Phil Riley
Release 6 / Serial number 220730 / Inform 7 build 6M62 (I6/v6.34 lib 6/12N) SD

Space Station Gangway
This is the pressurized bridge from Space Station Omicron-5 to the SS Usagi. Behind you is the familiar bulk of the huge station, largest outpost of the Space Authority in Deneb Sector. Before you is the aft airlock of the Usagi, beckoning you in.

[Better get a move on], you think.

>sb
The only obvious exit is fore.

>sf
I'm not sure what you're trying to say. I might just not recognize the words you're using.

>f
You pass into the aft airlock, the outer door closing behind you.

The Second Law of Thermodynamics, in one formulation, states that disorganization always increases in the absence of some outside force. A corollary is that things will always break down in the absence of someone to fix them. As a member of the repair corps of Space Station Omicron-5, you're that someone.

Your last assignment of the day, on the SS Usagi, a Space Marines fighting ship, looks routine enough. Fix the microwave and a jammed locker door, and then you're off for the day.

Aft Airlock
You are in the aft airlock. Outside is the gangway back to Space Station Omicron-5. Forward leads into the ship.

A pleasant androgynous voice says, "Welcome to the SS Usagi. This is the shipboard computer. Please feel free to call upon me for any information you may need. Use the command 'computer, help' for more information."

* * *

>s
Starboard-Side Crew Quarters
All crew members who aren't the captain sleep in this or the opposite-side bunk room. This one sleeps two in a bunk bed, done up with military precision. There is a large cabinet here, stretching almost to the ceiling. It is closed. Mounted in the wall is a crew personal storage unit. The sole exit is to port.

In a shocking lapse of military precision, there is a sticky note attached to the bed post.

A pair of slippers peeks out from under the bed.

>p
Junction
This is a busy place when the ship is populated. To port and starboard are the crew quarters, aft is the closed door to the captain's private quarters, and fore is the galley. A ladder leads down to the staging area.

* * *

>open cabinet
You open the port-side equipment cabinet, revealing an engineering uniform and an Universal Game Emulator.

>s
Junction
This is a busy place when the ship is populated. To port and starboard are the crew quarters, aft is the closed door to the captain's private quarters, and fore is the galley. A ladder leads down to the staging area.

* * *

>s
Starboard-Side Crew Quarters
All crew members who aren't the captain sleep in this or the opposite-side bunk room. This one sleeps two in a bunk bed, done up with military precision. There is a large cabinet here, stretching almost to the ceiling. It is closed. Mounted in the wall is a crew personal storage unit. The sole exit is to port.

In a shocking lapse of military precision, there is a sticky note attached to the bed post.

A pair of slippers peeks out from under the bed.

>x cabinet
A simple black-painted steel cabinet, it is closed.

>x door
You look closely, but you can't see anything from here that would stop the door from opening all the way.

>open door
The door is stuck one-quarter open. You try to open the cabinet the rest of the way, but the door is jammed.

>p
Junction
This is a busy place when the ship is populated. To port and starboard are the crew quarters, aft is the closed door to the captain's private quarters, and fore is the galley. A ladder leads down to the staging area.

>f
Galley
This narrow space is barely enough room for two Marines to prepare and eat a meal. There is a counter with a drawer, and two stools, a microwave oven, and a large closet here. Pots and pans hang from hooks in the ceiling. A ladder leads up through the midship door, and you can leave aft.

On the starboard wall is a panel on which is a blue button. Tacked to the panel is the operator's manual for the midship door.

>x closet
A closet with a folding door, set into the bulkhead.

You faintly hear someone speaking above.

>open door
(Midship Door)
You can't open that with your bare hands.

* * *

Crash
An Interactive Disaster by Phil Riley
Release 6 / Serial number 220730 / Inform 7 build 6M62 (I6/v6.34 lib 6/12N) SD

Space Station Gangway
This is the pressurized bridge from Space Station Omicron-5 to the SS Usagi. Behind you is the familiar bulk of the huge station, largest outpost of the Space Authority in Deneb Sector. Before you is the aft airlock of the Usagi, beckoning you in.

[Better get a move on], you think.

>take fasteners
You'll take them out when you need them.

>take screw
You can't see any such thing.

>take screws
You'll take them out when you need them.

>take screwdriver
You'll take it out when you need it.

>take tools
What do you want to take those things from?

>toolbox
You can't see any such thing.

>take all from toolbox
That can't contain things.

* * *

Crash
An Interactive Disaster by Phil Riley
Release 6 / Serial number 220730 / Inform 7 build 6M62 (I6/v6.34 lib 6/12N) SD

Space Station Gangway
This is the pressurized bridge from Space Station Omicron-5 to the SS Usagi. Behind you is the familiar bulk of the huge station, largest outpost of the Space Authority in Deneb Sector. Before you is the aft airlock of the Usagi, beckoning you in.

[Better get a move on], you think.

>take screwdriver
You'll take it out when you need it.

* * *

>wear syut
You can't see any such thing.

>wear suit
(first taking the vac suit)
You put on the vac suit.

>a
(first getting off the black trunk)

Aft Airlock
You are in the aft airlock. Outside is the blackness of space, speckled with the dying embers of what was once Space Station Omicron-5. Forward leads into the ship.

* * *

>a
It's dangerous out there. I recommend saving the game first...
⇒ Use "save" to save the game, or go "out" again to continue without saving.

>a
You take a step on the hull of the ship, and keep going, and going... Should have turned those mag boots on.
[Oops.]

    *** You float forever in the vastness of space ***

In that game you scored 1 out of a possible 10, in 23 turns.

Your death was completely pointless and preventable. All the same we grudgingly award you one point each for what you did accomplish, which was:
- fixing the aft airlock door

Would you like to RESTART, RESTORE a saved game, QUIT, or UNDO the last command?

>undo
Aft Airlock
[Previous turn undone.]

* * *

>a
Outside the Aft Airlock (vacuum)
You are standing on the hull of the ship, outside the aft airlock, secured by your vac suit's mag boots. Most of the hull is taken up by the protrusions of various machinery, antennae, radio dishes, and heat sinks. There is a clear path to fore among the obstructions. You can also go in to the airlock.

A hook protrudes from the hull next to the airlock door.

Your vac suit pings gently to indicate you have expended a unit of air.

>x hok
You can't see any such thing.

>x hook
A post extends from the hull here, with a heavyweight snap hook on the end. The hook is unattached.

Your vac suit pings gently to indicate you have expended a unit of air.

>x post
A post extends from the hull here, with a heavyweight snap hook on the end. The hook is unattached.

Your vac suit pings gently to indicate you have expended a unit of air.

* * *

>ask arvax about ship
(the ss usagi)
"Great ship. I hope we can save her. And you."

>ask arvax about gravity
Which do you mean, gravity or the gravity control?

>control
"I'm afraid I don't have anything to say about that."

>ask arvax about arvax
Hey, you sound tired. If you need a rest, lower the gravity setting. You should find it in the operations deck somewhere.

"I'm just an old Marine trying to do his duty."

* * *

>ask arvax about engine
(the fusion engine)
"I can't get any readings until you reboot the system."

>ask arvax about engine status
"I'm afraid I don't have anything to say about that."

* * *

>ask arvax about jl-758
Which do you mean, the JL-758 or the broken JL-758?

>broken
"I'm afraid I don't have anything to say about that."

>ask arvax about delphi
"I'm afraid I don't have anything to say about that."

>ask arvax about engine
(the fusion engine)
"I'm afraid I don't have anything to say about that."

>ask arvax about status
"I'm afraid I don't have anything to say about that."

>ask arvax about diagram
"I'm afraid I don't have anything to say about that."

>ask arvax about fusion engine
"I'm afraid I don't have anything to say about that."

>ask arvax about monitors
Which do you mean, the engineering monitors or the engine room monitors?

>engine room
"I'm afraid I don't have anything to say about that."

* * *

>ask captain about journal
(the captain's journal)
"Lies. Filthy lies. I don't know what you're talking about. And reading my private journal! What kind of person are you?"

Captain Mulgrew cuts the connection.

>ask captain about journal
You can't see any such thing.

* * *

>p
(first getting off the top bunk)

Junction
This is a busy place when the ship is populated. To port and starboard are the crew quarters, aft is the closed door to the captain's private quarters, and fore is the galley. A ladder leads down to the staging area.

>p
Port-Side Crew Quarters
All crew members who aren't the captain sleep in this or the opposite-side bunk room. This one sleeps two in a bunk bed, done up with military precision. There is a large cabinet here, stretching almost to the ceiling. It is closed. Mounted in the wall is a crew personal storage unit. The sole exit is to starboard.

>type 9467
As you press a key, the storage unit starts buzzing continuously. The display lights up with random characters, and you smell the distinct odor of burning wires. The bottom storage drawer pops out a centimeter or two.

You add an item ("fix the storage unit") to your to-do list.

>unlock unit with key
You may be trying to unlock the keypad, which has a keyhole in it.

>put key in keyhole
You open the front panel of the keypad, revealing a bundle of wiring. You can see the problem immediately -- two wires with worn insulation are in contact, causing a short-circuit.

* * *

>press test
A voice says "Fuel test sequence beginning..."

"10"

>f
Engineering Deck
The engineering crew is responsible for keeping the physical ship operating. They are in charge of every physical aspect of the ship, from the engines to hull integrity to the life support system.

The engineering deck consists of a large console giving a comprehensive view of the physical status of the ship. There is an airlock to starboard. The operations deck continues forward from here, and there are other exits to aft and port.

A device labeled "Suit Recharging Station" is here. It is shaped like a chair with nozzles protruding from either arm.

You hear someone speaking forward of here.

"9"

>out
Engineering Airlock
You are in the engineering airlock. Outside, the space to starboard looks so empty and peaceful it's hard to imagine the awful sight astern.

"8"

>out
You grab hold of the tether to keep yourself on the ship. Better turn your mag boots on.
⇒ If you'd really like to go farther out from the ship, say so with "out".

Your vac suit pings gently to indicate you have expended a unit of air.

"7"

>out
You propel yourself away from the ship. Some hours later a ship, following your beacon, finds you and rescues you. By that time, however, the SS Usagi has slammed into New Da Nang, killing thousands. You can't help but think you might have saved them if you had stayed on the ship.

    *** You have saved yourself in a disgraceful act of cowardice. ***

In that game you scored 0 out of a possible 10, in 158 turns.

You get nothing! You lose! Good day, sir!

Would you like to RESTART, RESTORE a saved game, QUIT, or UNDO the last command?

>undo
Outside the Engineering Airlock (vacuum)
[Previous turn undone.]

* * *

>a
Junction
This is a busy place when the ship is populated. To port and starboard are the crew quarters, aft is the closed door to the captain's private quarters, and fore is the galley. A ladder leads down to the staging area.

>s
Starboard-Side Crew Quarters
All crew members who aren't the captain sleep in this or the opposite-side bunk room. This one sleeps two in a bunk bed, done up with military precision. There is a large cabinet here, stretching almost to the ceiling. It is closed. Mounted in the wall is a crew personal storage unit. The sole exit is to port.

In a shocking lapse of military precision, there is a sticky note attached to the bed post.

You can also see a cardboard box (empty) and some wrapping paper here.

>get on bed
You get onto the top bunk.

>x door
You can see the problem from up here: the top hinge of the cabinet door has a crooked screw, probably from the door being slammed too many times. You'll have to replace it.

>fix screw
You unscrew the old screw and replace it with a new one.

You cross out an item ("fix the cabinet") on your to-do list.

[Your score has just gone up by one point.]

>unfo
I'm not sure what you're trying to say. I might just not recognize the words you're using.

>undo
Starboard-Side Crew Quarters
[Previous turn undone.]

>fix door
This is a hard one. You'll have to be more specific about how you do that.

>remove screw
You can't see any such thing.

>take screw
You can't see any such thing.

>x door
It's a simple black-painted steel door.

>restart
Are you sure you want to restart?

>y
Crash
An Interactive Disaster by Phil Riley
Release 5 / Serial number 220728 / Inform 7 build 6M62 (I6/v6.34 lib 6/12N) SD

Space Station Gangway
This is the pressurized bridge from Space Station Omicron-5 to the SS Usagi. Behind you is the familiar bulk of the huge station, largest outpost of the Space Authority in Deneb Sector. Before you is the aft airlock of the Usagi, beckoning you in.

[Better get a move on], you think.

* * *

>get on bed
You get onto the top bunk.

>take screw
You unscrew the old screw and replace it with a new one.

You cross out an item ("fix the cabinet") on your to-do list.

[Your score has just gone up by one point.]

>i
You are carrying:
  a microwavable dinner
  a knife
  a fresh fuse
  a hex-shaped tool
  a roll of electrical tape
  a small key
  a portable hand-held vacuum cleaner
  a vac suit (being worn) with chewing gum stuck to it
  a broken sensor
  Bertie the Bear™
  some pair of slippers
  a To-Do list
  a repair corps uniform (being worn)
  a toolbox

>d
You get off the top bunk.

Starboard-Side Crew Quarters
All crew members who aren't the captain sleep in this or the opposite-side bunk room. This one sleeps two in a bunk bed, done up with military precision. There is a large cabinet here, stretching almost to the ceiling. It is closed. Mounted in the wall is a crew personal storage unit. The sole exit is to port.

In a shocking lapse of military precision, there is a sticky note attached to the bed post.

You can also see a cardboard box (empty) and some wrapping paper here.

* * *

>s
Junction
This is a busy place when the ship is populated. To port and starboard are the crew quarters, aft is the closed door to the captain's private quarters, and fore is the galley. A ladder leads down to the staging area.

>d
Staging Area
This is the staging area of the ship, where marines prepare for missions. It is adjacent to the aft airlock. Locked compartments set into the walls hold various munitions. A ladder leads up into the rest of the ship. 

An equipment locker is sprawled across the room, with its door to the ground.
 
Through the airlock windows you see the blank space left by the destruction of Space Station Omicron-5.

What looks like part of an engine is stowed in a corner.

You can also see a black trunk (closed) here.

>take locker
You can't really lift the locker, even with the gravity this low, but you can turn it over.

You turn over the locker. Now it's door-side-up.

* * *

>ask arvax about engine
(the fusion engine)
"You're back! Great job rebooting the computer -- I'm getting telemetry now.

"We don't have time for that!

"The only thing we have time to focus on is the ship!

"I'm trying to divert the ship from its collision course with New Da Nang, but there's a problem: the fuel injection specification for the fusion engine is incorrect."

You add an item ("adjust fuel injection specification") to your to-do list.

>ask arvax about engine
(the fusion engine)
"We don't have time for that!

"The only thing we have time to focus on is the ship!

"I'm trying to divert the ship from its collision course with New Da Nang, but there's a problem: the fuel injection specification for the fusion engine is incorrect."

* * *

>ask arvax about engine
(the fusion engine)
"You're back! Great job rebooting the computer -- I'm getting telemetry now.

"I'm seeing the engine fully online. Now you need to get the fuel specification right."

>ask arvax about fuel
"This may be tricky. Take a look around the engine room."

>ask arvax about fuel specification
"This may be tricky. Take a look around the engine room."

>ask arvax about fuel injection specification
"This may be tricky. Take a look around the engine room."

>ask arvax about card
"We don't have time for that!

"The only thing we have time to focus on is the ship!

"I'm trying to divert the ship from its collision course with New Da Nang, but there's a problem: the fuel injection specification for the fusion engine is incorrect."

You add an item ("adjust fuel injection specification") to your to-do list.

* * *

>ask arvax about engine
(the fusion engine)
"You're back! Great job rebooting the computer -- I'm getting telemetry now.

"I'm seeing the engine fully online. Now you need to get the fuel specification right.

* * *

>ask arvax about card
"You're back! Great job rebooting the computer -- I'm getting telemetry now.

"We don't have time for that!

"I'm trying to divert the ship from its collision course with New Da Nang, but there's a problem: the fuel injection specification for the fusion engine is incorrect."

You add an item ("adjust fuel injection specification") to your to-do list.

>undo
Operations Deck
[Previous turn undone.]

>ask arvax about engine
(the fusion engine)
"You're back! Great job rebooting the computer -- I'm getting telemetry now.

"I'm seeing the engine fully online. Now you need to get the fuel specification right."

You add an item ("adjust fuel injection specification") to your to-do list.

>ask arvax about fuel
"You need to set it to produce the correct output. The computer may be able to help you. I'm no engine specialist."

>a
Engineering Deck
The engineering crew is responsible for keeping the physical ship operating. They are in charge of every physical aspect of the ship, from the engines to hull integrity to the life support system.

The engineering deck consists of a large console giving a comprehensive view of the physical status of the ship. There is an airlock to starboard. The operations deck continues forward from here, and there are other exits to aft and port.

A device labeled "Suit Recharging Station" is here. It is shaped like a chair with nozzles protruding from either arm.

>a
Engine Room
This where the combustion process is controlled. The aft wall is dominated by the operating panel of the fusion engine. Monitoring electronics and controls cover the other two walls. A doorway opens forward to the Engineering Deck.

There is a large diagram of the fuel injection process on the forward wall. There is a large button below the diagram labeled "Test".

You can see a broken JL-758 here.

>ask computer about void matter
I'm unable to give you any information about void matter.

>x diagram
This is a diagram of the fuel injection process for the fusion engine. Printed above it is the label "Delphi Engine Controls Aleph-Null". Below that is a representation of the various inputs and the products created during the fuel injection process. Each input has a touch-sensitive surface which can be used to alter the diagram's settings.

       Input: 2 --  3 --  4 --
                ||    ||    ||
             ===vv====vv====vv===
Input 1:     -- >> -- >> -- >> --  Output
             ====================

        FUEL INJECTION SPECIFICATION INCOMPLETE

Key:    --   empty input or output
        AH   Anti-Helium
        LC   Liquid Copernicium*
        Og   Oganesson
        RM   Red Matter            
        TC   Tachyon Crystals
        Un   Unobtainium
        VM   Void Matter*

        * this substance can only be produced, not input.

⇒ Use "substance > input" to set each input. For instance, "Un > 3" sets input 3 to Unobtainium. You may also use "set <input> to <substance>" for the same effect. Use "disconnect <input>" to disconnect an input.

>ask computer about void matter
Void Matter is essentially vacuum condensed into matter, according to the most comprehensible description we could find. It is an extremely unstable substance, and tends to explode catastrophically in the presence of high levels of energy. It can be created by injecting one source of tachyon crystals into another source of tachyon crystals.

>TC > 4
This is a diagram of the fuel injection process for the fusion engine. Printed above it is the label "Delphi Engine Controls Aleph-Null". Below that is a representation of the various inputs and the products created during the fuel injection process. Each input has a touch-sensitive surface which can be used to alter the diagram's settings.

       Input: 2 --  3 --  4 TC
                ||    ||    ||
             ===vv====vv====vv===
Input 1:     -- >> -- >> -- >> --  Output
             ====================

        FUEL INJECTION SPECIFICATION INCOMPLETE

Key:    --   empty input or output
        AH   Anti-Helium
        LC   Liquid Copernicium*
        Og   Oganesson
        RM   Red Matter            
        TC   Tachyon Crystals
        Un   Unobtainium
        VM   Void Matter*

        * this substance can only be produced, not input.

>ask computer about tc
Rather than containing or being formed of tachyons, tachyon crystals get their name from their use in detecting tachyons, due to their negative refractive index. The typical method of creating tachyon crystals is injecting Anti-Helium into Red Matter. Tachyon Crystals can be used in the creation of Void Matter.

>ah > 3
This is a diagram of the fuel injection process for the fusion engine. Printed above it is the label "Delphi Engine Controls Aleph-Null". Below that is a representation of the various inputs and the products created during the fuel injection process. Each input has a touch-sensitive surface which can be used to alter the diagram's settings.

       Input: 2 --  3 AH  4 TC
                ||    ||    ||
             ===vv====vv====vv===
Input 1:     -- >> -- >> -- >> --  Output
             ====================

        FUEL INJECTION SPECIFICATION INCOMPLETE

Key:    --   empty input or output
        AH   Anti-Helium
        LC   Liquid Copernicium*
        Og   Oganesson
        RM   Red Matter            
        TC   Tachyon Crystals
        Un   Unobtainium
        VM   Void Matter*

        * this substance can only be produced, not input.

>ask about rm
Master Sergeant R. Mu Arvax isn't here.

>ask computer about rm
Red Matter is an unstable, possibly impossible substance created by injecting Tachyon Crystals into Unobtainium.

>2 > tc
You can't use multiple objects with that verb.

>1 > un
I'm not sure what you're trying to say. I might just not recognize the words you're using.

>tc > 2
This is a diagram of the fuel injection process for the fusion engine. Printed above it is the label "Delphi Engine Controls Aleph-Null". Below that is a representation of the various inputs and the products created during the fuel injection process. Each input has a touch-sensitive surface which can be used to alter the diagram's settings.

       Input: 2 TC  3 AH  4 TC
                ||    ||    ||
             ===vv====vv====vv===
Input 1:     -- >> -- >> -- >> --  Output
             ====================

        FUEL INJECTION SPECIFICATION INCOMPLETE

Key:    --   empty input or output
        AH   Anti-Helium
        LC   Liquid Copernicium*
        Og   Oganesson
        RM   Red Matter            
        TC   Tachyon Crystals
        Un   Unobtainium
        VM   Void Matter*

        * this substance can only be produced, not input.

>un > 1
This is a diagram of the fuel injection process for the fusion engine. Printed above it is the label "Delphi Engine Controls Aleph-Null". Below that is a representation of the various inputs and the products created during the fuel injection process. Each input has a touch-sensitive surface which can be used to alter the diagram's settings.

       Input: 2 TC  3 AH  4 TC
                ||    ||    ||
             ===vv====vv====vv===
Input 1:     Un >> RM >> TC >> VM  Output
             ====================

        WARNING: DANGEROUS INJECTION PRODUCT

Key:    --   empty input or output
        AH   Anti-Helium
        LC   Liquid Copernicium*
        Og   Oganesson
        RM   Red Matter            
        TC   Tachyon Crystals
        Un   Unobtainium
        VM   Void Matter*

        * this substance can only be produced, not input.

>f
Engineering Deck
The engineering crew is responsible for keeping the physical ship operating. They are in charge of every physical aspect of the ship, from the engines to hull integrity to the life support system.

The engineering deck consists of a large console giving a comprehensive view of the physical status of the ship. There is an airlock to starboard. The operations deck continues forward from here, and there are other exits to aft and port.

A device labeled "Suit Recharging Station" is here. It is shaped like a chair with nozzles protruding from either arm.

>f
Operations Deck
This is where all of the support activity for the bridge occurs. There are large consoles for environmental controls, communications, and power systems here. The bridge continues forward from here, and engineering is aft. There is a door set in the floor with a ladder leading through it. Set in the frame of the door is a blue button.

You can see an equipment trunk (closed) here.

Master Sergeant R. Mu Arvax: "You there, Usagi? We don't have much time."

>ask about fuel
(addressing Master Sergeant R. Mu Arvax)
"You're back! Great job rebooting the computer -- I'm getting telemetry now.

"You've set the fuel injection to destroy the ship! Change it now before anything happens!"

>a
Engineering Deck
The engineering crew is responsible for keeping the physical ship operating. They are in charge of every physical aspect of the ship, from the engines to hull integrity to the life support system.

The engineering deck consists of a large console giving a comprehensive view of the physical status of the ship. There is an airlock to starboard. The operations deck continues forward from here, and there are other exits to aft and port.

A device labeled "Suit Recharging Station" is here. It is shaped like a chair with nozzles protruding from either arm.

* * *

>a
Engine Room
This where the combustion process is controlled. The aft wall is dominated by the operating panel of the fusion engine. Monitoring electronics and controls cover the other two walls. A doorway opens forward to the Engineering Deck.

There is a large diagram of the fuel injection process on the forward wall. There is a large button below the diagram labeled "Test".

You can see a broken JL-758 here.

>press test
A voice says "Fuel test sequence beginning..."

"10"

>z
Time passes.

"9"

>z
Time passes.

"8"

>z
Time passes.

"7"

>z
Time passes.

"6"

>z
Time passes.

"5"

>z
Time passes.

"4"

>z
Time passes.

"3"

>z
Time passes.

"2"

>z
Time passes.

"1"

>z
Time passes.

"0"

The Void Matter is injected into the fusion engine, causing an explosion that rips the ship apart. You are never aware of this, however, as you are instantly `. If you had been aware, you would certainly have been pleased to know that your death saved the people of New Da Nang.

    *** You have died nobly. ***

In that game you scored 7 out of a possible 10, in 172 turns.

Well done! You made the ultimate sacrifice so that others might live. First, we award you one point each for:
- fixing the aft airlock door
- fixing the microwave oven
- fixing the equipment cabinet in the starboard-side crew quarters
- fixing the storage unit in the port-side crew quarters
- fixing the fusion engine
- fixing the captain's door

We also award you one point for saving New Da Nang. Congratulations!

Would you like to RESTART, RESTORE a saved game, QUIT, or UNDO the last command?

* * *

>og > 4
This is a diagram of the fuel injection process for the fusion engine. Printed above it is the label "Delphi Engine Controls Aleph-Null". Below that is a representation of the various inputs and the products created during the fuel injection process. Each input has a touch-sensitive surface which can be used to alter the diagram's settings.

       Input: 2 --  3 --  4 Og
                ||    ||    ||
             ===vv====vv====vv===
Input 1:     -- >> -- >> -- >> --  Output
             ====================

        FUEL INJECTION SPECIFICATION INCOMPLETE

Key:    --   empty input or output
        AH   Anti-Helium
        LC   Liquid Copernicium*
        Og   Oganesson
        RM   Red Matter            
        TC   Tachyon Crystals
        Un   Unobtainium
        VM   Void Matter*

        * this substance can only be produced, not input.

>og > 1
This is a diagram of the fuel injection process for the fusion engine. Printed above it is the label "Delphi Engine Controls Aleph-Null". Below that is a representation of the various inputs and the products created during the fuel injection process. Each input has a touch-sensitive surface which can be used to alter the diagram's settings.

       Input: 2 --  3 --  4 Og
                ||    ||    ||
             ===vv====vv====vv===
Input 1:     Og >> -- >> -- >> --  Output
             ====================

        FUEL INJECTION SPECIFICATION INCOMPLETE

Key:    --   empty input or output
        AH   Anti-Helium
        LC   Liquid Copernicium*
        Og   Oganesson
        RM   Red Matter            
        TC   Tachyon Crystals
        Un   Unobtainium
        VM   Void Matter*

        * this substance can only be produced, not input.

>rm > 2
This is a diagram of the fuel injection process for the fusion engine. Printed above it is the label "Delphi Engine Controls Aleph-Null". Below that is a representation of the various inputs and the products created during the fuel injection process. Each input has a touch-sensitive surface which can be used to alter the diagram's settings.

       Input: 2 RM  3 --  4 Og
                ||    ||    ||
             ===vv====vv====vv===
Input 1:     Og >> -- >> -- >> --  Output
             ====================

        FUEL INJECTION SPECIFICATION INCOMPLETE

Key:    --   empty input or output
        AH   Anti-Helium
        LC   Liquid Copernicium*
        Og   Oganesson
        RM   Red Matter            
        TC   Tachyon Crystals
        Un   Unobtainium
        VM   Void Matter*

        * this substance can only be produced, not input.

>un > 2
This is a diagram of the fuel injection process for the fusion engine. Printed above it is the label "Delphi Engine Controls Aleph-Null". Below that is a representation of the various inputs and the products created during the fuel injection process. Each input has a touch-sensitive surface which can be used to alter the diagram's settings.

       Input: 2 Un  3 --  4 Og
                ||    ||    ||
             ===vv====vv====vv===
Input 1:     Og >> -- >> -- >> --  Output
             ====================

        FUEL INJECTION SPECIFICATION INCOMPLETE

Key:    --   empty input or output
        AH   Anti-Helium
        LC   Liquid Copernicium*
        Og   Oganesson
        RM   Red Matter            
        TC   Tachyon Crystals
        Un   Unobtainium
        VM   Void Matter*

        * this substance can only be produced, not input.

>ah > 2
This is a diagram of the fuel injection process for the fusion engine. Printed above it is the label "Delphi Engine Controls Aleph-Null". Below that is a representation of the various inputs and the products created during the fuel injection process. Each input has a touch-sensitive surface which can be used to alter the diagram's settings.

       Input: 2 AH  3 --  4 Og
                ||    ||    ||
             ===vv====vv====vv===
Input 1:     Og >> Un >> -- >> --  Output
             ====================

        FUEL INJECTION SPECIFICATION INCOMPLETE

Key:    --   empty input or output
        AH   Anti-Helium
        LC   Liquid Copernicium*
        Og   Oganesson
        RM   Red Matter            
        TC   Tachyon Crystals
        Un   Unobtainium
        VM   Void Matter*

        * this substance can only be produced, not input.

>tc >3
I didn't understand that sentence.

>tc > 3
This is a diagram of the fuel injection process for the fusion engine. Printed above it is the label "Delphi Engine Controls Aleph-Null". Below that is a representation of the various inputs and the products created during the fuel injection process. Each input has a touch-sensitive surface which can be used to alter the diagram's settings.

       Input: 2 AH  3 TC  4 Og
                ||    ||    ||
             ===vv====vv====vv===
Input 1:     Og >> Un >> RM >> LC  Output
             ====================

        FUEL INJECTION SPECIFICATION VALID

Key:    --   empty input or output
        AH   Anti-Helium
        LC   Liquid Copernicium*
        Og   Oganesson
        RM   Red Matter            
        TC   Tachyon Crystals
        Un   Unobtainium
        VM   Void Matter*

        * this substance can only be produced, not input.

You cross out an item ("adjust fuel injection specification") on your to-do list.

[Your score has just gone up by one point.]

>f
Engineering Deck
The engineering crew is responsible for keeping the physical ship operating. They are in charge of every physical aspect of the ship, from the engines to hull integrity to the life support system.

The engineering deck consists of a large console giving a comprehensive view of the physical status of the ship. There is an airlock to starboard. The operations deck continues forward from here, and there are other exits to aft and port.

A device labeled "Suit Recharging Station" is here. It is shaped like a chair with nozzles protruding from either arm.

I beg your pardon?

>f
Operations Deck
This is where all of the support activity for the bridge occurs. There are large consoles for environmental controls, communications, and power systems here. The bridge continues forward from here, and engineering is aft. There is a door set in the floor with a ladder leading through it. Set in the frame of the door is a blue button.

You can see an equipment trunk (closed) here.

Master Sergeant R. Mu Arvax: "You there, Usagi? We don't have much time."

>ask arvax about fuel
"It looks like you've set the fuel injection correctly."

"Looks like the ship is ready to fly! Quick! Get to the bridge and use the command console! Say 'computer, execute'"
[Not much time!]

"Impact in 9."

>undo
Operations Deck
[Previous turn undone.]

>ask arvax about spam
"Looks like the ship is ready to fly! Quick! Get to the bridge and use the command console! Say 'computer, execute'"
[Not much time!]

"Impact in 9."

* * *

>ask arvax about fuel
"You need to set it to produce the correct output. The computer may be able to help you. I'm no engine specialist."

>ask arvax about spam
We don't have time for that!

"I'm trying to divert the ship from its collision course with New Da Nang, but there's a problem: the fuel injection specification for the fusion engine is incorrect."

>ask arvax about ship
(the ss usagi)
"I'm trying to divert the ship from its collision course with New Da Nang, but there's a problem: the fuel injection specification for the fusion engine is incorrect."

>ask arvax about engine
(the fusion engine)
"I'm seeing the engine fully online. Now you need to get the fuel specification right."

* * *

>ask arvax about spam
We don't have time for that!

"I'm trying to divert the ship from its collision course with New Da Nang, but there's a problem: the fuel injection specification for the fusion engine is incorrect."

>rules
Rules tracing now switched on. Type "rules off" to switch it off again, or "rules all" to include even rules which do not apply.

[Rule "reset report text rule" applies.]

* * *

>ask arvax about chicken
"You're back! Great job rebooting the computer -- I'm getting telemetry now.

"The only thing we time to focus on is the ship!

"I'm trying to divert the ship from its collision course with New Da Nang, but there's a problem: the fuel injection specification for the fusion engine is incorrect.

You add an item ("adjust fuel injection specification") to your to-do list.

>ask arvax about asdf
"I'm trying to divert the ship from its collision course with New Da Nang, but there's a problem: the fuel injection specification for the fusion engine is incorrect.

* * *

>ask arvax about chicken
"You're back! Great job rebooting the computer -- I'm getting telemetry now.

"The only thing we time to focus on is the ship!

"I'm trying to divert the ship from its collision course with New Da Nang, but there's a problem: the fuel injection specification for the fusion engine is incorrect.

You add an item ("adjust fuel injection specification") to your to-do list.

>ask arvax about spam
"The only thing we time to focus on is the ship!
"I'm trying to divert the ship from its collision course with New Da Nang, but there's a problem: the fuel injection specification for the fusion engine is incorrect.

>ask arvax about journal
(the captain's journal)
"We don't have time for that!

"The only thing we time to focus on is the ship!
"I'm trying to divert the ship from its collision course with New Da Nang, but there's a problem: the fuel injection specification for the fusion engine is incorrect.

* * *

>ask arvax about chicken
"You're back! Great job rebooting the computer -- I'm getting telemetry now.

"The only thing we time to focus on is the ship!

"I'm trying to divert the ship from its collision course with New Da Nang, but there's a problem: the fuel injection specification for the fusion engine is incorrect.

You add an item ("adjust fuel injection specification") to your to-do list.

>yes
I'm not sure what question you're answering.

>z
Time passes.

>z
Time passes.

Master Sergeant R. Mu Arvax: "You there, Usagi? We don't have much time."

>yes
I'm not sure what question you're answering.

>no
I'm not sure what question you're answering.

* * *

>ask arvax about engine
(the fusion engine)
"You're back! Great job rebooting the computer -- I'm getting telemetry now.

"I'm seeing the engine fully online. Now you need to get the fuel specification right."

>ask arvax about fuel specification
"We don't have time for that!

"The only thing we have time to focus on is the ship!

"I'm trying to divert the ship from its collision course with New Da Nang, but there's a problem: the fuel injection specification for the fusion engine is incorrect."

You add an item ("adjust fuel injection specification") to your to-do list.

>ask arvax about fuel
"We don't have time for that!

"The only thing we have time to focus on is the ship!

"I'm trying to divert the ship from its collision course with New Da Nang, but there's a problem: the fuel injection specification for the fusion engine is incorrect."

* * *

>test tether
Please give one of the answers above.

Would you like to RESTART, RESTORE a saved game, QUIT, or UNDO the last command?

>test staging
Please give one of the answers above.

Would you like to RESTART, RESTORE a saved game, QUIT, or UNDO the last command?

>test planetfall
Please give one of the answers above.

Would you like to RESTART, RESTORE a saved game, QUIT, or UNDO the last command?

>test storage
Please give one of the answers above.

Would you like to RESTART, RESTORE a saved game, QUIT, or UNDO the last command?

>test cabinet
Please give one of the answers above.

Would you like to RESTART, RESTORE a saved game, QUIT, or UNDO the last command?

>test microwave
Please give one of the answers above.

Would you like to RESTART, RESTORE a saved game, QUIT, or UNDO the last command?

>test spacewalk
Please give one of the answers above.

Would you like to RESTART, RESTORE a saved game, QUIT, or UNDO the last command?

>test airlock
Please give one of the answers above.

Would you like to RESTART, RESTORE a saved game, QUIT, or UNDO the last command?

>f
Please give one of the answers above.

Would you like to RESTART, RESTORE a saved game, QUIT, or UNDO the last command?

>f
Please give one of the answers above.

Would you like to RESTART, RESTORE a saved game, QUIT, or UNDO the last command?

>u
Please give one of the answers above.

Would you like to RESTART, RESTORE a saved game, QUIT, or UNDO the last command?

>a
Please give one of the answers above.

Would you like to RESTART, RESTORE a saved game, QUIT, or UNDO the last command?

>u
Please give one of the answers above.

Would you like to RESTART, RESTORE a saved game, QUIT, or UNDO the last command?

>s
Please give one of the answers above.

Would you like to RESTART, RESTORE a saved game, QUIT, or UNDO the last command?

>take slippers
Please give one of the answers above.

Would you like to RESTART, RESTORE a saved game, QUIT, or UNDO the last command?

>look under bed
Please give one of the answers above.

Would you like to RESTART, RESTORE a saved game, QUIT, or UNDO the last command?

>get trunk
Please give one of the answers above.

Would you like to RESTART, RESTORE a saved game, QUIT, or UNDO the last command?

>open it
Please give one of the answers above.

Would you like to RESTART, RESTORE a saved game, QUIT, or UNDO the last command?

>take present
Please give one of the answers above.

Would you like to RESTART, RESTORE a saved game, QUIT, or UNDO the last command?

>open it
Please give one of the answers above.

Would you like to RESTART, RESTORE a saved game, QUIT, or UNDO the last command?

>take eyes
Please give one of the answers above.

Would you like to RESTART, RESTORE a saved game, QUIT, or UNDO the last command?

>p
Please give one of the answers above.

Would you like to RESTART, RESTORE a saved game, QUIT, or UNDO the last command?

>d
Please give one of the answers above.

Would you like to RESTART, RESTORE a saved game, QUIT, or UNDO the last command?

>drop trunk
Please give one of the answers above.

Would you like to RESTART, RESTORE a saved game, QUIT, or UNDO the last command?

>stand on trunk
Please give one of the answers above.

Would you like to RESTART, RESTORE a saved game, QUIT, or UNDO the last command?

>take broken sensor
Please give one of the answers above.

Would you like to RESTART, RESTORE a saved game, QUIT, or UNDO the last command?

>put optical sensor in panel
Please give one of the answers above.

Would you like to RESTART, RESTORE a saved game, QUIT, or UNDO the last command?

>take suit
Please give one of the answers above.

Would you like to RESTART, RESTORE a saved game, QUIT, or UNDO the last command?

>wear it
Please give one of the answers above.

Would you like to RESTART, RESTORE a saved game, QUIT, or UNDO the last command?

>turn on mag boots
Please give one of the answers above.

Would you like to RESTART, RESTORE a saved game, QUIT, or UNDO the last command?

>a
Please give one of the answers above.

Would you like to RESTART, RESTORE a saved game, QUIT, or UNDO the last command?

>out
Please give one of the answers above.

Would you like to RESTART, RESTORE a saved game, QUIT, or UNDO the last command?

>out
Please give one of the answers above.

Would you like to RESTART, RESTORE a saved game, QUIT, or UNDO the last command?

>f
Please give one of the answers above.

Would you like to RESTART, RESTORE a saved game, QUIT, or UNDO the last command?

>s
Please give one of the answers above.

Would you like to RESTART, RESTORE a saved game, QUIT, or UNDO the last command?

>vent air
Please give one of the answers above.

Would you like to RESTART, RESTORE a saved game, QUIT, or UNDO the last command?

>s
Please give one of the answers above.

Would you like to RESTART, RESTORE a saved game, QUIT, or UNDO the last command?

>in
Please give one of the answers above.

Would you like to RESTART, RESTORE a saved game, QUIT, or UNDO the last command?

>p
Please give one of the answers above.

Would you like to RESTART, RESTORE a saved game, QUIT, or UNDO the last command?

>sit in recharger
Please give one of the answers above.

Would you like to RESTART, RESTORE a saved game, QUIT, or UNDO the last command?

>p
Please give one of the answers above.

Would you like to RESTART, RESTORE a saved game, QUIT, or UNDO the last command?

>open drawer
Please give one of the answers above.

Would you like to RESTART, RESTORE a saved game, QUIT, or UNDO the last command?

>take all
Please give one of the answers above.

Would you like to RESTART, RESTORE a saved game, QUIT, or UNDO the last command?

>s
Please give one of the answers above.

Would you like to RESTART, RESTORE a saved game, QUIT, or UNDO the last command?

>f
Please give one of the answers above.

Would you like to RESTART, RESTORE a saved game, QUIT, or UNDO the last command?

>move trunk
Please give one of the answers above.

Would you like to RESTART, RESTORE a saved game, QUIT, or UNDO the last command?

>set gravity control to 1
Please give one of the answers above.

Would you like to RESTART, RESTORE a saved game, QUIT, or UNDO the last command?

>press button
Please give one of the answers above.

Would you like to RESTART, RESTORE a saved game, QUIT, or UNDO the last command?

>d
Please give one of the answers above.

Would you like to RESTART, RESTORE a saved game, QUIT, or UNDO the last command?

>open drawer
Please give one of the answers above.

Would you like to RESTART, RESTORE a saved game, QUIT, or UNDO the last command?

>take knife
Please give one of the answers above.

Would you like to RESTART, RESTORE a saved game, QUIT, or UNDO the last command?

>open closet
Please give one of the answers above.

Would you like to RESTART, RESTORE a saved game, QUIT, or UNDO the last command?

>take dinner
Please give one of the answers above.

Would you like to RESTART, RESTORE a saved game, QUIT, or UNDO the last command?

>unplug microwave
Please give one of the answers above.

Would you like to RESTART, RESTORE a saved game, QUIT, or UNDO the last command?

>vacuum socket
Please give one of the answers above.

Would you like to RESTART, RESTORE a saved game, QUIT, or UNDO the last command?

>plug in microwave
Please give one of the answers above.

Would you like to RESTART, RESTORE a saved game, QUIT, or UNDO the last command?

>a
Please give one of the answers above.

Would you like to RESTART, RESTORE a saved game, QUIT, or UNDO the last command?

>s
Please give one of the answers above.

Would you like to RESTART, RESTORE a saved game, QUIT, or UNDO the last command?

>get on top bunk
Please give one of the answers above.

Would you like to RESTART, RESTORE a saved game, QUIT, or UNDO the last command?

>replace screw
Please give one of the answers above.

Would you like to RESTART, RESTORE a saved game, QUIT, or UNDO the last command?

>get down
Please give one of the answers above.

Would you like to RESTART, RESTORE a saved game, QUIT, or UNDO the last command?

>open cabinet
Please give one of the answers above.

Would you like to RESTART, RESTORE a saved game, QUIT, or UNDO the last command?

>take beacon
Please give one of the answers above.

Would you like to RESTART, RESTORE a saved game, QUIT, or UNDO the last command?

>p
Please give one of the answers above.

Would you like to RESTART, RESTORE a saved game, QUIT, or UNDO the last command?

>p
Please give one of the answers above.

Would you like to RESTART, RESTORE a saved game, QUIT, or UNDO the last command?

>open cabinet
Please give one of the answers above.

Would you like to RESTART, RESTORE a saved game, QUIT, or UNDO the last command?

>x uniform
Please give one of the answers above.

Would you like to RESTART, RESTORE a saved game, QUIT, or UNDO the last command?

>take paper
Please give one of the answers above.

Would you like to RESTART, RESTORE a saved game, QUIT, or UNDO the last command?

>read it
Please give one of the answers above.

Would you like to RESTART, RESTORE a saved game, QUIT, or UNDO the last command?

>take universal game emulator
Please give one of the answers above.

Would you like to RESTART, RESTORE a saved game, QUIT, or UNDO the last command?

>x unit
Please give one of the answers above.

Would you like to RESTART, RESTORE a saved game, QUIT, or UNDO the last command?

>type 9467 on keypad
Please give one of the answers above.

Would you like to RESTART, RESTORE a saved game, QUIT, or UNDO the last command?

>pry bottom drawer open with knife
Please give one of the answers above.

Would you like to RESTART, RESTORE a saved game, QUIT, or UNDO the last command?

>take card
Please give one of the answers above.

Would you like to RESTART, RESTORE a saved game, QUIT, or UNDO the last command?

>close drawer
Please give one of the answers above.

Would you like to RESTART, RESTORE a saved game, QUIT, or UNDO the last command?

>put key into keyhole
Please give one of the answers above.

Would you like to RESTART, RESTORE a saved game, QUIT, or UNDO the last command?

>tape wires
Please give one of the answers above.

Would you like to RESTART, RESTORE a saved game, QUIT, or UNDO the last command?

>close bottom drawer
Please give one of the answers above.

Would you like to RESTART, RESTORE a saved game, QUIT, or UNDO the last command?

>type 9467 on keypad
Please give one of the answers above.

Would you like to RESTART, RESTORE a saved game, QUIT, or UNDO the last command?

>take planetfall
Please give one of the answers above.

Would you like to RESTART, RESTORE a saved game, QUIT, or UNDO the last command?

>play planetfall on universal
Please give one of the answers above.

Would you like to RESTART, RESTORE a saved game, QUIT, or UNDO the last command?

>z
Please give one of the answers above.

Would you like to RESTART, RESTORE a saved game, QUIT, or UNDO the last command?

>z
Please give one of the answers above.

Would you like to RESTART, RESTORE a saved game, QUIT, or UNDO the last command?

>s
Please give one of the answers above.

Would you like to RESTART, RESTORE a saved game, QUIT, or UNDO the last command?

>d
Please give one of the answers above.

Would you like to RESTART, RESTORE a saved game, QUIT, or UNDO the last command?

>turn over locker
Please give one of the answers above.

Would you like to RESTART, RESTORE a saved game, QUIT, or UNDO the last command?

>open locker
Please give one of the answers above.

Would you like to RESTART, RESTORE a saved game, QUIT, or UNDO the last command?

>a
Please give one of the answers above.

Would you like to RESTART, RESTORE a saved game, QUIT, or UNDO the last command?

* * *

>out
Please give one of the answers above.

Would you like to RESTART, RESTORE a saved game, QUIT, or UNDO the last command?

>tie eva transport line to hook
Please give one of the answers above.

Would you like to RESTART, RESTORE a saved game, QUIT, or UNDO the last command?

>f
Please give one of the answers above.

Would you like to RESTART, RESTORE a saved game, QUIT, or UNDO the last command?

>tie eva transport line to hook
Please give one of the answers above.

Would you like to RESTART, RESTORE a saved game, QUIT, or UNDO the last command?

>s
Please give one of the answers above.

Would you like to RESTART, RESTORE a saved game, QUIT, or UNDO the last command?

>tie eva transport line to hook
Please give one of the answers above.

Would you like to RESTART, RESTORE a saved game, QUIT, or UNDO the last command?

>p
Please give one of the answers above.

Would you like to RESTART, RESTORE a saved game, QUIT, or UNDO the last command?

>a
Please give one of the answers above.

Would you like to RESTART, RESTORE a saved game, QUIT, or UNDO the last command?

>in
Please give one of the answers above.

Would you like to RESTART, RESTORE a saved game, QUIT, or UNDO the last command?

>in
Please give one of the answers above.

Would you like to RESTART, RESTORE a saved game, QUIT, or UNDO the last command?

>turn off boots
Please give one of the answers above.

Would you like to RESTART, RESTORE a saved game, QUIT, or UNDO the last command?

>push jl-758 aft
Please give one of the answers above.

Would you like to RESTART, RESTORE a saved game, QUIT, or UNDO the last command?

>push jl-758 aft
Please give one of the answers above.

Would you like to RESTART, RESTORE a saved game, QUIT, or UNDO the last command?

>push jl-758 fore
Please give one of the answers above.

Would you like to RESTART, RESTORE a saved game, QUIT, or UNDO the last command?

>push jl-758 starboard
Please give one of the answers above.

Would you like to RESTART, RESTORE a saved game, QUIT, or UNDO the last command?

>push jl-758 in
Please give one of the answers above.

Would you like to RESTART, RESTORE a saved game, QUIT, or UNDO the last command?

>push jl-758 in
Please give one of the answers above.

Would you like to RESTART, RESTORE a saved game, QUIT, or UNDO the last command?

>push jl-758 aft
Please give one of the answers above.

Would you like to RESTART, RESTORE a saved game, QUIT, or UNDO the last command?

>f
Please give one of the answers above.

Would you like to RESTART, RESTORE a saved game, QUIT, or UNDO the last command?

>d
Please give one of the answers above.

Would you like to RESTART, RESTORE a saved game, QUIT, or UNDO the last command?

>a
Please give one of the answers above.

Would you like to RESTART, RESTORE a saved game, QUIT, or UNDO the last command?

>open door with red card
Please give one of the answers above.

Would you like to RESTART, RESTORE a saved game, QUIT, or UNDO the last command?

>x panel
Please give one of the answers above.

Would you like to RESTART, RESTORE a saved game, QUIT, or UNDO the last command?

>open panel
Please give one of the answers above.

Would you like to RESTART, RESTORE a saved game, QUIT, or UNDO the last command?

>take blown fuse
Please give one of the answers above.

Would you like to RESTART, RESTORE a saved game, QUIT, or UNDO the last command?

>put fuse in panel
Please give one of the answers above.

Would you like to RESTART, RESTORE a saved game, QUIT, or UNDO the last command?

>close panel
Please give one of the answers above.

Would you like to RESTART, RESTORE a saved game, QUIT, or UNDO the last command?

>close panel
Please give one of the answers above.

Would you like to RESTART, RESTORE a saved game, QUIT, or UNDO the last command?

>x panel
Please give one of the answers above.

Would you like to RESTART, RESTORE a saved game, QUIT, or UNDO the last command?

>put gum in hole
Please give one of the answers above.

Would you like to RESTART, RESTORE a saved game, QUIT, or UNDO the last command?

>close panel
Please give one of the answers above.

Would you like to RESTART, RESTORE a saved game, QUIT, or UNDO the last command?

>open door with red card
Please give one of the answers above.

Would you like to RESTART, RESTORE a saved game, QUIT, or UNDO the last command?

>a
Please give one of the answers above.

Would you like to RESTART, RESTORE a saved game, QUIT, or UNDO the last command?

>open drawer
Please give one of the answers above.

Would you like to RESTART, RESTORE a saved game, QUIT, or UNDO the last command?

>take journal
Please give one of the answers above.

Would you like to RESTART, RESTORE a saved game, QUIT, or UNDO the last command?

>read it
Please give one of the answers above.

Would you like to RESTART, RESTORE a saved game, QUIT, or UNDO the last command?

>journal, password walrus
Please give one of the answers above.

Would you like to RESTART, RESTORE a saved game, QUIT, or UNDO the last command?

>journal, password charon
Please give one of the answers above.

Would you like to RESTART, RESTORE a saved game, QUIT, or UNDO the last command?

>read journal
Please give one of the answers above.

Would you like to RESTART, RESTORE a saved game, QUIT, or UNDO the last command?

>f
Please give one of the answers above.

Would you like to RESTART, RESTORE a saved game, QUIT, or UNDO the last command?

* * *

>u
Please give one of the answers above.

Would you like to RESTART, RESTORE a saved game, QUIT, or UNDO the last command?

>z
Please give one of the answers above.

Would you like to RESTART, RESTORE a saved game, QUIT, or UNDO the last command?

>hello
Please give one of the answers above.

Would you like to RESTART, RESTORE a saved game, QUIT, or UNDO the last command?

>tell caller about me
Please give one of the answers above.

Would you like to RESTART, RESTORE a saved game, QUIT, or UNDO the last command?

>yes
Please give one of the answers above.

Would you like to RESTART, RESTORE a saved game, QUIT, or UNDO the last command?

>hello
Please give one of the answers above.

Would you like to RESTART, RESTORE a saved game, QUIT, or UNDO the last command?

>tell arvax about journal
Please give one of the answers above.

Would you like to RESTART, RESTORE a saved game, QUIT, or UNDO the last command?

>computer, access code 2
Please give one of the answers above.

Would you like to RESTART, RESTORE a saved game, QUIT, or UNDO the last command?

>computer, reboot
Please give one of the answers above.

Would you like to RESTART, RESTORE a saved game, QUIT, or UNDO the last command?

>z
Please give one of the answers above.

Would you like to RESTART, RESTORE a saved game, QUIT, or UNDO the last command?

>ask arvax about card
Please give one of the answers above.

Would you like to RESTART, RESTORE a saved game, QUIT, or UNDO the last command?

* * *

>ask arvax about engine
Please give one of the answers above.

Would you like to RESTART, RESTORE a saved game, QUIT, or UNDO the last command?

>ask arvax about fuel
Please give one of the answers above.

Would you like to RESTART, RESTORE a saved game, QUIT, or UNDO the last command?

* * *

>x line
The EVA transport line is a strong rope, maybe 16 meters long. It has a hook at either end. One extends the line between two or more points, and then transits the payload along it.

* * *

>s
Junction
This is a busy place when the ship is populated. To port and starboard are the crew quarters, aft is the closed door to the captain's private quarters, and fore is the galley. A ladder leads down to the staging area.

>f
Galley
This narrow space is barely enough room for two Marines to prepare and eat a meal. There is a counter with a drawer, and two stools, a microwave oven, and a large closet here. Pots and pans hang from hooks in the ceiling. A ladder leads up through the midship door, and you can leave aft.

On the starboard wall is a panel on which is a blue button. Tacked to the panel is the operator's manual for the midship door.

You hear someone speaking above.

>u
Operations Deck
This is where all of the support activity for the bridge occurs. There are large consoles for environmental controls, communications, and power systems here. The bridge continues forward from here, and engineering is aft. There is a door set in the floor with a ladder leading through it. Set in the frame of the door is a blue button.

You can see an equipment trunk (closed) here.

>a
Engineering Deck
The engineering crew is responsible for keeping the physical ship operating. They are in charge of every physical aspect of the ship, from the engines to hull integrity to the life support system.

The engineering deck consists of a large console giving a comprehensive view of the physical status of the ship. There is an airlock to starboard. The operations deck continues forward from here, and there are other exits to aft and port.

A device labeled "Suit Recharging Station" is here. It is shaped like a chair with nozzles protruding from either arm.

You hear someone speaking forward of here.

>a
Engine Room
This where the combustion process is controlled. The aft wall is dominated by the operating panel of the fusion engine. Monitoring electronics and controls cover the other two walls. A doorway opens forward to the Engineering Deck.

There is a large screen on the forward wall. It displays nothing right now. There is a large button below the diagram labeled "Test".

>x diagram
The diagram screen is black.

>computer, access code 2
Welcome, caller. Logging you in.

>computer, reboot
Beginning reboot. Take all appropriate precautions.

Red alert lights flash throughout the ship.

>z
Time passes.

>x diagram
The diagram screen is black.

Reboot complete.

>x diagram
This is a diagram of the fuel injection process for the fusion engine. Printed above it is the label "Delphi Engine Controls Aleph-Null". Below that is a representation of the various inputs and the products created during the fuel injection process. Each input has a touch-sensitive surface which can be used to alter the diagram's settings.

       Input: 2 --  3 --  4 --
                ||    ||    ||
             ===vv====vv====vv===
Input 1:     -- >> -- >> -- >> --  Output
             ====================

        FUEL INJECTION SPECIFICATION INCOMPLETE

Key:    --   empty input or output
        AH   Anti-Helium
        LC   Liquid Copernicium*
        Og   Oganesson
        RM   Red Matter            
        TC   Tachyon Crystals
        Un   Unobtainium
        VM   Void Matter*

        * this substance can only be produced, not input.

⇒ Use "substance > input" to set each input. For instance, "Un > 3" sets input 3 to Unobtainium. You may also use "set <input> to <substance>" for the same effect. Use "disconnect <input>" to disconnect an input.

>Un > 1
This is a diagram of the fuel injection process for the fusion engine. Printed above it is the label "Delphi Engine Controls Aleph-Null". Below that is a representation of the various inputs and the products created during the fuel injection process. Each input has a touch-sensitive surface which can be used to alter the diagram's settings.

       Input: 2 --  3 --  4 --
                ||    ||    ||
             ===vv====vv====vv===
Input 1:     Un >> -- >> -- >> --  Output
             ====================

        FUEL INJECTION SPECIFICATION INCOMPLETE

Key:    --   empty input or output
        AH   Anti-Helium
        LC   Liquid Copernicium*
        Og   Oganesson
        RM   Red Matter            
        TC   Tachyon Crystals
        Un   Unobtainium
        VM   Void Matter*

        * this substance can only be produced, not input.

>Og > 2
This is a diagram of the fuel injection process for the fusion engine. Printed above it is the label "Delphi Engine Controls Aleph-Null". Below that is a representation of the various inputs and the products created during the fuel injection process. Each input has a touch-sensitive surface which can be used to alter the diagram's settings.

       Input: 2 Og  3 --  4 --
                ||    ||    ||
             ===vv====vv====vv===
Input 1:     Un >> -- >> -- >> --  Output
             ====================

        FUEL INJECTION SPECIFICATION INCOMPLETE

Key:    --   empty input or output
        AH   Anti-Helium
        LC   Liquid Copernicium*
        Og   Oganesson
        RM   Red Matter            
        TC   Tachyon Crystals
        Un   Unobtainium
        VM   Void Matter*

        * this substance can only be produced, not input.

>Og > 1
This is a diagram of the fuel injection process for the fusion engine. Printed above it is the label "Delphi Engine Controls Aleph-Null". Below that is a representation of the various inputs and the products created during the fuel injection process. Each input has a touch-sensitive surface which can be used to alter the diagram's settings.

       Input: 2 Og  3 --  4 --
                ||    ||    ||
             ===vv====vv====vv===
Input 1:     Og >> -- >> -- >> --  Output
             ====================

        FUEL INJECTION SPECIFICATION INCOMPLETE

Key:    --   empty input or output
        AH   Anti-Helium
        LC   Liquid Copernicium*
        Og   Oganesson
        RM   Red Matter            
        TC   Tachyon Crystals
        Un   Unobtainium
        VM   Void Matter*

        * this substance can only be produced, not input.

>Un > 2
This is a diagram of the fuel injection process for the fusion engine. Printed above it is the label "Delphi Engine Controls Aleph-Null". Below that is a representation of the various inputs and the products created during the fuel injection process. Each input has a touch-sensitive surface which can be used to alter the diagram's settings.

       Input: 2 Un  3 --  4 --
                ||    ||    ||
             ===vv====vv====vv===
Input 1:     Og >> -- >> -- >> --  Output
             ====================

        FUEL INJECTION SPECIFICATION INCOMPLETE

Key:    --   empty input or output
        AH   Anti-Helium
        LC   Liquid Copernicium*
        Og   Oganesson
        RM   Red Matter            
        TC   Tachyon Crystals
        Un   Unobtainium
        VM   Void Matter*

        * this substance can only be produced, not input.

>Rm > 2
This is a diagram of the fuel injection process for the fusion engine. Printed above it is the label "Delphi Engine Controls Aleph-Null". Below that is a representation of the various inputs and the products created during the fuel injection process. Each input has a touch-sensitive surface which can be used to alter the diagram's settings.

       Input: 2 RM  3 --  4 --
                ||    ||    ||
             ===vv====vv====vv===
Input 1:     Og >> -- >> -- >> --  Output
             ====================

        FUEL INJECTION SPECIFICATION INCOMPLETE

Key:    --   empty input or output
        AH   Anti-Helium
        LC   Liquid Copernicium*
        Og   Oganesson
        RM   Red Matter            
        TC   Tachyon Crystals
        Un   Unobtainium
        VM   Void Matter*

        * this substance can only be produced, not input.

>og > 4
This is a diagram of the fuel injection process for the fusion engine. Printed above it is the label "Delphi Engine Controls Aleph-Null". Below that is a representation of the various inputs and the products created during the fuel injection process. Each input has a touch-sensitive surface which can be used to alter the diagram's settings.

       Input: 2 RM  3 --  4 Og
                ||    ||    ||
             ===vv====vv====vv===
Input 1:     Og >> -- >> -- >> --  Output
             ====================

        FUEL INJECTION SPECIFICATION INCOMPLETE

Key:    --   empty input or output
        AH   Anti-Helium
        LC   Liquid Copernicium*
        Og   Oganesson
        RM   Red Matter            
        TC   Tachyon Crystals
        Un   Unobtainium
        VM   Void Matter*

        * this substance can only be produced, not input.

>tc > 3
This is a diagram of the fuel injection process for the fusion engine. Printed above it is the label "Delphi Engine Controls Aleph-Null". Below that is a representation of the various inputs and the products created during the fuel injection process. Each input has a touch-sensitive surface which can be used to alter the diagram's settings.

       Input: 2 RM  3 TC  4 Og
                ||    ||    ||
             ===vv====vv====vv===
Input 1:     Og >> -- >> -- >> --  Output
             ====================

        FUEL INJECTION SPECIFICATION INCOMPLETE

Key:    --   empty input or output
        AH   Anti-Helium
        LC   Liquid Copernicium*
        Og   Oganesson
        RM   Red Matter            
        TC   Tachyon Crystals
        Un   Unobtainium
        VM   Void Matter*

        * this substance can only be produced, not input.

>ah > 2
This is a diagram of the fuel injection process for the fusion engine. Printed above it is the label "Delphi Engine Controls Aleph-Null". Below that is a representation of the various inputs and the products created during the fuel injection process. Each input has a touch-sensitive surface which can be used to alter the diagram's settings.

       Input: 2 AH  3 TC  4 Og
                ||    ||    ||
             ===vv====vv====vv===
Input 1:     Og >> Un >> RM >> LC  Output
             ====================

        FUEL INJECTION SPECIFICATION VALID

Key:    --   empty input or output
        AH   Anti-Helium
        LC   Liquid Copernicium*
        Og   Oganesson
        RM   Red Matter            
        TC   Tachyon Crystals
        Un   Unobtainium
        VM   Void Matter*

        * this substance can only be produced, not input.

It seems you completed something ("adjust fuel injection specification") that wasn't on your to-do list. You note it down.

[Your score has just gone up by one point.]

>n
I'm not sure what you're trying to say. I might just not recognize the words you're using.

>f
Engineering Deck
The engineering crew is responsible for keeping the physical ship operating. They are in charge of every physical aspect of the ship, from the engines to hull integrity to the life support system.

The engineering deck consists of a large console giving a comprehensive view of the physical status of the ship. There is an airlock to starboard. The operations deck continues forward from here, and there are other exits to aft and port.

A device labeled "Suit Recharging Station" is here. It is shaped like a chair with nozzles protruding from either arm.

>f
Operations Deck
This is where all of the support activity for the bridge occurs. There are large consoles for environmental controls, communications, and power systems here. The bridge continues forward from here, and engineering is aft. There is a door set in the floor with a ladder leading through it. Set in the frame of the door is a blue button.

You can see an equipment trunk (closed) here.

caller: "You there, Usagi? We don't have much time."

>ask caller about engine
(the fusion engine)
"You're back! Great job rebooting the computer -- I'm getting telemetry now.

"It looks like you need to replace the engine stabilizer. It's the kind of thing you might have on board."

>set gravity to 1
You got it. Physics has been changed at your whim.

>purloin new jl-758
[Purloined.]

>a
Engineering Deck
The engineering crew is responsible for keeping the physical ship operating. They are in charge of every physical aspect of the ship, from the engines to hull integrity to the life support system.

The engineering deck consists of a large console giving a comprehensive view of the physical status of the ship. There is an airlock to starboard. The operations deck continues forward from here, and there are other exits to aft and port.

A device labeled "Suit Recharging Station" is here. It is shaped like a chair with nozzles protruding from either arm.

You hear someone speaking forward of here.

>drop it
The suit recharging station is already here.

>drop jl-758
Dropped.

You hear someone speaking forward of here.

>push it aft
You push the brand-new JL-758 to Engine Room.

You slide the old part out from the engine, and slide the new JL-758 in its place.

Engine Room
This where the combustion process is controlled. The aft wall is dominated by the operating panel of the fusion engine. Monitoring electronics and controls cover the other two walls. A doorway opens forward to the Engineering Deck.

There is a large diagram of the fuel injection process on the forward wall. There is a large button below the diagram labeled "Test".

You can see a broken JL-758 here.

It seems you completed something ("fix the engine") that wasn't on your to-do list. You note it down.

[Your score has just gone up by one point.]

>f
Engineering Deck
The engineering crew is responsible for keeping the physical ship operating. They are in charge of every physical aspect of the ship, from the engines to hull integrity to the life support system.

The engineering deck consists of a large console giving a comprehensive view of the physical status of the ship. There is an airlock to starboard. The operations deck continues forward from here, and there are other exits to aft and port.

A device labeled "Suit Recharging Station" is here. It is shaped like a chair with nozzles protruding from either arm.

You hear someone speaking forward of here.

>f
Operations Deck
This is where all of the support activity for the bridge occurs. There are large consoles for environmental controls, communications, and power systems here. The bridge continues forward from here, and engineering is aft. There is a door set in the floor with a ladder leading through it. Set in the frame of the door is a blue button.

You can see an equipment trunk (closed) here.

>ask arvax about engine
(the fusion engine)
"I'm seeing the engine fully online."

"Looks like the ship is ready to fly! Quick! Get to the bridge and use the command console! Say 'computer, execute'"
[Not much time!]

"Impact in 9."

>f
Bridge
This is where the captain, navigator, and pilot all sit. Large viewscreens give a full view of the space around the ship. To port you can see the huge blue-white disk of Deneb. Ahead, the moon New Da Nang looms steadily larger and larger before you.

 The pilot's and navigator's chairs sit before their respective consoles. The captain's chair, with command console, sits halfway between them and operations further aft.

"Impact in 8."

The moon of New Da Nang looms ever larger on the forward viewscreen.

>touch console
(the Universal Game Emulator)
You feel nothing unexpected.

"Impact in 7."

The moon of New Da Nang looms ever larger on the forward viewscreen.

>touch command console
Welcome, Captain. What are your orders?
"Impact in 6."

The moon of New Da Nang looms ever larger on the forward viewscreen.

>computer, execute
Yes, Captain. Executing evasive maneuvers.

The ship pulls out of its dive toward New Da Nang, delivering a g-force that forces the breath out of you despite the intertial dampers. Soon you are turned around and headed for open space.

Diverting communications to the bridge.

Arvax comes over comms: "Diverting SS Usagi to Deneb III. Rendezvous with retrieval crew in approximately twenty-eight minutes.

"Sergeant Screwdriver, this couldn't have happened without you. You deserve to be a hero on New Da Nang, but unfortunately we need to keep this incident secret, as will no doubt be emphasized at your debriefing.

"You are to be especially commended for your judgment in determining the correct course of action when presented with a difficult choice. We have determined that Captain Mulgrew has been working with the separatists and was involved in the Omicron-5 bombing. She has been apprehended and will face the most severe justice permitted by the Space Authority.

"Now, soldier, time to relax. The crew will be there soon to pick you up."

You relax in the captain's chair and reflect on your accomplishment. When you get to the Deneb III space platform, you are whisked off for a series of debriefings and meetings.

At the end of the day, you can barely sleep, as the newest member of the 95th Mechanical Division Special Maintenance Force. Adventure at last!

    *** You have saved New Da Nang, the SS Usagi, and yourself! ***

In that game you scored 9 out of a possible 10, in 107 turns.

For your heroism in the face of almost certain death, we award you one point each for:
- fixing the aft airlock door
- fixing the microwave oven
- fixing the equipment cabinet in the starboard-side crew quarters
- fixing the storage unit in the port-side crew quarters
- adjusting the fuel injection specification correctly
- fixing the fusion engine

Additionally! We hereby award you one point for saving the SS Usagi, another point for saving yourself, and finally one more point for saving the moon New Da Nang! Congratulations!

Would you like to RESTART, RESTORE a saved game, QUIT, or UNDO the last command?

* * *

>put gum in hole
(first taking the chewing gum)
You can't reach the gum with the vac suit on top of your uniform.

>i
You are carrying:
  a blown fuse
  a knife
  a hex-shaped tool
  a roll of electrical tape
  a small key
  a portable hand-held vacuum cleaner
  a broken sensor
  Bertie the Bear™
  some pair of slippers
  a vac suit (being worn)
  a To-Do list
  a repair corps uniform (being worn) with chewing gum stuck to it
  a toolbox

>take off vac suit
You take off the vac suit.

The boots are now switched off.

>put gum in hole
(first taking the chewing gum)
That can't contain things.

>i
You are carrying:
  some chewing gum
  a blown fuse
  a knife
  a hex-shaped tool
  a roll of electrical tape
  a small key
  a portable hand-held vacuum cleaner
  a broken sensor
  Bertie the Bear™
  some pair of slippers
  a vac suit
  a To-Do list
  a repair corps uniform (being worn) with chewing gum stuck to it
  a toolbox

* * *

>put gum in hole
(first taking the chewing gum)
You can't reach the gum with the vac suit on top of your uniform.

You push the gum into the hole.
[I hope this works.]

* * *

>i
You are carrying:
  a blown fuse
  a knife
  a hex-shaped tool
  a roll of electrical tape
  a small key
  a portable hand-held vacuum cleaner
  a broken sensor
  Bertie the Bear™
  some pair of slippers
  a vac suit (being worn)
  a To-Do list
  a repair corps uniform (being worn) with chewing gum stuck to it
  a toolbox

>remove suit
You take off the vac suit.

The boots are now switched off.

>put gum in hole
(first taking the chewing gum)
Taken.

You push the gum into the hole.
[I hope this works.]

>i
You are carrying:
  a blown fuse
  a knife
  a hex-shaped tool
  a roll of electrical tape
  a small key
  a portable hand-held vacuum cleaner
  a broken sensor
  Bertie the Bear™
  some pair of slippers
  a vac suit
  a To-Do list
  a repair corps uniform (being worn) with chewing gum stuck to it
  a toolbox

* * *

>a
Engineering Deck
The engineering crew is responsible for keeping the physical ship operating. They are in charge of every physical aspect of the ship, from the engines to hull integrity to the life support system.

The engineering deck consists of a large console giving a comprehensive view of the physical status of the ship. There is an airlock to starboard. The operations deck continues forward from here, and there are other exits to aft and port.

A device labeled "Suit Recharging Station" is here. It is shaped like a chair with nozzles protruding from either arm.

* * *

>a
Engine Room
This where the combustion process is controlled. The aft wall is dominated by the operating panel of the fusion engine. Monitoring electronics and controls cover the other two walls. A doorway opens forward to the Engineering Deck.

There is a large diagram of the fuel injection process on the forward wall. There is a large button below the diagram labeled "Test".

You can see a broken JL-758 here.

>attach line to hook
You attach the EVA transport line to the hook.
[One...]

Your vac suit pings gently to indicate you have expended a unit of air.

>f
Hull of the Usagi (vacuum)
Here the path runs aft to the aft airlock and starboard to the engineering airlock. Where there used to be a large embedded chunk of debris blocking the path, now there is a scattering of rubble.

There is a hook set in the hull here.

You are holding one end of the EVA transport line, which runs aft from here.

Your vac suit pings gently to indicate you have expended a unit of air.

>attach line to hook
You attach the EVA transport line to the hook.
[Two...]

Your vac suit pings gently to indicate you have expended a unit of air.

>s
Outside the Engineering Airlock (vacuum)
You are standing on the hull of the ship, outside the engineering airlock, secured by your vac suit's mag boots. Most of the hull is taken up by the protrusions of various machinery, antennae, radio dishes, and heat sinks. There is a clear path to port among the obstructions. You can also go in to the airlock.

A hook protrudes from the hull next to the airlock door.

You're holding one end of the EVA transport line, which runs to port from here.

Your vac suit pings gently to indicate you have expended a unit of air.

>attach line to hook
You make the final attachment, letting go of the EVA transport line.
[Three! That was a bit of work. Hope it's useful.]

Your vac suit pings gently to indicate you have expended a unit of air.

>p
Hull of the Usagi (vacuum)
Here the path runs aft to the aft airlock and starboard to the engineering airlock. Where there used to be a large embedded chunk of debris blocking the path, now there is a scattering of rubble.

There is a hook set in the hull here.

The EVA transport line is attached to the hook, and extends aft and starboard from here.

Your vac suit pings gently to indicate you have expended a unit of air.

>a
Outside the Aft Airlock (vacuum)
You are standing on the hull of the ship, outside the aft airlock, secured by your vac suit's mag boots. Most of the hull is taken up by the protrusions of various machinery, antennae, radio dishes, and heat sinks. There is a clear path to fore among the obstructions. You can also go in to the airlock.

A hook protrudes from the hull next to the airlock door.

The EVA transport line is attached to the hook, and from there runs forward.

Your vac suit pings gently to indicate you have expended a unit of air.

>in
Aft Airlock
You are in the aft airlock. Outside is the blackness of space, speckled with the dying embers of what was once Space Station Omicron-5. Forward leads into the ship.

>in
Staging Area
This is the staging area of the ship, where marines prepare for missions. It is adjacent to the aft airlock. Locked compartments set into the walls hold various munitions. A ladder leads up into the rest of the ship. 

An equipment locker is sprawled across the room. It has been turned door-side up. It is open and contains four banged-up vac suits.
 
Through the airlock windows you see the blank space left by the destruction of Space Station Omicron-5.

What looks like part of an engine is stowed in a corner.

There is an air scrubber intake in the wall here.

You can also see a black trunk (closed) here.

>push engine a
You push the JL-758 to Aft Airlock.

Aft Airlock
You are in the aft airlock. Outside is the blackness of space, speckled with the dying embers of what was once Space Station Omicron-5. Forward leads into the ship.

You can see a JL-758 here.

>g
You clip the JL-758 to the EVA transport line.

You push the JL-758 to Outside the Aft Airlock (vacuum).

Outside the Aft Airlock (vacuum)
You are standing on the hull of the ship, outside the aft airlock, secured by your vac suit's mag boots. Most of the hull is taken up by the protrusions of various machinery, antennae, radio dishes, and heat sinks. There is a clear path to fore among the obstructions. You can also go in to the airlock.

A hook protrudes from the hull next to the airlock door.

The JL-758 is floating here, clipped to the EVA transport line.

The EVA transport line is attached to the hook, and from there runs forward.

Your vac suit pings gently to indicate you have expended a unit of air.

>f
Hull of the Usagi (vacuum)
Here the path runs aft to the aft airlock and starboard to the engineering airlock. Where there used to be a large embedded chunk of debris blocking the path, now there is a scattering of rubble.

There is a hook set in the hull here.

The EVA transport line is attached to the hook, and extends aft and starboard from here.

Your vac suit pings gently to indicate you have expended a unit of air.

>s
Outside the Engineering Airlock (vacuum)
You are standing on the hull of the ship, outside the engineering airlock, secured by your vac suit's mag boots. Most of the hull is taken up by the protrusions of various machinery, antennae, radio dishes, and heat sinks. There is a clear path to port among the obstructions. You can also go in to the airlock.

A hook protrudes from the hull next to the airlock door.

The EVA transport line is attached to the hook, and from there runs to port.

Your vac suit pings gently to indicate you have expended a unit of air.

>in
Engineering Airlock
You are in the engineering airlock. Outside, the space to starboard looks so empty and peaceful it's hard to imagine the awful sight astern.

>undo
Outside the Engineering Airlock (vacuum)
[Previous turn undone.]

>undo
Hull of the Usagi (vacuum)
[Previous turn undone.]

>undo
Outside the Aft Airlock (vacuum)
[Previous turn undone.]

>push engine f
You push the JL-758 to Hull of the Usagi (vacuum).

Hull of the Usagi (vacuum)
Here the path runs aft to the aft airlock and starboard to the engineering airlock. Where there used to be a large embedded chunk of debris blocking the path, now there is a scattering of rubble.

There is a hook set in the hull here.

The JL-758 is floating here, clipped to the EVA transport line.

The EVA transport line is attached to the hook, and extends aft and starboard from here.

Your vac suit pings gently to indicate you have expended a unit of air.

>push it s
You push the JL-758 to Outside the Engineering Airlock (vacuum).

Outside the Engineering Airlock (vacuum)
You are standing on the hull of the ship, outside the engineering airlock, secured by your vac suit's mag boots. Most of the hull is taken up by the protrusions of various machinery, antennae, radio dishes, and heat sinks. There is a clear path to port among the obstructions. You can also go in to the airlock.

A hook protrudes from the hull next to the airlock door.

The JL-758 is floating here, clipped to the EVA transport line.

The EVA transport line is attached to the hook, and from there runs to port.

Your vac suit pings gently to indicate you have expended a unit of air.

>push it in
You unclip the JL-758 from the EVA transport line.

You push the JL-758 to Engineering Airlock.

Engineering Airlock
You are in the engineering airlock. Outside, the space to starboard looks so empty and peaceful it's hard to imagine the awful sight astern.

You can see a JL-758 here.

>push it p
You push the JL-758 to Engineering Deck.

Engineering Deck
The engineering crew is responsible for keeping the physical ship operating. They are in charge of every physical aspect of the ship, from the engines to hull integrity to the life support system.

The engineering deck consists of a large console giving a comprehensive view of the physical status of the ship. There is an airlock to starboard. The operations deck continues forward from here, and there are other exits to aft and port.

A device labeled "Suit Recharging Station" is here. It is shaped like a chair with nozzles protruding from either arm.

You can also see a JL-758 here.

>push it a
The suit recharging station cannot be pushed from place to place.

You hear someone speaking forward of here.

>push engine a
You push the JL-758 to Engine Room.

You slide the old part out from the engine, and slide the new JL-758 in its place.

Engine Room
This where the combustion process is controlled. The aft wall is dominated by the operating panel of the fusion engine. Monitoring electronics and controls cover the other two walls. A doorway opens forward to the Engineering Deck.

There is a large screen on the forward wall. It displays nothing right now. There is a large button below the diagram labeled "Test".

You can see a broken JL-758 here.

You cross out an item ("fix the engine") on your to-do list.

[Your score has just gone up by one point.]

>read list
You have finished the following: fix the airlock door, fix the microwave, fix the storage unit, fix the captain's door, fix the cabinet, and fix the engine.

>computer, reboot
Beginning reboot. Take all appropriate precautions.

Red alert lights flash throughout the ship.

>f
Engineering Deck
The engineering crew is responsible for keeping the physical ship operating. They are in charge of every physical aspect of the ship, from the engines to hull integrity to the life support system.

The engineering deck consists of a large console giving a comprehensive view of the physical status of the ship. There is an airlock to starboard. The operations deck continues forward from here, and there are other exits to aft and port.

A device labeled "Suit Recharging Station" is here. It is shaped like a chair with nozzles protruding from either arm.

>f
Operations Deck
This is where all of the support activity for the bridge occurs. There are large consoles for environmental controls, communications, and power systems here. The bridge continues forward from here, and engineering is aft. There is a door set in the floor with a ladder leading through it. Set in the frame of the door is a blue button.

You can see an equipment trunk (closed) here.

>ask arvax about ship
You can't see any such thing.

>z
Time passes.

>z
Time passes.

Reboot complete.

>ask arvax about ship
(the SS Usagi)
"You're back! Great job rebooting the computer -- I'm getting telemetry now.

"The only thing we time to focus on is the ship!

"I'm trying to divert the ship from its collision course with New Da Nang, but there's a problem: the fuel injection specification for the fusion engine is incorrect.

You add an item ("adjust fuel injection specification") to your to-do list.

* * *

>a
Engine Room
This where the combustion process is controlled. The aft wall is dominated by the operating panel of the fusion engine. Monitoring electronics and controls cover the other two walls. A doorway opens forward to the Engineering Deck.

There is a large diagram of the fuel injection process on the forward wall. There is a large button below the diagram labeled "Test".

You can see a broken JL-758 here.

>x diagram
This is a diagram of the fuel injection process for the fusion engine. Printed above it is the label "Delphi Engine Controls Aleph-Null". Below that is a representation of the various inputs and the products created during the fuel injection process. Each input has a touch-sensitive surface which can be used to alter the diagram's settings.

       Input: 2 --  3 --  4 --
                ||    ||    ||
             ===vv====vv====vv===
Input 1:     -- >> -- >> -- >> --  Output
             ====================

        FUEL INJECTION SPECIFICATION INCOMPLETE

Key:    --   empty input or output
        AH   Anti-Helium
        LC   Liquid Copernicium*
        Og   Oganesson
        RM   Red Matter            
        TC   Tachyon Crystals
        Un   Unobtainium
        VM   Void Matter*

        * this substance can only be produced, not input.

⇒ Use "substance > input" to set each input. For instance, "Un > 3" sets input 3 to Unobtainium. You may also use "set <input> to <substance>" for the same effect. Use "disconnect <input>" to disconnect an input.

>ask computer about LC
Liquid Copernicium is the liquid form of the element Copernicium. It is a common starship fuel. It can be created by injecting Oganesson into Red Matter.

>Og > 4
This is a diagram of the fuel injection process for the fusion engine. Printed above it is the label "Delphi Engine Controls Aleph-Null". Below that is a representation of the various inputs and the products created during the fuel injection process. Each input has a touch-sensitive surface which can be used to alter the diagram's settings.

       Input: 2 --  3 --  4 Og
                ||    ||    ||
             ===vv====vv====vv===
Input 1:     -- >> -- >> -- >> --  Output
             ====================

        FUEL INJECTION SPECIFICATION INCOMPLETE

Key:    --   empty input or output
        AH   Anti-Helium
        LC   Liquid Copernicium*
        Og   Oganesson
        RM   Red Matter            
        TC   Tachyon Crystals
        Un   Unobtainium
        VM   Void Matter*

        * this substance can only be produced, not input.

>ask computer about red matter
Red Matter is an unstable, possibly impossible substance created by injecting Tachyon Crystals into Unobtainium.

>TC > 3
This is a diagram of the fuel injection process for the fusion engine. Printed above it is the label "Delphi Engine Controls Aleph-Null". Below that is a representation of the various inputs and the products created during the fuel injection process. Each input has a touch-sensitive surface which can be used to alter the diagram's settings.

       Input: 2 --  3 TC  4 Og
                ||    ||    ||
             ===vv====vv====vv===
Input 1:     -- >> -- >> -- >> --  Output
             ====================

        FUEL INJECTION SPECIFICATION INCOMPLETE

Key:    --   empty input or output
        AH   Anti-Helium
        LC   Liquid Copernicium*
        Og   Oganesson
        RM   Red Matter            
        TC   Tachyon Crystals
        Un   Unobtainium
        VM   Void Matter*

        * this substance can only be produced, not input.

>ask computer about unobtainium
Unobtanium can only be acquired by the injection of Anti-Helium into Oganesson, hence its legendary reputation for being difficult to obtain.

>AH > 2
This is a diagram of the fuel injection process for the fusion engine. Printed above it is the label "Delphi Engine Controls Aleph-Null". Below that is a representation of the various inputs and the products created during the fuel injection process. Each input has a touch-sensitive surface which can be used to alter the diagram's settings.

       Input: 2 AH  3 TC  4 Og
                ||    ||    ||
             ===vv====vv====vv===
Input 1:     -- >> -- >> -- >> --  Output
             ====================

        FUEL INJECTION SPECIFICATION INCOMPLETE

Key:    --   empty input or output
        AH   Anti-Helium
        LC   Liquid Copernicium*
        Og   Oganesson
        RM   Red Matter            
        TC   Tachyon Crystals
        Un   Unobtainium
        VM   Void Matter*

        * this substance can only be produced, not input.

>Og > 1
This is a diagram of the fuel injection process for the fusion engine. Printed above it is the label "Delphi Engine Controls Aleph-Null". Below that is a representation of the various inputs and the products created during the fuel injection process. Each input has a touch-sensitive surface which can be used to alter the diagram's settings.

       Input: 2 AH  3 TC  4 Og
                ||    ||    ||
             ===vv====vv====vv===
Input 1:     Og >> Un >> RM >> LC  Output
             ====================

        FUEL INJECTION SPECIFICATION VALID

Key:    --   empty input or output
        AH   Anti-Helium
        LC   Liquid Copernicium*
        Og   Oganesson
        RM   Red Matter            
        TC   Tachyon Crystals
        Un   Unobtainium
        VM   Void Matter*

        * this substance can only be produced, not input.

You cross out an item ("adjust fuel injection specification") on your to-do list.

[Your score has just gone up by one point.]

* * *

>a
Engineering Deck
The engineering crew is responsible for keeping the physical ship operating. They are in charge of every physical aspect of the ship, from the engines to hull integrity to the life support system.

The engineering deck consists of a large console giving a comprehensive view of the physical status of the ship. There is an airlock to starboard. The operations deck continues forward from here, and there are other exits to aft and port.

A device labeled "Suit Recharging Station" is here. It is shaped like a chair with nozzles protruding from either arm.

>x desk
(the captain's desk)
The Captain's desk is a simple institutional metal desk with a single drawer,  which is closed. On the desk are two framed photos, one of a dog, who by his tag must be named "Pluto", and another of an astronaut planting a flag on Earth's moon.

>x dog
Pluto is a beagle with a wise, knowing look on his face.
[Cute dog.]

>x moon
The iconic photo of Neil Armstrong standing next to the American flag.

>open drawer
You open the desk drawer, revealing the captain's journal.

>take journal
Taken.

>read it
The captain's journal is an electronic diary which requires a password to open.
⇒ For example, say "journal, password walrus" to unlock the journal with the password "walrus".

>journal, password walrus
The journal beeps once to indicate an invalid login.

>ask computer about pluto
Once considered the ninth planet, Pluto is now considered a dwarf planet. Along with many of the trans-Neptunian dwarf planets, Pluto is part of the solar system's defensive "early warning" system, with a listening post on its largest moon, Charon.

>journal, password charon
The journal chimes pleasantly and the screen fills with text.

* * *

>ask arvax about ship
You can't see any such thing.

* * *

>f
Engineering Deck
The engineering crew is responsible for keeping the physical ship operating. They are in charge of every physical aspect of the ship, from the engines to hull integrity to the life support system.

The engineering deck consists of a large console giving a comprehensive view of the physical status of the ship. There is an airlock to starboard. The operations deck continues forward from here, and there are other exits to aft and port.

A device labeled "Suit Recharging Station" is here. It is shaped like a chair with nozzles protruding from either arm.

* * *

>f
Operations Deck
This is where all of the support activity for the bridge occurs. There are large consoles for environmental controls, communications, and power systems here. The bridge continues forward from here, and engineering is aft. There is a door set in the floor with a ladder leading through it. Set in the frame of the door is a blue button.

You can see an equipment trunk (closed) here.

Master Sergeant R. Mu Arvax: "You there, Usagi? We don't have much time."

>ask arvax about ship
(the SS Usagi)
"The only thing we have time to focus on is the ship!

"Looks like the ship is ready to fly! Quick! Get to the bridge and use the command console! Say 'computer, execute'"
[Not much time!]

"Impact in 9."

>f
Bridge
This is where the captain, navigator, and pilot all sit. Large viewscreens give a full view of the space around the ship. To port you can see the huge blue-white disk of Deneb. Ahead, the moon New Da Nang looms steadily larger and larger before you.

 The pilot's and navigator's chairs sit before their respective consoles. The captain's chair, with command console, sits halfway between them and operations further aft.

"Impact in 8."

The moon of New Da Nang looms ever larger on the forward viewscreen.

>x command console
The command console displays the red outline of a hand.

⇒ You can "touch command console" to touch your palm to it.

"Impact in 7."

The moon of New Da Nang looms ever larger on the forward viewscreen.

>touch it
Welcome, Captain. What are your orders?
"Impact in 6."

The moon of New Da Nang looms ever larger on the forward viewscreen.

>computer, execute
Yes, Captain. Executing evasive maneuvers.

The ship pulls out of its dive toward New Da Nang, delivering a g-force that forces the breath out of you despite the intertial dampers. Soon you are turned around and headed for open space.

Diverting communications to the bridge.

Arvax comes over comms: "Diverting SS Usagi to Deneb III. Rendezvous with retrieval crew in approximately twenty-eight minutes.

"Sergeant Screwdriver, this couldn't have happened without you. You deserve to be a hero on New Da Nang, but unfortunately we need to keep this incident secret, as will no doubt be emphasized at your debriefing.

"You are to be especially commended for your judgment in determining the correct course of action when presented with a difficult choice. We have determined that Captain Mulgrew has been working with the separatists and was involved in the Omicron-5 bombing. She has been apprehended and will face the most severe justice permitted by the Space Authority.

"Now, soldier, time to relax. The crew will be there soon to pick you up."

You relax in the captain's chair and reflect on your accomplishment. When you get to the Deneb III space platform, you are whisked off for a series of debriefings and meetings.

At the end of the day, you can barely sleep, as the newest member of the 95th Mechanical Division Special Maintenance Force. Adventure at last!

    *** You have saved New Da Nang, the SS Usagi, and yourself! ***

In that game you scored 10 out of a possible 10, in 174 turns.

For your heroism in the face of almost certain death, we award you one point each for:
- fixing the aft airlock door
- fixing the microwave oven
- fixing the storage unit in the port-side crew quarters
- fixing the captain's door
- fixing the equipment cabinet in the starboard-side crew quarters
- fixing the fusion engine
- adjusting the fuel injection specification correctly

Additionally! We hereby award you one point for saving the SS Usagi, another point for saving yourself, and finally one more point for saving the moon New Da Nang! Congratulations!

Would you like to RESTART, RESTORE a saved game, QUIT, or UNDO the last command?

* * *

>push gum into hole
You can't see any such thing.

>put gum in hole
You push the gum into the hole.
[I hope this works.]

>i
You are carrying:
  a blown fuse
  a knife
  a hex-shaped tool
  a roll of electrical tape
  a small key
  a portable hand-held vacuum cleaner
  a broken sensor
  Bertie the Bear™
  some pair of slippers
  a vac suit (being worn)
  a To-Do list
  a repair corps uniform (being worn) with chewing gum stuck to it
  a toolbox

>undo
Junction
[Previous turn undone.]

>undo
Junction
[Previous turn undone.]

>rules
Rules tracing now switched on. Type "rules off" to switch it off again, or "rules all" to include even rules which do not apply.

[Rule "reset report text rule" applies.]

>put gum in hole
[Rule "After reading a command" applies.]
[Rule "After deciding the scope of the player when the current stuck thing of the chewing gum is not the player" applies.]
[Rule "computer is everywhere rule" applies.]
[Rule "After deciding the scope of the player when the current stuck thing of the chewing gum is not the player" applies.]
[Rule "computer is everywhere rule" applies.]
[Rule "After deciding the scope of the player when the current stuck thing of the chewing gum is not the player" applies.]
[Rule "computer is everywhere rule" applies.]
[Rule "After deciding the scope of the player when the current stuck thing of the chewing gum is not the player" applies.]
[Rule "computer is everywhere rule" applies.]
[Rule "After deciding the scope of the player when the current stuck thing of the chewing gum is not the player" applies.]
[Rule "computer is everywhere rule" applies.]
[Rule "declare everything initially unmentioned rule" applies.]
[Rule "announce items from multiple object lists rule" applies.]
[Rule "set pronouns from items from multiple object lists rule" applies.]
[Rule "before stage rule" applies.]
[Rule "Before" applies.]
[Rule "reaching inside the room of stuff rule" applies.]
[Rule "new instead stage rule" applies.]
[Rule "Instead of inserting the chewing gum into the hole" applies.]
You push the gum into the hole.
[I hope this works.]

[Rule "pre-report rule" applies.]
[Rule "post-report rule" applies.]
[Rule "A first turn sequence rule" applies.]
[Rule "post-report rule" applies.]
[Rule "every turn stage rule" applies.]
[Rule "Every turn when talking about asking mulgrew questions and computer-rebooting is false and protocols-in-progress is false" applies.]
[Rule "For Asking for attention by Arvax when current conversation state is asking mulgrew questions" applies.]
[Rule "reset protocol rule" applies.]
[Rule "Every turn" applies.]
[Rule "close open doors rule" applies.]
[Rule "A last turn sequence rule" applies.]
[Rule "notify score changes rule" applies.]
[Rule "reset report text rule" applies.]

* * *

>put gum in hole
(first taking the chewing gum)
You can't reach the gum with the vac suit on top of your uniform.

(first taking the chewing gum)
You can't reach the gum with the vac suit on top of your uniform.

>rules
Rules tracing now switched on. Type "rules off" to switch it off again, or "rules all" to include even rules which do not apply.

[Rule "reset report text rule" applies.]

* * *

>put gum in hole
(first taking the chewing gum)
You can't reach the gum with the vac suit on top of your uniform.

(first taking the chewing gum)
You can't reach the gum with the vac suit on top of your uniform.

>take gum
That isn't available.

>undo
Junction
[Previous turn undone.]

>take gum
You unstick the chewing gum from the repair corps uniform.

>i
You are carrying:
  some used chewing gum
  a blown fuse
  a knife
  a hex-shaped tool
  a roll of electrical tape
  a small key
  a portable hand-held vacuum cleaner
  a broken sensor
  Bertie the Bear™
  some pair of slippers
  a vac suit (being worn)
  a To-Do list
  a repair corps uniform (being worn)
  a toolbox

>undo
Junction
[Previous turn undone.]

>i
You are carrying:
  a blown fuse
  a knife
  a hex-shaped tool
  a roll of electrical tape
  a small key
  a portable hand-held vacuum cleaner
  a broken sensor
  Bertie the Bear™
  some pair of slippers
  a vac suit (being worn)
  a To-Do list
  a repair corps uniform (being worn) with chewing gum stuck to it
  a toolbox

>showme chewing gum
chewing gum - thing
location: in the Room of Stuff
singular-named, improper-named; unlit, edible, portable, handled, seen, familiar, screwed; list grouping key: none
printed name: "chewing gum"
printed plural name: none
indefinite article: "some"
description: "It's a used wad of pink chewing gum. It used to taste like grape, but now it tastes of nothing."
initial appearance: none
last utterance: none
readable text: none
voice locale: yourself
current stuck thing: repair corps uniform

>take gum
You unstick the chewing gum from the repair corps uniform.

The chewing gum has become stuck to the toolbox.

>undo
Junction
[Previous turn undone.]

>showme repair corps uniform
repair corps uniform - thing
    repair corps patch (part of repair corps uniform)
location: worn by yourself in Junction
singular-named, improper-named; unlit, inedible, portable, wearable, handled, seen, familiar, screwed
list grouping key: none
printed name: "repair corps uniform"
printed plural name: none
indefinite article: none
description: "dummy description"
initial appearance: none
last utterance: none
readable text: none
voice locale: yourself

* * *

>put gum inhole
You can't see any such thing.

>put gum in hole
(first taking the chewing gum)
You can't reach the gum with the vac suit on top of your uniform.

>remove suit
You take off the vac suit.

The boots are now switched off.

>put gum in hole
(first taking the chewing gum)
You push the gum into the hole.
[I hope this works.]

>wear suit
You put on the vac suit.

>turn on boots
You switch the Magnetic boots on.

>close panel
You drive a screw into the gum and it holds. The panel is now closed.

You hear a series of beeps, and a voice says "Door now operational."

It seems you completed something ("fix the captain's door") that wasn't on your to-do list. You note it down.

[Your score has just gone up by one point.]

>i
You are carrying:
  a blown fuse
  a knife
  a hex-shaped tool
  a roll of electrical tape
  a small key
  a portable hand-held vacuum cleaner
  a broken sensor
  Bertie the Bear™
  some pair of slippers
  a vac suit (being worn)
  a To-Do list
  a repair corps uniform (being worn) with chewing gum stuck to it
  a toolbox

* * *

>read diary
[I never thought it would come to this, eavesdropping on someone's personal thoughts.]

You page through the journal, skimming over the boring parts detailing the running of the ship. Eventually you come across something more interesting:

"I screwed up last night. I let them spend the night and I think someone noticed. If this got out my career would be over."

A few pages later:

"I'm being blackmailed. I don't know who, but someone messaged me telling me all they know. They know a lot. They made it clear they expect my 'cooperation'."

Numerous later passages detail this cooperation, ranging from simple intelligence gathering to actively working to harm the Space Authority.

[My god...]

>ask computer about diary
I'm unable to give you any information about diary.

>f
The Captain's Door opens as you approach, and closes silently behind you.

Junction
This is a busy place when the ship is populated. To port and starboard are the crew quarters, aft is the closed door to the captain's private quarters, and fore is the galley. A ladder leads down to the staging area.

>s
Starboard-Side Crew Quarters
All crew members who aren't the captain sleep in this or the opposite-side bunk room. This one sleeps two in a bunk bed, done up with military precision. There is a large cabinet here, stretching almost to the ceiling. It is closed. Mounted in the wall is a crew personal storage unit. The sole exit is to port.

In a shocking lapse of military precision, there is a sticky note attached to the bed post.

You can also see a cardboard box (empty) and some wrapping paper here.

* * *

>x cabinet
You can see the problem from up here: the top hinge of the cabinet door has a crooked screw, probably from the door being slammed too many times. You'll have to replace it.

>replace screw
You unscrew the old screw and replace it with a new one.

You cross out an item ("fix the cabinet") on your to-do list.

[Your score has just gone up by one point.]

>read list
You have the following items on your to-do list: fix the engine. You have finished the following: fix the airlock door, fix the microwave, fix the storage unit, fix the captain's door, and fix the cabinet.

>p
(first getting off the top bunk)

Junction
This is a busy place when the ship is populated. To port and starboard are the crew quarters, aft is the closed door to the captain's private quarters, and fore is the galley. A ladder leads down to the staging area.

>p
Port-Side Crew Quarters
All crew members who aren't the captain sleep in this or the opposite-side bunk room. This one sleeps two in a bunk bed, done up with military precision. There is a large cabinet here, stretching almost to the ceiling. It is open and contains an engineering uniform and an Universal Game Emulator. Mounted in the wall is a crew personal storage unit. The sole exit is to starboard.

>f
The only obvious exit is starboard (to junction).

>s
Junction
This is a busy place when the ship is populated. To port and starboard are the crew quarters, aft is the closed door to the captain's private quarters, and fore is the galley. A ladder leads down to the staging area.

* * *

>u
Operations Deck
This is where all of the support activity for the bridge occurs. There are large consoles for environmental controls, communications, and power systems here. The bridge continues forward from here, and engineering is aft. There is a door set in the floor with a ladder leading through it. Set in the frame of the door is a blue button.

You can see an equipment trunk (closed) here.

>set gravity control to 1
You dial the gravity to 1.

Captain Mulgrew: "What'll it be, Usagi?"

>jump
Whee! You can jump high in this lower gravity.

>d
Galley
This narrow space is barely enough room for two Marines to prepare and eat a meal. There is a counter with a drawer, and two stools, a microwave oven, and a large closet here. Pots and pans hang from hooks in the ceiling. A ladder leads up through the midship door, and you can leave aft.

On the starboard wall is a panel on which is a blue button. Tacked to the panel is the operator's manual for the midship door.

You hear someone speaking above.

* * *

>a
Junction
This is a busy place when the ship is populated. To port and starboard are the crew quarters, aft is the closed door to the captain's private quarters, and fore is the galley. A ladder leads down to the staging area.

>d
Staging Area
This is the staging area of the ship, where marines prepare for missions. It is adjacent to the aft airlock. Locked compartments set into the walls hold various munitions. A ladder leads up into the rest of the ship. 

An equipment locker is sprawled across the room, with its door to the ground.
 
Through the airlock windows you see the blank space left by the destruction of Space Station Omicron-5.

What looks like part of an engine is stowed in a corner.

There is an air scrubber intake in the wall here.

You can also see a black trunk (closed) here.

>x enginer part
You can't see any such thing.

>x engine part
This is a wide, low, trapezoidal hunk of metal bearing the marking JL-758 on one side. Numerous electrical contacts dot the upper surface. Someone has threaded a thick cord with clips on both ends through some openings on the top and side.

>x cord
It looks like this is meant to attach the JL-758 to something.

>x locker
The vac suit locker has fallen with its door to the ground. It looks pretty heavy.

>turn it over
You turn over the locker. Now it's door-side-up.

>open it
You open the locker.

You search through the contents of the locker. It's mostly broken vac suits, but you discover something interesting: a tether, used for securing people or objects during extravehicular activity.

* * *

>read list
You have the following items on your to-do list: fix the cabinet and fix the engine. You have finished the following: fix the airlock door, fix the microwave, and fix the storage unit.

>x me
Not much to see other than the vac suit.

* * *

>x uniform
The repair corps uniform is a smart hunter green color, with a patch featuring a hammer and a wrench, crossed. It would look impressive if it weren't for the chewing gum stuck to it.

>remove uniform
You take off the repair corps uniform.

>x me
Not much to see other than the vac suit.

>i
You are carrying:
  a blown fuse
  a knife
  a hex-shaped tool
  a roll of electrical tape
  a small key
  a portable hand-held vacuum cleaner
  a broken sensor
  Bertie the Bear™
  some pair of slippers
  a vac suit (being worn)
  a To-Do list
  a repair corps uniform with chewing gum stuck to it
  a toolbox

* * *

>z
Time passes.

* * *

>undo
Bridge
[Previous turn undone.]

>x gum
You can't see any such thing.

>l
Bridge
This is where the captain, navigator, and pilot all sit. Large viewscreens give a full view of the space around the ship. To port you can see the huge blue-white disk of Deneb. Ahead, the moon New Da Nang looms steadily larger and larger before you.

 The pilot's and navigator's chairs sit before their respective consoles. The captain's chair, with command console, sits halfway between them and operations further aft.

"Impact in 6."

The moon of New Da Nang looms ever larger on the forward viewscreen.

>i
You are carrying:
  the captain's journal
  a blown fuse
  a copy of Planetfall
  the red access card
  an Universal Game Emulator
  a piece of note paper
  a beacon
  a microwavable dinner
  a knife
  a hex-shaped tool
  a roll of electrical tape
  a small key
  a portable hand-held vacuum cleaner
  a vac suit (being worn)
  a broken sensor
  Bertie the Bear™
  some pair of slippers
  a To-Do list
  a repair corps uniform (being worn)
  a toolbox

"Impact in 5."

The moon of New Da Nang looms ever larger on the forward viewscreen.

>restart
Are you sure you want to restart?

* * *

>s
Starboard-Side Crew Quarters
All crew members who aren't the captain sleep in this or the opposite-side bunk room. This one sleeps two in a bunk bed, done up with military precision. There is a large cabinet here, stretching almost to the ceiling. It is closed. Mounted in the wall is a crew personal storage unit. The sole exit is to port.

In a shocking lapse of military precision, there is a sticky note attached to the bed post.

You can also see a cardboard box (empty) and some wrapping paper here.

>get on top bunk
You get onto the top bunk.

>take screw
You unscrew the old screw and replace it with a new one.

You cross out an item ("fix the cabinet") on your to-do list.

[Your score has just gone up by one point.]

>undo
Starboard-Side Crew Quarters
[Previous turn undone.]

>fix screw
This is a hard one. You'll have to be more specific about how you do that.

* * *

Crash
An Interactive Disaster by Phil Riley
Release 6 / Serial number 220730 / Inform 7 build 6M62 (I6/v6.34 lib 6/12N) SD

Space Station Gangway
This is the pressurized bridge from Space Station Omicron-5 to the SS Usagi. Behind you is the familiar bulk of the huge station, largest outpost of the Space Authority in Deneb Sector. Before you is the aft airlock of the Usagi, beckoning you in.

[Better get a move on], you think.

>x screw
All of your tools are top quality.

>take it
I'm not sure what 'it' refers to.

>take screw
You'll take them out when you need them.

* * *

Crash
An Interactive Disaster by Phil Riley
Release 6 / Serial number 220730 / Inform 7 build 6M62 (I6/v6.34 lib 6/12N) SD

Space Station Gangway
This is the pressurized bridge from Space Station Omicron-5 to the SS Usagi. Behind you is the familiar bulk of the huge station, largest outpost of the Space Authority in Deneb Sector. Before you is the aft airlock of the Usagi, beckoning you in.

[Better get a move on], you think.

>x tool
Your toolbox holds wrenches, screwdrivers, pliers, and an assortment of various fasteners.

>x wrench
All of your tools are top quality.

>x fasteners
All of your tools are top quality.

* * *

Crash
An Interactive Disaster by Phil Riley
Release 6 / Serial number 220730 / Inform 7 build 6M62 (I6/v6.34 lib 6/12N) SD

Space Station Gangway
This is the pressurized bridge from Space Station Omicron-5 to the SS Usagi. Behind you is the familiar bulk of the huge station, largest outpost of the Space Authority in Deneb Sector. Before you is the aft airlock of the Usagi, beckoning you in.

[Better get a move on], you think.

>x tools
Your toolbox holds wrenches, screwdrivers, pliers, and an assortment of various fasteners.

>x tool
Your toolbox holds wrenches, screwdrivers, pliers, and an assortment of various fasteners.

>x screwdriver
All of your tools are top quality.

>x screws
All of your tools are top quality.

* * *

Crash
An Interactive Disaster by Phil Riley
Release 6 / Serial number 220730 / Inform 7 build 6M62 (I6/v6.34 lib 6/12N) SD

Space Station Gangway
This is the pressurized bridge from Space Station Omicron-5 to the SS Usagi. Behind you is the familiar bulk of the huge station, largest outpost of the Space Authority in Deneb Sector. Before you is the aft airlock of the Usagi, beckoning you in.

[Better get a move on], you think.

>x wrench
You see nothing special about the wrench.

>take it
You'll take it out when you need it.

>x wrenches
You see nothing special about the wrench.