Luna Spacewerks Company has no description.
tiny piece of debris has no description.
Typing it on has no description.

Crash
An Interactive Disaster by Phil Riley
Release 18 / Serial number 221104 / Inform 7 build 6M62 (I6/v6.34 lib 6/12N) SD

Space Station Gangway
This is the pressurized bridge from Space Station Omicron-5 to the SS Usagi. Behind you is the familiar bulk of the huge station, largest outpost of the Space Authority in Deneb Sector. Before you is the aft airlock of the Usagi, beckoning you in.

[Better get a move on], you think.

>f
You pass into the aft airlock, the outer door closing behind you.

The Second Law of Thermodynamics, in one formulation, states that disorganization always increases in the absence of some outside force. A corollary is that things will always break down in the absence of someone to fix them. As a member of the repair corps of Space Station Omicron-5, you're that someone.

Your last assignment of the day, on the SS Usagi, a Space Marines fighting ship, looks routine enough. Fix the microwave and a jammed cabinet door, and then you're off for the day.

Aft Airlock
You are in the aft airlock. Outside is the gangway back to Space Station Omicron-5. Forward leads into the ship.

A pleasant androgynous voice says, "Welcome to the SS Usagi. This is the shipboard computer. Please feel free to call upon me for any information you may need. Use the command 'computer, help' for more information."

>ask computer about airlock
The aft airlock of the SS Usagi is a standard class B starship airlock, featuring auto-pressurization and auto-depressurization.

>ask computer about starboard airlock
I'm unable to give you any information about starboard airlock.

>f
You enter the ship from the airlock. The inner door closes behind you.

Staging Area
This is the staging area of the ship, where marines prepare for missions. It is adjacent to the aft airlock. It houses a number of vac suits in an open locker, and various munitions in locked compartments set into the walls. A ladder leads up into the rest of the ship. 
Through the airlock windows you can see the gangway to Space Station Omicron-5.

What looks like part of an engine is stowed in a corner.

>ask computer about windows
The aft airlock of the SS Usagi is a standard class B starship airlock, featuring auto-pressurization and auto-depressurization.

>ask computer about gangway
A gangway is an inflatable bridge used to transfer people and equipment to and from space vessels.

>ask computer about space station
Space Station Omicron-5 is the the Deneb system outpost of the Space Authority. It is one of the largest space stations of the Space Authority.

>ask computer about engine
(the brand-new JL-758)
The JL-758 is a widely-used model of engine stabilizer produced by Luna Spacewerks.

>ask computer about spacewerks
I'm unable to give you any information about spacewerks.

* * *

>ask computer about captain
Captain Mulgrew is one of the most decorated captains in the Deneb sector. She was the second-youngest graduate of the Orion Marine Academy. She received command of the SS Usagi after successfully leading the retaking of the capital of Pollux VI from Irion invaders from the moon of Pollux III.

* * *

>ask computer about luna spacewerks
I'm unable to give you any information about luna spacewerks.

>ask computer about luna
The moon of Earth, often called simply "The Moon", is famously the first extraterrestrial body inhabited by humans.

>f
You enter the ship from the airlock. The inner door closes behind you.

Staging Area
This is the staging area of the ship, where marines prepare for missions. It is adjacent to the aft airlock. It houses a number of vac suits in an open locker, and various munitions in locked compartments set into the walls. A ladder leads up into the rest of the ship. 
Through the airlock windows you can see the gangway to Space Station Omicron-5.

What looks like part of an engine is stowed in a corner.

>ask computer about luna
The moon of Earth, often called simply "The Moon", is famously the first extraterrestrial body inhabited by humans.

>ask computer about luna spacewerks
I'm unable to give you any information about luna spacewerks.

>x engine
This is a wide, low, trapezoidal hunk of metal bearing the marking JL-758 on one side. Numerous electrical contacts dot the upper surface. Someone has threaded a thick cord with clips on both ends through some openings on the top and side.

>ask computer about engine
(the brand-new JL-758)
The JL-758 is a widely-used model of engine stabilizer produced by Luna Spacewerks.

>ask computer about luna spacewerks
I'm unable to give you any information about luna spacewerks.

* * *

>f
You enter the ship from the airlock. The inner door closes behind you.

Staging Area
This is the staging area of the ship, where marines prepare for missions. It is adjacent to the aft airlock. It houses a number of vac suits in an open locker, and various munitions in locked compartments set into the walls. A ladder leads up into the rest of the ship. 
Through the airlock windows you can see the gangway to Space Station Omicron-5.

What looks like part of an engine is stowed in a corner.

>ask computer about locker
There is a vac suit locker in the Staging Area. Sometimes things other than vac suits are stored there.

>open it
It isn't something you can open.

>open locker
That's already open.

>look in it
In the vac suit locker are five vac suits.

>take suit
In general, the crew's gear is off-limits.

>u
You climb the la--

***BOOM***

Press any key...

A gigantic force grabs the ship, knocking you off the ladder and sending you flying against an aft bulkhead. The inertial dampers are probably all that saved you from being smashed to jelly rather than just banged up. 

Press any key...

Some time later you find yourself lying on the floor of the staging area with a throbbing headache. Gingerly you push yourself to your knees and stand up. The vac suit locker has detached from its mounting and lies face down on the floor.

[Thank god I wasn't in the way of that.]

Looking outside --

[Holy -- ]

[Where's the station?].

Where Space Station Omicron-5 was, is now an expanding sphere of rubble, dimly lit by the blue light of far-off Deneb. The rubble is clearly receding behind the ship. [We're moving!]

[How am I going to get off this ship?]

Press any key...

Crash
An Interactive Disaster by Phil Riley
Release 18 / Serial number 221104 / Inform 7 build 6M62 (I6/v6.34 lib 6/12N) SD

Staging Area
This is the staging area of the ship, where marines prepare for missions. It is adjacent to the aft airlock. Locked compartments set into the walls hold various munitions. A ladder leads up into the rest of the ship. 

An equipment locker is sprawled across the room, with its door to the ground.
 
Through the airlock windows you see the blank space left by the destruction of Space Station Omicron-5.

What looks like part of an engine is stowed in a corner.

A vac suit is here, lying prone as if it were some malformed yellow person knocked unconscious by the shaking of the ship.

[What now?]

[I think I spit out my gum.]

>ask computer about locker
(the vac suit locker)
There is a vac suit locker in the Staging Area. Sometimes things other than vac suits are stored there.

Attention all crew: command functions are offline and the computer is running with decreased capabilities. Full system reboot required. There is also an oxygen leak due to a jammed vent cover on the external hull.

You add an item ("close the vent") to your to-do list.

>u
Junction
This is a busy place when the ship is populated. To port and starboard are the crew quarters, aft is the closed door to the captain's private quarters, and fore is the galley. A ladder leads down to the staging area.

⇒ You can enter "hints" at any time for help in progressing in the game.

>ask computer about locker
(the vac suit locker)
There is a vac suit locker in the Staging Area. Sometimes things other than vac suits are stored there.

* * *

>ask computer about locker
There is a vac suit locker in the Staging Area. Sometimes things other than vac suits are stored there.

>u
You climb the la--

***BOOM***

Press any key...

A gigantic force grabs the ship, knocking you off the ladder and sending you flying against an aft bulkhead. The inertial dampers are probably all that saved you from being smashed to jelly rather than just banged up. 

Press any key...

Some time later you find yourself lying on the floor of the staging area with a throbbing headache. Gingerly you push yourself to your knees and stand up. The vac suit locker has detached from its mounting and lies face down on the floor.

[Thank god I wasn't in the way of that.]

Looking outside --

[Holy -- ]

[Where's the station?].

Where Space Station Omicron-5 was, is now an expanding sphere of rubble, dimly lit by the blue light of far-off Deneb. The rubble is clearly receding behind the ship. [We're moving!]

[How am I going to get off this ship?]

Press any key...

Crash
An Interactive Disaster by Phil Riley
Release 18 / Serial number 221104 / Inform 7 build 6M62 (I6/v6.34 lib 6/12N) SD

Staging Area
This is the staging area of the ship, where marines prepare for missions. It is adjacent to the aft airlock. Locked compartments set into the walls hold various munitions. A ladder leads up into the rest of the ship. 

An equipment locker is sprawled across the room, with its door to the ground.
 
Through the airlock windows you see the blank space left by the destruction of Space Station Omicron-5.

What looks like part of an engine is stowed in a corner.

A vac suit is here, lying prone as if it were some malformed yellow person knocked unconscious by the shaking of the ship.

[What now?]

[I think I spit out my gum.]

* * *

>ask computer about locker
(the vac suit locker)
There is a vac suit locker in the Staging Area. Sometimes things other than vac suits are stored there.

Attention all crew: command functions are offline and the computer is running with decreased capabilities. Full system reboot required. There is also an oxygen leak due to a jammed vent cover on the external hull.

You add an item ("close the vent") to your to-do list.

>showme
Staging Area - room
    explosion - backdrop
    ss usagi - backdrop
    wall - dummy-backdrop
    ceiling - dummy-backdrop
    vac suit locker - supporter
    aft ladder - backdrop
    Aft Airlock - backdrop
    Space Station Omicron-5 - backdrop
    gangway - backdrop
    yourself - person
        underwear (part of yourself)
        To-Do list
        repair corps uniform (worn)
            repair corps patch (part of repair corps uniform)
        toolbox
            screwdriver (part of toolbox) - tool-thing
            wrench (part of toolbox) - tool-thing
            pliers (part of toolbox) - tool-thing
            fasteners (part of toolbox) - tool-thing
    brand-new JL-758
        electrical contacts (part of brand-new JL-758)
        openings (part of brand-new JL-758)
        woven cord (part of brand-new JL-758)
    vac suit - vac suit
        helmet (part of vac suit) - helmet
        Magnetic boots (part of vac suit) - Magnetic boots
        Gloves (part of vac suit) - Gloves
        nozzle (part of vac suit) - nozzle
        air gauge (part of vac suit) - air gauge
    munitions compartment - transparent locked container
        laser rifle
    air scrubber intake
    Airlock door
    component panel

>showme component panel
component panel - thing
location: in the Staging Area
singular-named, improper-named; unlit, inedible, fixed in place, scenery, seen, familiar, screwed
list grouping key: none
printed name: "component panel"
printed plural name: none
indefinite article: none
description: "dummy description"
initial appearance: none
last utterance: none
readable text: none
voice locale: yourself

>u
Junction
This is a busy place when the ship is populated. To port and starboard are the crew quarters, aft is the closed door to the captain's private quarters, and fore is the galley. A ladder leads down to the staging area.

⇒ You can enter "hints" at any time for help in progressing in the game.

>ask computer about vac suit
A vacuum suit is required equipment for EVAs (extra-vehicular activities). The vacuum suits on board the SS Usagi are model V13 manufactured by Polaris Equipment Corp. They feature automated pressurization and depressurization, as well as manually-activated magnetic boots. The V13 is rated as medium in terms of air capacity.

>ask computer about usagi
The SS Usagi is a light frigate in the Deneb system, with a crew of five including the captain. It is currently helmed by Captain Jane Mulgrew. The ship's main drive is a Luna Spacewerks Parsec VI.

>ask computer about mulgrew
Captain Mulgrew is one of the most decorated captains in the Deneb sector. She was the second-youngest graduate of the Orion Marine Academy. She received command of the SS Usagi after successfully leading the retaking of the capital of Pollux VI from Irion invaders from the moon of Pollux III.

>ask computer about deneb
Which do you mean, Deneb System, Deneb IV, Deneb II, Deneb sector, the Deneb separatists, or Deneb (star)?

>system
The planetary system orbiting the star Deneb consists of seven planets, of which the second and fourth are suitable for large-scale settlement, though they are not habitable without artificial intervention. There are sizable human populations on Deneb II and Deneb IV, as well as on the moon New Da Nang. There is also a small military settlement on Deneb III.

>ask computer about deneb iv
Deneb IV, founded by anti-corporate ideologues who split off from Deneb II, has from the start had a popular separatist movement.

>ask computer about deneb ii
Once the jewel of Deneb sector and a paradise of natural splendor, over the last two centuries Deneb II has succumbed to creeping corporatization. The resulting degrading of the ecosphere is a primary reason for the exodus to Deneb IV and the separatist movement which has followed.

>ask computer about deneb iii
A small rocky planet without atmosphere used as a Space Marines outpost.

>computer about separatist
I'm not sure what you're trying to say. I might just not recognize the words you're using.

>ask computer about separatist
Anti-corporate ideologues advocating for Deneb IV's independence from the Space Authority.

>ask computer about deneb sector
The portion of space containing the stars Deneb, XB-546J, GF-195A, and numerous other minor stars.

>ask computer about deneb
Which do you mean, Deneb System, Deneb IV, Deneb II, Deneb sector, Deneb III planet, the Deneb separatists, or Deneb (star)?

>star
Deneb is a blue-white supergiant located 2,615 light-years from Earth. When seen from Earth, it appears in the constellation of Cygnus.

* * *

>ask computer about milky way
The Milky Way is the galaxy that includes the Solar System, and the systems of Deneb and Pollux, for instance.

>ask computer about solar system
Sol, the home star of the human race, has eight planets: Mercury, Venus, Earth, Mars, Jupiter, Saturn, Uranus, and Neptune. Sol also has numerous dwarf planets, of which the best known is Pluto, once classified as a planet.

>ask computer about pluto
Once considered the ninth planet, Pluto is now considered a dwarf planet. Along with many of the trans-Neptunian dwarf planets, Pluto is part of the solar system's defensive "early warning" system, with a listening post on its largest moon, Charon.

Attention all crew: command functions are offline and the computer is running with decreased capabilities. Full system reboot required. There is also an oxygen leak due to a jammed vent cover on the external hull.

>ask computer about saturn
The second-largest planet in the solar system, and the sixth from the sun, Saturn is known for its impressive rings and many moons.

>ask computer about tethys
The fifteenth moon of Saturn, it is made primarily of water ice with a small fraction of rock.

>ask computer about saturn
The second-largest planet in the solar system, and the sixth from the sun, Saturn is known for its impressive rings and many moons.

>ask computer about hupiter
I'm unable to give you any information about hupiter.

>ask computer about jupiter
The fifth and largest planet in the solar system, Jupiter is a gas giant. Humans have inhabited its sixth moon, Europa, since the mid-twenty-second century.

>ask computer about europa
The first trans-Martian colony was established on Europa in 2165 CE.

>ask computer about mars
The so-called "red planet", Mars is the fourth planet of the Sol system. Humans have inhabited Mars since the late twenty-first century, making it the second extraterrestrial human habitation, after the Moon.

>ask computer about moon
The moon of Earth, often called simply "The Moon", is famously the first extraterrestrial body inhabited by humans.

>ask computer about earth
The home planet of the human race, third planet from the star Sol. It is one of only a handful of habitable planets discovered by the human race.

>showme
Junction - room
    aft ladder - backdrop
    ss usagi - backdrop
    wall - dummy-backdrop
    ceiling - dummy-backdrop
    yourself - person
        underwear (part of yourself)
        To-Do list
        repair corps uniform (worn)
            repair corps patch (part of repair corps uniform)
        toolbox
            screwdriver (part of toolbox) - tool-thing
            wrench (part of toolbox) - tool-thing
            pliers (part of toolbox) - tool-thing
            fasteners (part of toolbox) - tool-thing
    Captain's Door - starship door
        Captain's Door's slot (part of Captain's Door) - slot
    access panel - closed container
        hole (part of access panel)
        *blown fuse
        *row of fuses
* denotes things which are not in scope

>x usagi
The SS Usagi is quiet, its engines still, even as it hurtles through space.

* * *

>f
You enter the ship from the airlock. The inner door closes behind you.

Staging Area
This is the staging area of the ship, where marines prepare for missions. It is adjacent to the aft airlock. It houses a number of vac suits in an open locker, and various munitions in locked compartments set into the walls. A ladder leads up into the rest of the ship. 
Through the airlock windows you can see the gangway to Space Station Omicron-5.

What looks like part of an engine is stowed in a corner.

>u
You climb the la--

***BOOM***

Press any key...

A gigantic force grabs the ship, knocking you off the ladder and sending you flying against an aft bulkhead. The inertial dampers are probably all that saved you from being smashed to jelly rather than just banged up. 

Press any key...

Some time later you find yourself lying on the floor of the staging area with a throbbing headache. Gingerly you push yourself to your knees and stand up. The vac suit locker has detached from its mounting and lies face down on the floor.

[Thank god I wasn't in the way of that.]

Looking outside --

[Holy -- ]

[Where's the station?].

Where Space Station Omicron-5 was, is now an expanding sphere of rubble, dimly lit by the blue light of far-off Deneb. The rubble is clearly receding behind the ship. [We're moving!]

[How am I going to get off this ship?]

Press any key...

Crash
An Interactive Disaster by Phil Riley
Release 18 / Serial number 221103 / Inform 7 build 6M62 (I6/v6.34 lib 6/12N) SD

Staging Area
This is the staging area of the ship, where marines prepare for missions. It is adjacent to the aft airlock. Locked compartments set into the walls hold various munitions. A ladder leads up into the rest of the ship. 

An equipment locker is sprawled across the room, with its door to the ground.
 
Through the airlock windows you see the blank space left by the destruction of Space Station Omicron-5.

What looks like part of an engine is stowed in a corner.

A vac suit is here, lying prone as if it were some malformed yellow person knocked unconscious by the shaking of the ship.

[What now?]

[I think I spit out my gum.]

>take gum
You unstick the chewing gum from the repair corps uniform.

Attention all crew: command functions are offline and the computer is running with decreased capabilities. Full system reboot required.

The chewing gum has become stuck to the toolbox.

>chew it
You can't chew the gum when it's stuck to the toolbox.

>u
Junction
This is a busy place when the ship is populated. To port and starboard are the crew quarters, aft is the closed door to the captain's private quarters, and fore is the galley. A ladder leads down to the staging area.

⇒ You can enter "hints" at any time for help in progressing in the game.

>take gum
You unstick the chewing gum from the toolbox.

>chew it
You put the chewing gum in your mouth.

>p
Port-Side Crew Quarters
All crew members who aren't the captain sleep in this or the opposite-side bunk room. This one sleeps two in a bunk bed, done up with military precision. There is a large cabinet here, stretching almost to the ceiling. It is closed. Mounted in the wall is a crew personal storage unit. The sole exit is to starboard.

>type on keypad
As you press a key, the storage unit starts buzzing continuously. The display lights up with random characters, and you smell the distinct odor of burning wires. The bottom drawer pops out a centimeter or two.

You add an item ("fix the storage unit") to your to-do list.

>close drawer
Which do you mean, the top drawer or the bottom drawer?

* * *

>bottom
You're unable to close the drawer. I think you'll need to open it all the way first.

>push it
The drawer seems jammed.

>open it
The drawer is partially open, but you can't find a purchase on it firm enough to open it.

>i
You are carrying:
  some chewing gum (being chewed)
  a To-Do list
  a repair corps uniform (being worn)
  a toolbox

>s
Junction
This is a busy place when the ship is populated. To port and starboard are the crew quarters, aft is the closed door to the captain's private quarters, and fore is the galley. A ladder leads down to the staging area.

* * *

>take slippers
As you lean to take the slippers, you notice something under the bed.

>wear them
You put on the slippers.

>i
You are carrying:
  some slippers (being worn)
  some chewing gum (being chewed)
  a To-Do list
  a repair corps uniform (being worn)
  a toolbox

Attention all crew: command functions are offline and the computer is running with decreased capabilities. Full system reboot required.

>ask computer about captain
I'm unable to give you any information about captain.

>ask computer about mulgrew
I'm unable to give you any information about mulgrew.

* * *

>u
Junction
This is a busy place when the ship is populated. To port and starboard are the crew quarters, aft is the closed door to the captain's private quarters, and fore is the galley. A ladder leads down to the staging area.

⇒ You can enter "hints" at any time for help in progressing in the game.

Attention all crew: command functions are offline and the computer is running with decreased capabilities. Full system reboot required. There is also an oxygen leak due to a jammed vent cover on the external hull.

You add an item ("close the vent") to your to-do list.

>d
Staging Area
This is the staging area of the ship, where marines prepare for missions. It is adjacent to the aft airlock. Locked compartments set into the walls hold various munitions. A ladder leads up into the rest of the ship. 

An equipment locker is sprawled across the room, with its door to the ground.
 
Through the airlock windows you see the blank space left by the destruction of Space Station Omicron-5.

What looks like part of an engine is stowed in a corner.

A vac suit is here, lying prone as if it were some malformed yellow person knocked unconscious by the shaking of the ship.

>take suit
Taken.

>u
Junction
This is a busy place when the ship is populated. To port and starboard are the crew quarters, aft is the closed door to the captain's private quarters, and fore is the galley. A ladder leads down to the staging area.

>wear it
You put on the vac suit.

>s
Starboard-Side Crew Quarters
All crew members who aren't the captain sleep in this or the opposite-side bunk room. This one sleeps two in a bunk bed, done up with military precision. There is a large cabinet here, stretching almost to the ceiling. It is closed. Mounted in the wall is a crew personal storage unit. The sole exit is to port.

In a shocking lapse of military precision, there is a sticky note attached to the bed post.

A pair of slippers peeks out from under the bed.

* * *

>take eyes
[Am I really going to do this? Yes, yes, I am, apparently.]

You grasp one of the eyes and give it a tug, first softly then harder. Eventually it gives and you extract the eye from the bear. Upon examination you discover that the eye is in fact an optical sensor in camouflage. It looks like you didn't pull it carefully enough, however, because the connector at the end has been damaged.

You try again more carefully with the second eye, and manage to produce an undamaged optical sensor.

>d
The only obvious exit is port (to junction).

>p
Junction
This is a busy place when the ship is populated. To port and starboard are the crew quarters, aft is the closed door to the captain's private quarters, and fore is the galley. A ladder leads down to the staging area.

* * *

>d
Staging Area
This is the staging area of the ship, where marines prepare for missions. It is adjacent to the aft airlock. Locked compartments set into the walls hold various munitions. A ladder leads up into the rest of the ship. 

An equipment locker is sprawled across the room, with its door to the ground.
 
Through the airlock windows you see the blank space left by the destruction of Space Station Omicron-5.

What looks like part of an engine is stowed in a corner.

>drop trunk
You can't see any such thing.

>i
You are carrying:
  a new optical sensor
  Bertie the Bear™
  a vac suit (being worn)
  a To-Do list
  a repair corps uniform (being worn) with chewing gum stuck to it
  a toolbox

>u
Junction
This is a busy place when the ship is populated. To port and starboard are the crew quarters, aft is the closed door to the captain's private quarters, and fore is the galley. A ladder leads down to the staging area.

>s
Starboard-Side Crew Quarters
All crew members who aren't the captain sleep in this or the opposite-side bunk room. This one sleeps two in a bunk bed, done up with military precision. There is a large cabinet here, stretching almost to the ceiling. It is closed. Mounted in the wall is a crew personal storage unit. The sole exit is to port.

In a shocking lapse of military precision, there is a sticky note attached to the bed post.

A pair of slippers peeks out from under the bed.

You can also see a cardboard box (empty), some wrapping paper, and a black trunk (empty) here.

Attention all crew: command functions are offline and the computer is running with decreased capabilities. Full system reboot required. There is also an oxygen leak due to a jammed vent cover on the external hull.

>take trunk
Taken.

* * *

>drop trunk
You place the black trunk near the airlock door.

>stand on trunk
(first closing the black trunk)
You get onto the black trunk.

>replace sensor
You remove the broken sensor and insert the fresh sensor into the empty socket.
[There. That should do it.]

It seems you completed something ("fix the airlock door") that wasn't on your to-do list. You note it down.

[Your score has just gone up by one point.]

>turn on boots
You switch the Magnetic boots on.

>a
(first getting off the black trunk)

Aft Airlock
You are in the aft airlock. Outside is the blackness of space, speckled with the dying embers of what was once Space Station Omicron-5. Forward leads into the ship.

* * *

>s
Floating as you are, you can't move in any direction.

Your vac suit pings gently to indicate you have expended a unit of air.

>vent air
You vent a bit of air from your suit. It propels you just a tiny amount toward the hull, but it's enough. One agonizing minute later, you're attached to the hull again.

[Oh thank god! I thought I was a goner.]

Hull of the Usagi (vacuum)
Here the path runs aft to the aft airlock and starboard to the engineering airlock. Where there used to be a large embedded chunk of debris blocking the path, now there is a scattering of rubble.

There is a hook set in the hull here.

Your vac suit pings gently to indicate you have expended a unit of air.

>s
Outside the Engineering Airlock (vacuum)
You are standing on the hull of the ship, outside the engineering airlock, secured by your vac suit's mag boots. Most of the hull is taken up by the protrusions of various machinery, antennae, radio dishes, and heat sinks. There is a clear path to port among the obstructions. You can also go in to the airlock.

Near your feet is a six-inch hole in the hull labeled "Caution: Stand back during venting." The hole is almost entirely closed by a sliding cover, but a small gap remains, held open by a tiny piece of debris.

A hook protrudes from the hull next to the airlock door.

Your vac suit pings gently to indicate you have expended a unit of air.

* * *

>take debris
(the tiny piece of debris)
The vent slides all the way shut.

Taken.

You cross out an item ("close the vent") on your to-do list.

Your vac suit pings gently to indicate you have expended a unit of air.

[Your score has just gone up by one point.]

>l
Outside the Engineering Airlock (vacuum)
You are standing on the hull of the ship, outside the engineering airlock, secured by your vac suit's mag boots. Most of the hull is taken up by the protrusions of various machinery, antennae, radio dishes, and heat sinks. There is a clear path to port among the obstructions. You can also go in to the airlock.

A hook protrudes from the hull next to the airlock door.

Your vac suit pings gently to indicate you have expended a unit of air.

>turn off boots
You switch the Magnetic boots off.

A stern voice in your helmet intones "Air levels critical. Seek a pressurized location immediately."

>jump
You propel yourself away from the ship, realizing too late you have no way to get back. You drift through the blackness of space until your air runs out and you suffocate.

    *** You have died ***

In that game you scored 2 out of a possible 10, in 38 turns.

Your death was completely pointless and preventable. All the same we grudgingly award you one point each for what you did accomplish, which was:
- fixing the aft airlock door
- closing the vent

Would you like to RESTART, RESTORE a saved game, QUIT, or UNDO the last command?

>undo
Outside the Engineering Airlock (vacuum)
[Previous turn undone.]

* * *

>u
Junction
This is a busy place when the ship is populated. To port and starboard are the crew quarters, aft is the closed door to the captain's private quarters, and fore is the galley. A ladder leads down to the staging area.

⇒ You can enter "hints" at any time for help in progressing in the game.

Attention all crew: command functions are offline and the computer is running with decreased capabilities. Full system reboot required. There is also an oxygen leak due to a jammed vent cover on the external hull.

You add an item ("close the vent") to your to-do list.

>x list
You have the following items on your to-do list: fix the microwave, fix the cabinet, and close the vent.

* * *

>f
You enter the ship from the airlock. The inner door closes behind you.

Staging Area
This is the staging area of the ship, where marines prepare for missions. It is adjacent to the aft airlock. It houses a number of vac suits in an open locker, and various munitions in locked compartments set into the walls. A ladder leads up into the rest of the ship. 
Through the airlock windows you can see the gangway to Space Station Omicron-5.

What looks like part of an engine is stowed in a corner.

>x engine
This is a wide, low, trapezoidal hunk of metal bearing the marking JL-758 on one side. Numerous electrical contacts dot the upper surface. Someone has threaded a thick cord with clips on both ends through some openings on the top and side.

* * *

>ask computer about engine
(the brand-new JL-758)
The JL-758 is a widely-used model of engine stabilizer produced by Luna Spacewerks.

>ask computer about luna spacewerks
Based on the moon of Earth, Luna Spacewerks is a leading supplier of engine parts to the Space Marines.

>ask computer about space marines
The Space Marines is an arm of the Space Force.

>ask computer about space force
The Space Force is the military arm of The Space Authority.

>ask computer about space authority
The Space Authority is the governing body of most human-controlled space. Its military is known as the Space Force. The Space Authority is a socialist society with a representative democracy.

>l
Staging Area
This is the staging area of the ship, where marines prepare for missions. It is adjacent to the aft airlock. It houses a number of vac suits in an open locker, and various munitions in locked compartments set into the walls. A ladder leads up into the rest of the ship. 
Through the airlock windows you can see the gangway to Space Station Omicron-5.

What looks like part of an engine is stowed in a corner.

>ask computer about ladder
I'm unable to give you any information about ladder.

>u
You climb the la--

***BOOM***

Press any key...

A gigantic force grabs the ship, knocking you off the ladder and sending you flying against an aft bulkhead. The inertial dampers are probably all that saved you from being smashed to jelly rather than just banged up. 

Press any key...

Some time later you find yourself lying on the floor of the staging area with a throbbing headache. Gingerly you push yourself to your knees and stand up. The vac suit locker has detached from its mounting and lies face down on the floor.

[Thank god I wasn't in the way of that.]

Looking outside --

[Holy -- ]

[Where's the station?].

Where Space Station Omicron-5 was, is now an expanding sphere of rubble, dimly lit by the blue light of far-off Deneb. The rubble is clearly receding behind the ship. [We're moving!]

[How am I going to get off this ship?]

Press any key...

Crash
An Interactive Disaster by Phil Riley
Release 18 / Serial number 221104 / Inform 7 build 6M62 (I6/v6.34 lib 6/12N) SD

Staging Area
This is the staging area of the ship, where marines prepare for missions. It is adjacent to the aft airlock. Locked compartments set into the walls hold various munitions. A ladder leads up into the rest of the ship. 

An equipment locker is sprawled across the room, with its door to the ground.
 
Through the airlock windows you see the blank space left by the destruction of Space Station Omicron-5.

What looks like part of an engine is stowed in a corner.

A vac suit is here, lying prone as if it were some malformed yellow person knocked unconscious by the shaking of the ship.

[What now?]

[I think I spit out my gum.]

>take gum
You unstick the chewing gum from the repair corps uniform.

Attention all crew: command functions are offline and the computer is running with decreased capabilities. Full system reboot required. There is also an oxygen leak due to a jammed vent cover on the external hull.

You add an item ("close the vent") to your to-do list.

>chew gum
You put the chewing gum in your mouth.

>swallow gum
Don't you know that if you swallow gum it will stay in your stomach forever?

>showme
Staging Area - room
    explosion - backdrop
    ss usagi - backdrop
    wall - dummy-backdrop
    ceiling - dummy-backdrop
    vac suit locker - supporter
    aft ladder - backdrop
    Aft Airlock - backdrop
    Space Station Omicron-5 - backdrop
    gangway - backdrop
    yourself - person
        underwear (part of yourself)
        chewing gum
        To-Do list
        repair corps uniform (worn)
            repair corps patch (part of repair corps uniform)
        toolbox
            screwdriver (part of toolbox) - tool-thing
            wrench (part of toolbox) - tool-thing
            pliers (part of toolbox) - tool-thing
            fasteners (part of toolbox) - tool-thing
    brand-new JL-758
        electrical contacts (part of brand-new JL-758)
        openings (part of brand-new JL-758)
        woven cord (part of brand-new JL-758)
    vac suit - vac suit
        helmet (part of vac suit) - helmet
        Magnetic boots (part of vac suit) - Magnetic boots
        Gloves (part of vac suit) - Gloves
        nozzle (part of vac suit) - nozzle
        air gauge (part of vac suit) - air gauge
    munitions compartment - transparent locked container
        laser rifle
    air scrubber intake
    Airlock door
    component panel

>x path
You can't see any such thing.

>x patvh
You can't see any such thing.

>x patch
The patch shows a hammer and a wrench, crossed.

* * *

>f
You enter the ship from the airlock. The inner door closes behind you.

Staging Area
This is the staging area of the ship, where marines prepare for missions. It is adjacent to the aft airlock. It houses a number of vac suits in an open locker, and various munitions in locked compartments set into the walls. A ladder leads up into the rest of the ship. 
Through the airlock windows you can see the gangway to Space Station Omicron-5.

What looks like part of an engine is stowed in a corner.

>y
There's no one here to talk to.

>u
You climb the la--

***BOOM***

Press any key...

A gigantic force grabs the ship, knocking you off the ladder and sending you flying against an aft bulkhead. The inertial dampers are probably all that saved you from being smashed to jelly rather than just banged up. 

Press any key...

Some time later you find yourself lying on the floor of the staging area with a throbbing headache. Gingerly you push yourself to your knees and stand up. The vac suit locker has detached from its mounting and lies face down on the floor.

[Thank god I wasn't in the way of that.]

Looking outside --

[Holy -- ]

[Where's the station?].

Where Space Station Omicron-5 was, is now an expanding sphere of rubble, dimly lit by the blue light of far-off Deneb. The rubble is clearly receding behind the ship. [We're moving!]

[How am I going to get off this ship?]

Press any key...

Crash
An Interactive Disaster by Phil Riley
Release 18 / Serial number 221102 / Inform 7 build 6M62 (I6/v6.34 lib 6/12N) SD

Staging Area
This is the staging area of the ship, where marines prepare for missions. It is adjacent to the aft airlock. Locked compartments set into the walls hold various munitions. A ladder leads up into the rest of the ship. 

An equipment locker is sprawled across the room, with its door to the ground.
 
Through the airlock windows you see the blank space left by the destruction of Space Station Omicron-5.

What looks like part of an engine is stowed in a corner.

A vac suit is here, lying prone as if it were some malformed yellow person knocked unconscious by the shaking of the ship.

[What now?]

[I think I spit out my gum.]

>u
Junction
This is a busy place when the ship is populated. To port and starboard are the crew quarters, aft is the closed door to the captain's private quarters, and fore is the galley. A ladder leads down to the staging area.

⇒ You can enter "hints" at any time for help in progressing in the game.

Attention all crew: command functions are offline and the computer is running with decreased capabilities. Full system reboot required.

>i
You are carrying:
  a To-Do list
  a repair corps uniform (being worn) with chewing gum stuck to it
  a toolbox

>x me
Nice uniform, but you should get the gum off of it.

>s
Starboard-Side Crew Quarters
All crew members who aren't the captain sleep in this or the opposite-side bunk room. This one sleeps two in a bunk bed, done up with military precision. There is a large cabinet here, stretching almost to the ceiling. It is closed. Mounted in the wall is a crew personal storage unit. The sole exit is to port.

In a shocking lapse of military precision, there is a sticky note attached to the bed post.

A pair of slippers peeks out from under the bed.

>unscrew cabinet
You can't see anything to unscrew from this angle. There are probably screws you can't reach inside the cabinet.

>unscrew cabinet door
You can't see anything to unscrew from this angle. There are probably screws you can't reach inside the cabinet.

>repair cabinet
This is a hard one. You'll have to be more specific about how you do that.

>climb bunk
As you clamber up, it looks like there's something wrong with the cabinet door.

>x door
You can see the problem from up here: the top hinge of the cabinet door has a crooked screw, probably from the door being slammed too many times. You'll have to replace it.

>unscrew door
You unscrew the old screw and replace it with a new one from your toolbox.

You cross out an item ("fix the cabinet") on your to-do list.

[Your score has just gone up by one point.]

>undo
Starboard-Side Crew Quarters
[Previous turn undone.]

>take screw
You unscrew the old screw and replace it with a new one from your toolbox.

You cross out an item ("fix the cabinet") on your to-do list.

[Your score has just gone up by one point.]

>i
You are carrying:
  a To-Do list
  a repair corps uniform (being worn) with chewing gum stuck to it
  a toolbox

>undo
Starboard-Side Crew Quarters
[Previous turn undone.]

>d
You get off the top bunk.

Starboard-Side Crew Quarters
All crew members who aren't the captain sleep in this or the opposite-side bunk room. This one sleeps two in a bunk bed, done up with military precision. There is a large cabinet here, stretching almost to the ceiling. It is closed. Mounted in the wall is a crew personal storage unit. The sole exit is to port.

In a shocking lapse of military precision, there is a sticky note attached to the bed post.

A pair of slippers peeks out from under the bed.

>take screwe
You can't see any such thing.

>take screw
You can't see any such thing.

>u
The only obvious exit is port (to junction).

>get on bed
You get onto the top bunk.

>take screw
You can't see any such thing.

>i
You are carrying:
  a To-Do list
  a repair corps uniform (being worn) with chewing gum stuck to it
  a toolbox

>l
Starboard-Side Crew Quarters (in the bunk bed)
All crew members who aren't the captain sleep in this or the opposite-side bunk room. This one sleeps two in a bunk bed, done up with military precision. There is a large cabinet here, stretching almost to the ceiling. It is closed. Mounted in the wall is a crew personal storage unit. The sole exit is to port.

In a shocking lapse of military precision, there is a sticky note attached to the bed post.

A pair of slippers peeks out from under the bed.

>x cabinet
A simple black-painted steel cabinet, it is closed.

>x door
It's a simple black-painted steel door.

>d
You get off the top bunk.

Starboard-Side Crew Quarters
All crew members who aren't the captain sleep in this or the opposite-side bunk room. This one sleeps two in a bunk bed, done up with military precision. There is a large cabinet here, stretching almost to the ceiling. It is closed. Mounted in the wall is a crew personal storage unit. The sole exit is to port.

In a shocking lapse of military precision, there is a sticky note attached to the bed post.

A pair of slippers peeks out from under the bed.

>open cabinet
You open the starboard-side equipment cabinet, revealing a beacon.

* * *

Luna Spacewerks Company has no description.
tiny piece of debris has no description.
Typing it on has no description.

Crash
An Interactive Disaster by Phil Riley
Release 18 / Serial number 221104 / Inform 7 build 6M62 (I6/v6.34 lib 6/12N) SD

Space Station Gangway
This is the pressurized bridge from Space Station Omicron-5 to the SS Usagi. Behind you is the familiar bulk of the huge station, largest outpost of the Space Authority in Deneb Sector. Before you is the aft airlock of the Usagi, beckoning you in.

[Better get a move on], you think.

>i
You are carrying:
  some chewing gum (being chewed)
  a To-Do list
  a repair corps uniform (being worn)
  a toolbox

>remove list
Please note that I understand that verb to mean to remove a piece of clothing.

>take off list
Please note that I understand that verb to mean to remove a piece of clothing.

>take off gum
[The gum's still got flavor. I don't want to spit it out yet.]

>f
You pass into the aft airlock, the outer door closing behind you.

The Second Law of Thermodynamics, in one formulation, states that disorganization always increases in the absence of some outside force. A corollary is that things will always break down in the absence of someone to fix them. As a member of the repair corps of Space Station Omicron-5, you're that someone.

Your last assignment of the day, on the SS Usagi, a Space Marines fighting ship, looks routine enough. Fix the microwave and a jammed cabinet door, and then you're off for the day.

Aft Airlock
You are in the aft airlock. Outside is the gangway back to Space Station Omicron-5. Forward leads into the ship.

A pleasant androgynous voice says, "Welcome to the SS Usagi. This is the shipboard computer. Please feel free to call upon me for any information you may need. Use the command 'computer, help' for more information."

* * *

>f
You enter the ship from the airlock. The inner door closes behind you.

Staging Area
This is the staging area of the ship, where marines prepare for missions. It is adjacent to the aft airlock. It houses a number of vac suits in an open locker, and various munitions in locked compartments set into the walls. A ladder leads up into the rest of the ship. 
Through the airlock windows you can see the gangway to Space Station Omicron-5.

What looks like part of an engine is stowed in a corner.

>u
You climb the la--

***BOOM***

Press any key...

A gigantic force grabs the ship, knocking you off the ladder and sending you flying against an aft bulkhead. The inertial dampers are probably all that saved you from being smashed to jelly rather than just banged up. 

Press any key...

Some time later you find yourself lying on the floor of the staging area with a throbbing headache. Gingerly you push yourself to your knees and stand up. The vac suit locker has detached from its mounting and lies face down on the floor.

[Thank god I wasn't in the way of that.]

Looking outside --

[Holy -- ]

[Where's the station?].

Where Space Station Omicron-5 was, is now an expanding sphere of rubble, dimly lit by the blue light of far-off Deneb. The rubble is clearly receding behind the ship. [We're moving!]

[How am I going to get off this ship?]

Press any key...

Crash
An Interactive Disaster by Phil Riley
Release 18 / Serial number 221102 / Inform 7 build 6M62 (I6/v6.34 lib 6/12N) SD

Staging Area
This is the staging area of the ship, where marines prepare for missions. It is adjacent to the aft airlock. Locked compartments set into the walls hold various munitions. A ladder leads up into the rest of the ship. 

An equipment locker is sprawled across the room, with its door to the ground.
 
Through the airlock windows you see the blank space left by the destruction of Space Station Omicron-5.

What looks like part of an engine is stowed in a corner.

A vac suit is here, lying prone as if it were some malformed yellow person knocked unconscious by the shaking of the ship.

[What now?]

[I think I spit out my gum.]

>take gum
You unstick the chewing gum from the repair corps uniform.

Attention all crew: command functions are offline and the computer is running with decreased capabilities. Full system reboot required.

The chewing gum has become stuck to the toolbox.

>u
Junction
This is a busy place when the ship is populated. To port and starboard are the crew quarters, aft is the closed door to the captain's private quarters, and fore is the galley. A ladder leads down to the staging area.

⇒ You can enter "hints" at any time for help in progressing in the game.

>w
I'm not sure what you're trying to say. I might just not recognize the words you're using.

>p
Port-Side Crew Quarters
All crew members who aren't the captain sleep in this or the opposite-side bunk room. This one sleeps two in a bunk bed, done up with military precision. There is a large cabinet here, stretching almost to the ceiling. It is closed. Mounted in the wall is a crew personal storage unit. The sole exit is to starboard.

* * *

>s
Junction
This is a busy place when the ship is populated. To port and starboard are the crew quarters, aft is the closed door to the captain's private quarters, and fore is the galley. A ladder leads down to the staging area.

>i
You are carrying:
  a To-Do list
  a repair corps uniform (being worn)
  a toolbox with chewing gum stuck to it

>take off gum
Please note that I understand that verb to mean to remove a piece of clothing.

>take gum
You unstick the chewing gum from the toolbox.

>pronouns
At the moment, "it" means the used chewing gum, "him" is unset, "her" is unset, and "them" means the slippers.

>take them
You can't see 'them' (nothing) at the moment.

>w
I'm not sure what you're trying to say. I might just not recognize the words you're using.

>l
Junction
This is a busy place when the ship is populated. To port and starboard are the crew quarters, aft is the closed door to the captain's private quarters, and fore is the galley. A ladder leads down to the staging area.

>p
Port-Side Crew Quarters
All crew members who aren't the captain sleep in this or the opposite-side bunk room. This one sleeps two in a bunk bed, done up with military precision. There is a large cabinet here, stretching almost to the ceiling. It is closed. Mounted in the wall is a crew personal storage unit. The sole exit is to starboard.

The chewing gum has become stuck to the toolbox.

>open cabinet
You open the port-side equipment cabinet, revealing an engineering uniform and an Universal Game Emulator.

>play uge
You need to say "play <game> on UGE". Note that you actually have to have the game you want to play. The UGE doesn't come with any games installed.

>play pac man on uge
You can't see any such thing.

* * *

>undo
Bridge
[Previous turn undone.]

>x list
You have the following items on your to-do list: close the vent and fix the captain's door. You have finished the following: fix the airlock door, fix the microwave, fix the cabinet, fix the storage unit, fix the engine, and adjust fuel injection specification.

Impact in 6.

The moon of New Da Nang looms ever larger on the forward viewscreen.

* * *

Luna Spacewerks Company has no description.
tiny piece of debris has no description.
Typing it on has no description.

Crash
An Interactive Disaster by Phil Riley
Release 18 / Serial number 221104 / Inform 7 build 6M62 (I6/v6.34 lib 6/12N) SD

Space Station Gangway
This is the pressurized bridge from Space Station Omicron-5 to the SS Usagi. Behind you is the familiar bulk of the huge station, largest outpost of the Space Authority in Deneb Sector. Before you is the aft airlock of the Usagi, beckoning you in.

[Better get a move on], you think.

>x all
You can't use multiple objects with that verb.

>x me
Nice uniform.

>x gum
It still tastes pretty good.

>take gum
[The gum's still got flavor. I don't want to spit it out yet.]

>z
Chew, chew, chew...

>x gangway
The gangway between the space station and the SS Usagi is an inflated tube between two airlocks. Beyond its walls is the vastness of space.

>x tube
The gangway between the space station and the SS Usagi is an inflated tube between two airlocks. Beyond its walls is the vastness of space.

>x space station
Space Station Omicron-5 is a huge spindle-shaped structure, spinning eternally to generate the coriolis force that simulates gravity.

>x airlock
The aft airlock is to fore. The door is open, expecting you to come in.

>in
You pass into the aft airlock, the outer door closing behind you.

The Second Law of Thermodynamics, in one formulation, states that disorganization always increases in the absence of some outside force. A corollary is that things will always break down in the absence of someone to fix them. As a member of the repair corps of Space Station Omicron-5, you're that someone.

Your last assignment of the day, on the SS Usagi, a Space Marines fighting ship, looks routine enough. Fix the microwave and a jammed cabinet door, and then you're off for the day.

Aft Airlock
You are in the aft airlock. Outside is the gangway back to Space Station Omicron-5. Forward leads into the ship.

A pleasant androgynous voice says, "Welcome to the SS Usagi. This is the shipboard computer. Please feel free to call upon me for any information you may need. Use the command 'computer, help' for more information."

>x computer
You can't see the computer.

>x airlock
The airlock is the last defense against the great uncaring vacuum of outer space.

>x gangway
The gangway between the space station and the SS Usagi is an inflated tube between two airlocks. Beyond its walls is the vastness of space.

>x space station
Space Station Omicron-5 is a huge spindle-shaped structure, spinning eternally to generate the coriolis force that simulates gravity.

>f
You enter the ship from the airlock. The inner door closes behind you.

Staging Area
This is the staging area of the ship, where marines prepare for missions. It is adjacent to the aft airlock. It houses a number of vac suits in an open locker, and various munitions in locked compartments set into the walls. A ladder leads up into the rest of the ship. 
Through the airlock windows you can see the gangway to Space Station Omicron-5.

What looks like part of an engine is stowed in a corner.

>x airlock
Which do you mean, Aft Airlock or the Airlock door?

>aft
You can see the aft airlock through a window in the airlock door. Beyond the airlock is the gangway back to Space Station Omicron-5.

>x airlock door
The airlock door is an imposing solid barrier between vacuum and safety. It is colored yellow with red warning symbols on it. Above the door is a panel of electronic components.

>x panel
The component panel is too high.

>climb door
Little is to be achieved by that.

>x engine
This is a wide, low, trapezoidal hunk of metal bearing the marking JL-758 on one side. Numerous electrical contacts dot the upper surface. Someone has threaded a thick cord with clips on both ends through some openings on the top and side.

>x cord
It looks like this is meant to attach the brand-new JL-758 to something.

>x clips
It looks like this is meant to attach the brand-new JL-758 to something.

>x contacts
It looks like the JL-758 is meant to be put under something, so that it makes contact with some other device.

>x metal
This is a wide, low, trapezoidal hunk of metal bearing the marking JL-758 on one side. Numerous electrical contacts dot the upper surface. Someone has threaded a thick cord with clips on both ends through some openings on the top and side.

>x jl-758
This is a wide, low, trapezoidal hunk of metal bearing the marking JL-758 on one side. Numerous electrical contacts dot the upper surface. Someone has threaded a thick cord with clips on both ends through some openings on the top and side.

>ask computer about airlock
The aft airlock of the SS Usagi is a standard class B starship airlock, featuring auto-pressurization and auto-depressurization.

>x engine
This is a wide, low, trapezoidal hunk of metal bearing the marking JL-758 on one side. Numerous electrical contacts dot the upper surface. Someone has threaded a thick cord with clips on both ends through some openings on the top and side.

* * *

>ask computer about engine
(the brand-new JL-758)
The JL-758 is a widely-used model of engine stabilizer produced by Luna Spacewerks.

>ask computer about status
The SS Usagi employs a Luna Spacewerks Parsec VI. The shipboard engine is functioning normally.

>ask computer about location
The ship is docked at Space Station Omicron-5.

>ask computer about navigation
The ship is docked at Space Station Omicron-5.

>ask computer about staging area
The staging area of the SS Usagi is where crew members prepare for missions. It is normally stocked with a full complement of vacuum suits and an array of offensive weaponry.

>u
You climb the la--

***BOOM***

Press any key...

A gigantic force grabs the ship, knocking you off the ladder and sending you flying against an aft bulkhead. The inertial dampers are probably all that saved you from being smashed to jelly rather than just banged up. 

Press any key...

Some time later you find yourself lying on the floor of the staging area with a throbbing headache. Gingerly you push yourself to your knees and stand up. The vac suit locker has detached from its mounting and lies face down on the floor.

[Thank god I wasn't in the way of that.]

Looking outside --

[Holy -- ]

[Where's the station?].

Where Space Station Omicron-5 was, is now an expanding sphere of rubble, dimly lit by the blue light of far-off Deneb. The rubble is clearly receding behind the ship. [We're moving!]

[How am I going to get off this ship?]

Press any key...

Crash
An Interactive Disaster by Phil Riley
Release 18 / Serial number 221103 / Inform 7 build 6M62 (I6/v6.34 lib 6/12N) SD

Staging Area
This is the staging area of the ship, where marines prepare for missions. It is adjacent to the aft airlock. Locked compartments set into the walls hold various munitions. A ladder leads up into the rest of the ship. 

An equipment locker is sprawled across the room, with its door to the ground.
 
Through the airlock windows you see the blank space left by the destruction of Space Station Omicron-5.

What looks like part of an engine is stowed in a corner.

A vac suit is here, lying prone as if it were some malformed yellow person knocked unconscious by the shaking of the ship.

[What now?]

[I think I spit out my gum.]

>x me
Nice uniform, but you should get the gum off of it.

Attention all crew: command functions are offline and the computer is running with decreased capabilities. Full system reboot required.

>take gum
You unstick the chewing gum from the repair corps uniform.

>chew it
You put the chewing gum in your mouth.

>u
Junction
This is a busy place when the ship is populated. To port and starboard are the crew quarters, aft is the closed door to the captain's private quarters, and fore is the galley. A ladder leads down to the staging area.

⇒ You can enter "hints" at any time for help in progressing in the game.

>ask computer about junction
I'm unable to give you any information about Junction.

>ask computer about blather
I'm unable to give you any information about blather.

>x ladder
An ordinary metal ladder, it connects the staging area to the crew quarters.

>x door
The Captain's Door is a conventional, self-opening starship door. It is painted in the traditional red of a starship captain. It features a slot through which you may slide the appropriate access card. Beside the door is an access panel, which is closed.

>x panel
The access panel is set in the bulkhead to the left of the door. It is closed and held fast with a screw.

>x screw
It's a fairly small screw, covered in blue enamel.

>take screw
You'll need to unscrew it first.

>i
You are carrying:
  some chewing gum (being chewed)
  a To-Do list
  a repair corps uniform (being worn)
  a toolbox

>touch screw
You feel nothing unexpected.

>lick it
I'm not sure what you're trying to say. I might just not recognize the words you're using.

>x screw
It's a fairly small screw, covered in blue enamel.

>s
Starboard-Side Crew Quarters
All crew members who aren't the captain sleep in this or the opposite-side bunk room. This one sleeps two in a bunk bed, done up with military precision. There is a large cabinet here, stretching almost to the ceiling. It is closed. Mounted in the wall is a crew personal storage unit. The sole exit is to port.

In a shocking lapse of military precision, there is a sticky note attached to the bed post.

A pair of slippers peeks out from under the bed.

>take all
sticky note: Taken.
slippers: As you lean to take the slippers, you notice something under the bed.

Attention all crew: command functions are offline and the computer is running with decreased capabilities. Full system reboot required.

>u
The only obvious exit is port (to junction).

>climb bunk
As you clamber up, it looks like there's something wrong with the cabinet door.

>take screw
You unscrew the old, crooked screw and replace it with a new one from your toolbox.

You cross out an item ("fix the cabinet") on your to-do list.

[Your score has just gone up by one point.]

>i
You are carrying:
  some slippers
  a sticky note
  some chewing gum (being chewed)
  a To-Do list
  a repair corps uniform (being worn)
  a toolbox

>undo
Starboard-Side Crew Quarters
[Previous turn undone.]

>x screw
The screw is bent beyond repair.

>take it
You unscrew the old, crooked screw and replace it with a new one from your toolbox.

You cross out an item ("fix the cabinet") on your to-do list.

[Your score has just gone up by one point.]

>x bunk
A fairly typical military bunk bed.

>i
You are carrying:
  some slippers
  a sticky note
  some chewing gum (being chewed)
  a To-Do list
  a repair corps uniform (being worn)
  a toolbox

>put all on bunk
slippers: Putting things on the bunk bed would achieve nothing.
sticky note: Putting things on the bunk bed would achieve nothing.
chewing gum: (first spitting out the chewing gum)
You stick the chewing gum to the bunk bed.

To-Do list: You need that to write on.

toolbox: [No. That's my life right there.]

>x bunk
A fairly typical military bunk bed.

Some chewing gum is stuck to the bunk bed.

>take gum
You unstick the chewing gum from the bunk bed.

>take all
But you don't see anything.

>d
You get off the top bunk.

Starboard-Side Crew Quarters
All crew members who aren't the captain sleep in this or the opposite-side bunk room. This one sleeps two in a bunk bed, done up with military precision. There is a large cabinet here, stretching almost to the ceiling. It is closed. Mounted in the wall is a crew personal storage unit. The sole exit is to port.

>put all on bottom bunk
used chewing gum: You stick the chewing gum to the bottom bunk.

slippers: Done.
sticky note: Done.
To-Do list: You need that to write on.

toolbox: [No. That's my life right there.]

>l
Starboard-Side Crew Quarters
All crew members who aren't the captain sleep in this or the opposite-side bunk room. This one sleeps two in a bunk bed, done up with military precision. There is a large cabinet here, stretching almost to the ceiling. It is closed. Mounted in the wall is a crew personal storage unit. The sole exit is to port.

You see a sticky note and some slippers on the bottom bunk.

The bottom bunk has chewing gum stuck to it.

>stick gum to bottom bunk
(first removing the chewing gum from the bottom bunk)
You stick the chewing gum to the bottom bunk.

>l
Starboard-Side Crew Quarters
All crew members who aren't the captain sleep in this or the opposite-side bunk room. This one sleeps two in a bunk bed, done up with military precision. There is a large cabinet here, stretching almost to the ceiling. It is closed. Mounted in the wall is a crew personal storage unit. The sole exit is to port.

You see a sticky note and some slippers on the bottom bunk.

The bottom bunk has chewing gum stuck to it.

>take gum
You unstick the chewing gum from the bottom bunk.

Attention all crew: command functions are offline and the computer is running with decreased capabilities. Full system reboot required.

>stick gum to slippers
You stick the chewing gum to the slippers.

>l
Starboard-Side Crew Quarters
All crew members who aren't the captain sleep in this or the opposite-side bunk room. This one sleeps two in a bunk bed, done up with military precision. There is a large cabinet here, stretching almost to the ceiling. It is closed. Mounted in the wall is a crew personal storage unit. The sole exit is to port.

You see a sticky note and some slippers with chewing gum stuck to them on the bottom bunk.

>take all
sticky note: Taken.
slippers: Taken.

>take gum
You unstick the chewing gum from the slippers.

The chewing gum has become stuck to the slippers.

>chew it
You can't chew the gum when it's stuck to the slippers.

>i
You are carrying:
  some slippers with chewing gum stuck to them
  a sticky note
  a To-Do list
  a repair corps uniform (being worn)
  a toolbox

>stick gum to slippers
(first removing the chewing gum from the slippers)
You stick the chewing gum to the slippers.

>wear slippers
You put on the slippers.

>x me
Nice uniform, even with the slippers, which look even sillier with that gum stuck to them.

>take gum then stick it to the repair uniform
You unstick the chewing gum from the slippers.

You stick the chewing gum to the repair corps uniform.

>x me
Nice uniform, even with the slippers, but you should get the gum off of it.

>take gum
You unstick the chewing gum from the repair corps uniform.

>chew it
[Eww. That gum has gotten gross. No way.]

>p
Junction
This is a busy place when the ship is populated. To port and starboard are the crew quarters, aft is the closed door to the captain's private quarters, and fore is the galley. A ladder leads down to the staging area.

Attention all crew: command functions are offline and the computer is running with decreased capabilities. Full system reboot required.

>p
Port-Side Crew Quarters
All crew members who aren't the captain sleep in this or the opposite-side bunk room. This one sleeps two in a bunk bed, done up with military precision. There is a large cabinet here, stretching almost to the ceiling. It is closed. Mounted in the wall is a crew personal storage unit. The sole exit is to starboard.

The chewing gum has become stuck to the sticky note.

>open cabinet
You open the port-side equipment cabinet, revealing an engineering uniform and an Universal Game Emulator.

>take uniform
(the engineering uniform)
Taken.

>s
Junction
This is a busy place when the ship is populated. To port and starboard are the crew quarters, aft is the closed door to the captain's private quarters, and fore is the galley. A ladder leads down to the staging area.

>f
Galley
This narrow space is barely enough room for two Marines to prepare and eat a meal. There is a counter with a drawer, and two stools, a microwave oven, and a large closet here. Pots and pans hang from hooks in the ceiling. A ladder leads up through the midship door, and you can leave aft.

On the starboard wall is a panel on which is a blue button. Tacked to the panel is the operator's manual for the midship door.

You faintly hear someone speaking above.

>press button
Which do you mean, the Cook button or the blue button?

>cook
You press the Cook button on the microwave oven. Nothing happens, but it's unclear why.

>a
Junction
This is a busy place when the ship is populated. To port and starboard are the crew quarters, aft is the closed door to the captain's private quarters, and fore is the galley. A ladder leads down to the staging area.

>p
Port-Side Crew Quarters
All crew members who aren't the captain sleep in this or the opposite-side bunk room. This one sleeps two in a bunk bed, done up with military precision. There is a large cabinet here, stretching almost to the ceiling. It is open and contains an Universal Game Emulator. Mounted in the wall is a crew personal storage unit. The sole exit is to starboard.

>l
Port-Side Crew Quarters
All crew members who aren't the captain sleep in this or the opposite-side bunk room. This one sleeps two in a bunk bed, done up with military precision. There is a large cabinet here, stretching almost to the ceiling. It is open and contains an Universal Game Emulator. Mounted in the wall is a crew personal storage unit. The sole exit is to starboard.

>play uge
You need to say "play <game> on UGE". Note that you actually have to have the game you want to play. The UGE doesn't come with any games installed.

>s
Junction
This is a busy place when the ship is populated. To port and starboard are the crew quarters, aft is the closed door to the captain's private quarters, and fore is the galley. A ladder leads down to the staging area.

>n
I'm not sure what you're trying to say. I might just not recognize the words you're using.

>f
Galley
This narrow space is barely enough room for two Marines to prepare and eat a meal. There is a counter with a drawer, and two stools, a microwave oven, and a large closet here. Pots and pans hang from hooks in the ceiling. A ladder leads up through the midship door, and you can leave aft.

On the starboard wall is a panel on which is a blue button. Tacked to the panel is the operator's manual for the midship door.

You faintly hear someone speaking above.

>unplug microwave
(the microwave oven)
You unplug the microwave oven.

>x socket
It's an ordinary grounded wall socket. Upon close inspection, you notice that it's clogged up with dust.

>clean socket
Your fingers won't fit into the socket to reach the dust.

Attention all crew: command functions are offline and the computer is running with decreased capabilities. Full system reboot required.

>clean socket with suit
You can't see any such thing.

>i
You are carrying:
  an engineering uniform
    a piece of note paper
  some slippers (being worn)
  a sticky note with chewing gum stuck to it
  a To-Do list
  a repair corps uniform (being worn)
  a toolbox

>e
I'm not sure what you're trying to say. I might just not recognize the words you're using.

>s
The obvious exits are aft (to junction) and up.

>a
Junction
This is a busy place when the ship is populated. To port and starboard are the crew quarters, aft is the closed door to the captain's private quarters, and fore is the galley. A ladder leads down to the staging area.

* * *

>d
Staging Area
This is the staging area of the ship, where marines prepare for missions. It is adjacent to the aft airlock. Locked compartments set into the walls hold various munitions. A ladder leads up into the rest of the ship. 

An equipment locker is sprawled across the room, with its door to the ground.
 
Through the airlock windows you see the blank space left by the destruction of Space Station Omicron-5.

What looks like part of an engine is stowed in a corner.

A vac suit is here, lying prone as if it were some malformed yellow person knocked unconscious by the shaking of the ship.

>wear suit
(first taking the vac suit)
The mag boots won't fit over your slippers.

>remove slippers
You take off the slippers.

>wear suit
You put on the vac suit.

>u
Junction
This is a busy place when the ship is populated. To port and starboard are the crew quarters, aft is the closed door to the captain's private quarters, and fore is the galley. A ladder leads down to the staging area.

>f
Galley
This narrow space is barely enough room for two Marines to prepare and eat a meal. There is a counter with a drawer, and two stools, a microwave oven, and a large closet here. Pots and pans hang from hooks in the ceiling. A ladder leads up through the midship door, and you can leave aft.

On the starboard wall is a panel on which is a blue button. Tacked to the panel is the operator's manual for the midship door.

You faintly hear someone speaking above.

>clean socket with suit
You blow the dust out of the socket with the vac suit.

>undo
Galley
[Previous turn undone.]

>drop suit
(first taking the vac suit off)
Dropped.

>clean socket with suit
(first taking the vac suit)
You blow the dust out of the socket with the vac suit.

>undo
Galley
[Previous turn undone.]

>take suit
Taken.

>clean socket with suit
You blow the dust out of the socket with the vac suit.

* * *

>undo
Galley
[Previous turn undone.]

>a
Junction
This is a busy place when the ship is populated. To port and starboard are the crew quarters, aft is the closed door to the captain's private quarters, and fore is the galley. A ladder leads down to the staging area.

>drop suit
Dropped.

>f
Galley
This narrow space is barely enough room for two Marines to prepare and eat a meal. There is a counter with a drawer, and two stools, a microwave oven, and a large closet here. Pots and pans hang from hooks in the ceiling. A ladder leads up through the midship door, and you can leave aft.

On the starboard wall is a panel on which is a blue button. Tacked to the panel is the operator's manual for the midship door.

You faintly hear someone speaking above.

>clean socket with suit
You can't see any such thing.

>a
Junction
This is a busy place when the ship is populated. To port and starboard are the crew quarters, aft is the closed door to the captain's private quarters, and fore is the galley. A ladder leads down to the staging area.

You can see a vac suit here.

Attention all crew: command functions are offline and the computer is running with decreased capabilities. Full system reboot required.

>get suit
Taken.

>clean socket with suit
You can't see any such thing.

>vent air
You let a unit of air out of the suit.

>vent air at me
You blow a little air at yourself. Nothing much seems to happen.

>x air gauge
The gauge indicates the suit has 14 units of air left.

>f
Galley
This narrow space is barely enough room for two Marines to prepare and eat a meal. There is a counter with a drawer, and two stools, a microwave oven, and a large closet here. Pots and pans hang from hooks in the ceiling. A ladder leads up through the midship door, and you can leave aft.

On the starboard wall is a panel on which is a blue button. Tacked to the panel is the operator's manual for the midship door.

You faintly hear someone speaking above.

>vent air at socket
You blow the dust out of the socket with the vac suit.

>vent air at socket
You blow some more air into the socket, but there's no more dust.

>undo
Galley
[Previous turn undone.]

>undo
Galley
[Previous turn undone.]

>clean socket with suit
You blow the dust out of the socket with the vac suit.

>g
You blow some more air into the socket, but there's no more dust.

>undo
Galley
[Previous turn undone.]

>clean socket with nozzle
(first taking the nozzle)
That seems to be a part of the vac suit.

* * *

Luna Spacewerks Company has no description.
tiny piece of debris has no description.
Typing it on has no description.

Crash
An Interactive Disaster by Phil Riley
Release 18 / Serial number 221104 / Inform 7 build 6M62 (I6/v6.34 lib 6/12N) SD

Space Station Gangway
This is the pressurized bridge from Space Station Omicron-5 to the SS Usagi. Behind you is the familiar bulk of the huge station, largest outpost of the Space Authority in Deneb Sector. Before you is the aft airlock of the Usagi, beckoning you in.

[Better get a move on], you think.

>x toolboc
You can't see any such thing.

>x toolboc
You can't see any such thing.

>x toolbox
Your toolbox holds wrenches, screwdrivers, pliers, and an assortment of various fasteners.

>showme debris
(the small piece of debris)
small piece of debris - thing
location: in Hull of the Usagi (vacuum)
singular-named, improper-named; unlit, inedible, portable, unseen, unfamiliar, screwed
list grouping key: none
printed name: "small piece of debris"
printed plural name: none
indefinite article: none
description: "It seems like a chunk of what might have been terracotta tile before it was blown up."
initial appearance: "It looks like you could break off a small piece of debris."
last utterance: none
readable text: none
voice locale: yourself