Luna Spacewerks Company has no description.
tiny piece of debris has no description.
Typing it on has no description.

Crash
An Interactive Disaster by Phil Riley
Release 18 / Serial number 221123 / Inform 7 build 6M62 (I6/v6.34 lib 6/12N) SD

Space Station Gangway
This is the pressurized bridge from Space Station Omicron-5 to the SS Usagi. Behind you is the familiar bulk of the huge station, largest outpost of the Space Authority in Deneb Sector. Before you is the aft airlock of the Usagi, beckoning you in.

[Better get a move on], you think.

>f
You pass into the aft airlock, the outer door closing behind you.

The Second Law of Thermodynamics, in one formulation, states that disorganization always increases in the absence of some outside force. A corollary is that things will always break down in the absence of someone to fix them. As a member of the repair corps of Space Station Omicron-5, you're that someone.

Your last assignment of the day, on the SS Usagi, a Space Marines fighting ship, looks routine enough. Fix the microwave and a jammed cabinet door, and then you're off for the day.

Aft Airlock
You are in the aft airlock. Outside is the gangway back to Space Station Omicron-5. Forward leads into the ship.

A pleasant androgynous voice says, "Welcome to the SS Usagi. This is the shipboard computer. Please feel free to call upon me for any information you may need. Use the command 'computer, help' for more information."

* * *

>f
You enter the ship from the airlock. The inner door closes behind you.

Staging Area
This is the staging area of the ship, where marines prepare for missions. It is adjacent to the aft airlock. It houses a number of vac suits in an open locker, and various munitions in locked compartments set into the walls. A ladder leads up into the rest of the ship. 
Through the airlock windows you can see the gangway to Space Station Omicron-5.

What looks like part of an engine is stowed in a corner.

>u
You climb the la--

***BOOM***

Press any key...

A gigantic force grabs the ship, knocking you off the ladder and sending you flying against an aft bulkhead. The inertial dampers are probably all that saved you from being smashed to jelly rather than just banged up. 

Press any key...

Some time later you find yourself lying on the floor of the staging area with a throbbing headache. Gingerly you push yourself to your knees and stand up. The vac suit locker has detached from its mounting and lies face down on the floor.

[Thank god I wasn't in the way of that.]

Looking outside --

[Holy -- ]

[Where's the station?].

Where Space Station Omicron-5 was, is now an expanding sphere of rubble, dimly lit by the blue light of far-off Deneb. The rubble is clearly receding behind the ship. [We're moving!]

[How am I going to get off this ship?]

Press any key...

Crash
An Interactive Disaster by Phil Riley
Release 18 / Serial number 221123 / Inform 7 build 6M62 (I6/v6.34 lib 6/12N) SD

Staging Area
This is the staging area of the ship, where marines prepare for missions. It is adjacent to the aft airlock. Locked compartments set into the walls hold various munitions. A ladder leads up into the rest of the ship. 

An equipment locker is sprawled across the room, with its door to the ground.
 
Through the airlock windows you see the blank space left by the destruction of Space Station Omicron-5.

What looks like part of an engine is stowed in a corner.

A vac suit is here, lying prone as if it were some malformed yellow person knocked unconscious by the shaking of the ship.

[What now?]

[I think I spit out my gum.]

>chew gum
You can't chew the gum when it's stuck to the repair corps uniform.

Attention all crew: command functions are offline and the computer is running with decreased capabilities. Full system reboot required. There is also an oxygen leak due to a jammed vent cover on the external hull.

You add an item ("close the vent") to your to-do list.

>take gum
You unstick the chewing gum from the repair corps uniform.

The chewing gum has become stuck to the toolbox.

>take gum
You unstick the chewing gum from the toolbox.

* * *

>s
Starboard-Side Crew Quarters
All crew members who aren't the captain sleep in this or the opposite-side bunk room. This one sleeps two in a bunk bed, done up with military precision. There is a large cabinet here, stretching almost to the ceiling. It is closed. Mounted in the wall is a crew personal storage unit. The sole exit is to port.

In a shocking lapse of military precision, there is a sticky note attached to the bed post.

A pair of slippers peeks out from under the bed.

>purloin small key
[Purloined.]

>open keypad
It seems to be locked.

>unlock keypad
(with the small key)
You open the front panel of the keypad, revealing a bundle of wiring.

>x wires
The wires look intact and functional.

>x wiring
You can't see any such thing.

* * *

>take gum
You unstick the chewing gum from the repair corps uniform.

Attention all crew: command functions are offline and the computer is running with decreased capabilities. Full system reboot required. There is also an oxygen leak due to a jammed vent cover on the external hull.

You add an item ("close the vent") to your to-do list.

>chew it
You put the chewing gum in your mouth.

* * *

>open present
[I'll go to hell for this, but here goes...]

You rip off the wrapping paper and open the box. Inside is a stuffed bear you recognize as Bertie the Bear™. You discard the paper and box.

>take trunk
Taken.

* * *

>d
Staging Area
This is the staging area of the ship, where marines prepare for missions. It is adjacent to the aft airlock. Locked compartments set into the walls hold various munitions. A ladder leads up into the rest of the ship. 

An equipment locker is sprawled across the room, with its door to the ground.
 
Through the airlock windows you see the blank space left by the destruction of Space Station Omicron-5.

What looks like part of an engine is stowed in a corner.

A vac suit is here, lying prone as if it were some malformed yellow person knocked unconscious by the shaking of the ship.

>drop trunk
You place the black trunk near the airlock door.

>stand on it
(first closing the black trunk)
You get onto the black trunk.

>take eyes
[Am I really going to do this? Yes, yes, I am, apparently.]

You grasp one of the eyes and give it a tug, first softly then harder. Eventually it gives and you extract the eye from the bear. Upon examination you discover that the eye is in fact an optical sensor in camouflage. It looks like you didn't pull it carefully enough, however, because the connector at the end has been damaged.

You try again more carefully with the second eye, and manage to produce an undamaged optical sensor.

>replace sensor
You remove the broken sensor and insert the fresh sensor into the empty socket.
[There. That should do it.]

It seems you completed something ("fix the airlock door") that wasn't on your to-do list. You note it down.

[Your score has just gone up by one point.]

>x panel
The prominent features of the panel are two optical sensors. They are both in working order now.

>showme broken sensor
broken sensor - thing
location: in the Room of Stuff
singular-named, improper-named; unlit, inedible, portable, unseen, unfamiliar, screwed
list grouping key: none
printed name: "broken sensor"
printed plural name: none
indefinite article: none
description: "You can tell it's broken because the connecting prongs are too short."
initial appearance: none
last utterance: none
readable text: none
voice locale: yourself

* * *

>x panel
The prominent features of the panel are two optical sensors. They are both in working order now.

>x intake
This is an aperture through which air is pulled for recycling. Even if you knew how, you wouldn't dare open it for fear of wrecking the air scrubber.

Attention all crew: command functions are offline and the computer is running with decreased capabilities. Full system reboot required. There is also an oxygen leak due to a jammed vent cover on the external hull.

* * *

>stand on it
(first closing the black trunk)
You get onto the black trunk.

>take sensor
(the broken sensor)
You remove the broken sensor from the panel.

>get off trunk
You get off the black trunk.

Staging Area
This is the staging area of the ship, where marines prepare for missions. It is adjacent to the aft airlock. Locked compartments set into the walls hold various munitions. A ladder leads up into the rest of the ship. 

An equipment locker is sprawled across the room, with its door to the ground.
 
Through the airlock windows you see the blank space left by the destruction of Space Station Omicron-5.

What looks like part of an engine is stowed in a corner.

A vac suit is here, lying prone as if it were some malformed yellow person knocked unconscious by the shaking of the ship.

You can also see a black trunk (closed) here.

>take sensor
[Am I really going to do this? Yes, yes, I am, apparently.]

You grasp one of the eyes and give it a tug, first softly then harder. Eventually it gives and you extract the eye from the bear. Upon examination you discover that the eye is in fact an optical sensor in camouflage. It looks like you didn't pull it carefully enough, however, because the connector at the end has been damaged.

You try again more carefully with the second eye, and manage to produce an undamaged optical sensor.

>undo
Staging Area
[Previous turn undone.]

>stand on trunk
You get onto the black trunk.

>take sensor
Which do you mean, the eyes or the broken sensor?

>get off trunk
You get off the black trunk.

Staging Area
This is the staging area of the ship, where marines prepare for missions. It is adjacent to the aft airlock. Locked compartments set into the walls hold various munitions. A ladder leads up into the rest of the ship. 

An equipment locker is sprawled across the room, with its door to the ground.
 
Through the airlock windows you see the blank space left by the destruction of Space Station Omicron-5.

What looks like part of an engine is stowed in a corner.

A vac suit is here, lying prone as if it were some malformed yellow person knocked unconscious by the shaking of the ship.

You can also see a black trunk (closed) here.

>get on locker
You get onto the vac suit locker.

Attention all crew: command functions are offline and the computer is running with decreased capabilities. Full system reboot required. There is also an oxygen leak due to a jammed vent cover on the external hull.

>get sensor
[Am I really going to do this? Yes, yes, I am, apparently.]

You grasp one of the eyes and give it a tug, first softly then harder. Eventually it gives and you extract the eye from the bear. Upon examination you discover that the eye is in fact an optical sensor in camouflage. It looks like you didn't pull it carefully enough, however, because the connector at the end has been damaged.

You try again more carefully with the second eye, and manage to produce an undamaged optical sensor.

>undo
Staging Area
[Previous turn undone.]

>stand on trunk
(getting off the vac suit locker)
You get onto the black trunk.

* * *

>take sensor
(the broken sensor)
You remove the broken sensor from the panel.

>take sensor
(the broken sensor)
You already have that.

>x eyes
They're well disguised, but the eyes are clearly top-of-the-line optical sensors that you might see in more serious uses, such as in facial recognition devices.

>take eyes
[Am I really going to do this? Yes, yes, I am, apparently.]

You grasp one of the eyes and give it a tug, first softly then harder. Eventually it gives and you extract the eye from the bear. Upon examination you discover that the eye is in fact an optical sensor in camouflage. It looks like you didn't pull it carefully enough, however, because the connector at the end has been damaged.

You try again more carefully with the second eye, and manage to produce an undamaged optical sensor.

Attention all crew: command functions are offline and the computer is running with decreased capabilities. Full system reboot required. There is also an oxygen leak due to a jammed vent cover on the external hull.

>i
You are carrying:
  a new optical sensor
  a broken sensor
  Bertie the Bear™
  some chewing gum (being chewed)
  a To-Do list
  a repair corps uniform (being worn)
  a toolbox

* * *

Luna Spacewerks Company has no description.
tiny piece of debris has no description.
Typing it on has no description.

Crash
An Interactive Disaster by Phil Riley
Release 18 / Serial number 221123 / Inform 7 build 6M62 (I6/v6.34 lib 6/12N) SD

Space Station Gangway
This is the pressurized bridge from Space Station Omicron-5 to the SS Usagi. Behind you is the familiar bulk of the huge station, largest outpost of the Space Authority in Deneb Sector. Before you is the aft airlock of the Usagi, beckoning you in.

[Better get a move on], you think.

>gonear command console
The Second Law of Thermodynamics, in one formulation, states that disorganization always increases in the absence of some outside force. A corollary is that things will always break down in the absence of someone to fix them. As a member of the repair corps of Space Station Omicron-5, you're that someone.

Your last assignment of the day, on the SS Usagi, a Space Marines fighting ship, looks routine enough. Fix the microwave and a jammed cabinet door, and then you're off for the day.

Bridge
This is where the captain, navigator, and pilot all sit. Large viewscreens give a full view of the space around the ship. To port you can see the blue-white disk of Deneb. Astern you can faintly see the fading embers of what was Space Station Omicron-5.
 
The pilot's and navigator's chairs sit before the large helm console. The captain's chair, with command console, sits halfway between them and operations further aft.

You hear someone speaking aft of here.

>touch console
Unauthorized access attempted. This event has been logged by security.

>touch hand
Unauthorized access attempted. This event has been logged by security.

>touch outline
Unauthorized access attempted. This event has been logged by security.

>gonear junction
Junction
This is a busy place when the ship is populated. To port and starboard are the crew quarters, aft is the closed door to the captain's private quarters, and fore is the galley. A ladder leads down to the staging area.

⇒ You can enter "hints" at any time for help in progressing in the game.

>purloin key
Which do you mean, Access key or the small key?

* * *

>small
[Purloined.]

>s
Starboard-Side Crew Quarters
All crew members who aren't the captain sleep in this or the opposite-side bunk room. This one sleeps two in a bunk bed, done up with military precision. There is a large cabinet here, stretching almost to the ceiling. It is closed. Mounted in the wall is a crew personal storage unit. The sole exit is to port.

In a shocking lapse of military precision, there is a sticky note attached to the bed post.

A pair of slippers peeks out from under the bed.

>unlock keypad
(with the small key)
You open the front panel of the keypad, revealing a bundle of wiring.

>x wiring
The wires look intact and functional.

>x wires
The wires look intact and functional.

>x keypad wiring
The wires look intact and functional.

>gonear command console
Bridge
This is where the captain, navigator, and pilot all sit. Large viewscreens give a full view of the space around the ship. To port you can see the blue-white disk of Deneb. Astern you can faintly see the fading embers of what was Space Station Omicron-5.
 
The pilot's and navigator's chairs sit before the large helm console. The captain's chair, with command console, sits halfway between them and operations further aft.

You hear someone speaking aft of here.

>purloin hex
[Purloined.]

>x helm
(the helm table)
The helm is a sloped table covered with cryptic readouts and touch controls. In the back is an access panel which is closed. A hex-shaped aperture is probably the locking mechanism.

>open panel
It seems to be locked.

>x panelk
You can't see any such thing.

>x panel
The access panel is a rectangle of the same plastic that makes up the console. There is a hex-shaped keyhole in it.

>unlock panel with hex
You unlock the helm access panel.

>open it
Opening the helm access panel reveals an array of wiring and circuit boards.

* * *

>x boards
There's a lot of it.

>x wires
You can't see any such thing.