Crash
An Interactive Disaster by Phil Riley
Release 17 / Serial number 221017 / Inform 7 build 6M62 (I6/v6.34 lib 6/12N) SD

Space Station Gangway
This is the pressurized bridge from Space Station Omicron-5 to the SS Usagi. Behind you is the familiar bulk of the huge station, largest outpost of the Space Authority in Deneb Sector. Before you is the aft airlock of the Usagi, beckoning you in.

[Better get a move on], you think.

>f
You pass into the aft airlock, the outer door closing behind you.

The Second Law of Thermodynamics, in one formulation, states that disorganization always increases in the absence of some outside force. A corollary is that things will always break down in the absence of someone to fix them. As a member of the repair corps of Space Station Omicron-5, you're that someone.

Your last assignment of the day, on the SS Usagi, a Space Marines fighting ship, looks routine enough. Fix the microwave and a jammed locker door, and then you're off for the day.

Aft Airlock
You are in the aft airlock. Outside is the gangway back to Space Station Omicron-5. Forward leads into the ship.

A pleasant androgynous voice says, "Welcome to the SS Usagi. This is the shipboard computer. Please feel free to call upon me for any information you may need. Use the command 'computer, help' for more information."

* * *

>f
You enter the ship from the airlock. The inner door closes behind you.

Staging Area
This is the staging area of the ship, where marines prepare for missions. It is adjacent to the aft airlock. It houses a number of vac suits in an open locker, and various munitions in locked compartments set into the walls. A ladder leads up into the rest of the ship. 
Through the airlock windows you can see the gangway to Space Station Omicron-5.

What looks like part of an engine is stowed in a corner.

>ask computer about engine
(the brand-new JL-758)
The JL-758 is a widely-used model of engine stabilizer produced by Luna Spacewerks.

>x engine
This is a wide, low, trapezoidal hunk of metal bearing the marking JL-758 on one side. Numerous electrical contacts dot the upper surface. Someone has threaded a thick cord with clips on both ends through some openings on the top and side.

>ask computer about luna
The moon of Earth, often called simply "The Moon", is famously the first extraterrestrial body inhabited by humans.

>ask computer about spacewerks
I'm unable to give you any information about spacewerks.

>ask computer about luna spacewerks
I'm unable to give you any information about luna spacewerks.

>ask computer about engine stabilizer
The JL-758 is a widely-used model of engine stabilizer produced by Luna Spacewerks.

>purloin rope
Which do you mean, the EVA transport line or the woven cord?

>EVA
[Purloined.]

>i
You are carrying:
  an EVA transport line
  some chewing gum (being chewed)
  a To-Do list
  a repair corps uniform (being worn)
  a toolbox

>a
Your work is in the ship, not outside.

>u
You climb the la--

***BOOM***

Press any key...

A gigantic force grabs the ship, knocking you off the ladder and sending you flying against an aft bulkhead. The inertial dampers are probably all that saved you from being smashed to jelly rather than just banged up. 

Press any key...

Some time later you find yourself lying on the floor of the staging area with a throbbing headache. Gingerly you push yourself to your knees and stand up. The vac suit locker has detached from its mounting and slammed into the airlock door.

[Thank god I wasn't in the way of that.]

Looking outside --

[Holy -- ]

[Where's the station?].

Where Space Station Omicron-5 was, is now an expanding sphere of rubble, dimly lit by the blue light of far-off Deneb. The rubble is clearly receding behind the ship. [We're moving!]

[How am I going to get off this ship?]

Press any key...

Crash
An Interactive Disaster by Phil Riley
Release 17 / Serial number 221017 / Inform 7 build 6M62 (I6/v6.34 lib 6/12N) SD

Staging Area
This is the staging area of the ship, where marines prepare for missions. It is adjacent to the aft airlock. Locked compartments set into the walls hold various munitions. A ladder leads up into the rest of the ship. 

An equipment locker is sprawled across the room, with its door to the ground.
 
Through the airlock windows you see the blank space left by the destruction of Space Station Omicron-5.

What looks like part of an engine is stowed in a corner.

A vac suit is here, lying prone as if it were some malformed yellow person knocked unconscious by the shaking of the ship. It has chewing gum stuck to it.

[What now?]

[I think I spit out my gum.]

>a
You try to enter the airlock, but the automatic door fails to open for you.
[It's always just opened in the past.]

You add an item ("fix the airlock door") to your to-do list.

Attention all crew: command functions are offline and the computer is running with decreased capabilities. Full system reboot required.

>a
You try to enter the airlock, but the automatic door fails to open for you.
[It's always just opened in the past.]

>gonear aft airlock
Staging Area
This is the staging area of the ship, where marines prepare for missions. It is adjacent to the aft airlock. Locked compartments set into the walls hold various munitions. A ladder leads up into the rest of the ship. 

An equipment locker is sprawled across the room, with its door to the ground.
 
Through the airlock windows you see the blank space left by the destruction of Space Station Omicron-5.

What looks like part of an engine is stowed in a corner.

A vac suit is here, lying prone as if it were some malformed yellow person knocked unconscious by the shaking of the ship. It has chewing gum stuck to it.

>gonear spacewalk
Which do you mean, Outside the Aft Airlock (vacuum), Hull of the Usagi (vacuum), or Outside the Engineering Airlock (vacuum)?

>outside the aft airlock
I only understood you as far as wanting to gonear outside.

>gonear outside the aft airlock
I only understood you as far as wanting to gonear outside.

>gonear hull
(Hull Integrity)
Room of Stuff
dummy description

A vac suit is here, lying prone as if it were some malformed yellow person knocked unconscious by the shaking of the ship.

You can also see some chewing gum, Input 4, Input 3, Input 2, Input 1, Tachyon Crystals, Anti-Helium, Liquid Copernicium, Red Matter, Unobtainium, Oganesson, Void Matter, Empty-space, a brochure, a broken sensor, Typing it on, Captain's Affair, a blue screw, a cooked dinner, subj-rebooting-computer, Private Akin Abimbola, Private First Class Friedrich Jäger, Gunnery Sergeant Somchai Khotpanya, Corporal Delores Franck, gravity, Irion, Pollux VI, Pollux III, Hull Integrity, Life support, Milky Way, Cygnus, Pluto, Neptune, Uranus, Tethys, Saturn, Europa, Jupiter, Mars, Venus, Mercury, a moon, Earth, a Sun, Access key, New Da Nang, a Deneb separatists, Location of the ship, Pollux star, a Space Force, Space Authority, Deneb III planet, Orion Marine Academy, Delphi Engine Controls LLC, Substance Injection, Element Copernicium, Luna Spacewerks Parsec VI, Delphi Engine Controls Aleph-Null, Operation Dalmatian, a Space Marines, Deneb sector, Deneb II, Deneb IV, Deneb System, Destroying the ship, engine status, security code, mulgrew's-code, Emergency protocols, Identity of the player, a Pilot, a Navigator, a cardboard box (empty), some wrapping paper, Bertie the Bear™, a new optical sensor, a black trunk (closed), a null card, Vacuum-suit, Captain Jane Mulgrew, Fuel injection specification, and a shipboard computer floating here.

"I said to return to your post, Ensign Seventh Class!" bellows Blather, turning a deepening shade of crimson.

>z
Time passes.

"I said to return to your post, Ensign Seventh Class!" bellows Blather, turning a deepening shade of crimson.

>restart
Are you sure you want to restart?

>y
Crash
An Interactive Disaster by Phil Riley
Release 17 / Serial number 221017 / Inform 7 build 6M62 (I6/v6.34 lib 6/12N) SD

Space Station Gangway
This is the pressurized bridge from Space Station Omicron-5 to the SS Usagi. Behind you is the familiar bulk of the huge station, largest outpost of the Space Authority in Deneb Sector. Before you is the aft airlock of the Usagi, beckoning you in.

[Better get a move on], you think.

* * *

>get do
You can't see any such thing.

>get d
You must name something more substantial.

>d
You get off the top bunk.

Starboard-Side Crew Quarters
All crew members who aren't the captain sleep in this or the opposite-side bunk room. This one sleeps two in a bunk bed, done up with military precision. There is a large cabinet here, stretching almost to the ceiling. It is closed. Mounted in the wall is a crew personal storage unit. The sole exit is to port.

In a shocking lapse of military precision, there is a sticky note attached to the bed post.

You can also see a cardboard box (empty) and some wrapping paper here.

>open cabinet
You open the starboard-side equipment cabinet, revealing a beacon.

>take beacon
Taken.

>p
Junction
This is a busy place when the ship is populated. To port and starboard are the crew quarters, aft is the closed door to the captain's private quarters, and fore is the galley. A ladder leads down to the staging area.

* * *

>p
Port-Side Crew Quarters
All crew members who aren't the captain sleep in this or the opposite-side bunk room. This one sleeps two in a bunk bed, done up with military precision. There is a large cabinet here, stretching almost to the ceiling. It is closed. Mounted in the wall is a crew personal storage unit. The sole exit is to starboard.

>put key in keyhole
You open the front panel of the keypad, revealing a bundle of wiring.

>x wirint
You can't see any such thing.

>x wiring
You can't see any such thing.

>type 53456
You need to close the keypad before you can type on it.

>close keypad
You close the keypad.

>type 53456
As you press a key, the storage unit starts buzzing continuously. The display lights up with random characters, and you smell the distinct odor of burning wires. The bottom drawer pops out a centimeter or two.

You add an item ("fix the storage unit") to your to-do list.

>put key in keyhole
You open the front panel of the keypad, revealing a bundle of wiring. You can see the problem immediately -- two wires with worn insulation are in contact, causing a short-circuit.

* * *

>u
Junction
This is a busy place when the ship is populated. To port and starboard are the crew quarters, aft is the closed door to the captain's private quarters, and fore is the galley. A ladder leads down to the staging area.

⇒ You can enter "hints" at any time for help in progressing in the game.
Attention all crew: command functions are offline and the computer is running with decreased capabilities. Full system reboot required.

>open panel
You open the panel, hanging on to the blue screw that held it shut.

The access panel opens to reveal a row of fuses, one of which is blown.

>replace fuse
You don't have a suitable fuse.

* * *

Crash
An Interactive Disaster by Phil Riley
Release 17 / Serial number 221017 / Inform 7 build 6M62 (I6/v6.34 lib 6/12N) SD

Space Station Gangway
This is the pressurized bridge from Space Station Omicron-5 to the SS Usagi. Behind you is the familiar bulk of the huge station, largest outpost of the Space Authority in Deneb Sector. Before you is the aft airlock of the Usagi, beckoning you in.

[Better get a move on], you think.

>gonear helm
(the helm access panel)

The Second Law of Thermodynamics, in one formulation, states that disorganization always increases in the absence of some outside force. A corollary is that things will always break down in the absence of someone to fix them. As a member of the repair corps of Space Station Omicron-5, you're that someone.

Your last assignment of the day, on the SS Usagi, a Space Marines fighting ship, looks routine enough. Fix the microwave and a jammed locker door, and then you're off for the day.

Bridge
This is where the captain, navigator, and pilot all sit. Large viewscreens give a full view of the space around the ship. To port you can see the blue-white disk of Deneb. Astern you can faintly see the fading embers of what was Space Station Omicron-5.
 
The pilot's and navigator's chairs sit before the large helm console. The captain's chair, with command console, sits halfway between them and operations further aft.

You hear someone speaking aft of here.

>open access panel
It seems to be locked.

>purloin hex
[Purloined.]

>purloin hex
[Purloined.]

>open access panel
It seems to be locked.

>open access panel with hex
You unlock the helm access panel.

>open access panel
Opening the helm access panel reveals an array of wiring and circuit boards.

>x it
Inside the panel is a maze of wiring and circuit boards.

>x wiring
There's a lot of it.

>x boards
There's a lot of it.

>x cicuit
You can't see any such thing.

>x circuit
There's a lot of it.

>x maze
You can't see any such thing.

>showme aperture
aperture - thing
location: part of the helm access panel , which is part of the helm table in Bridge
singular-named, improper-named; unlit, inedible, portable, seen, familiar, screwed
list grouping key: none
printed name: "aperture"
printed plural name: none
indefinite article: none
description: none
initial appearance: none
last utterance: none
readable text: none
voice locale: yourself

>x aperture
You see nothing special about the aperture.

>x keyhole
(the aperture)
You see nothing special about the aperture.

* * *

>open access panel
It seems to be locked.

>unlock it
You must specify what you want to unlock the helm access panel with.

>purloin hex key
I only understood you as far as wanting to purloin the hex-shaped tool.

>purloin hex
[Purloined.]

>unlock it
You must specify what you want to unlock the hex-shaped tool with.

>unlock access panel with hex
You unlock the helm access panel.

>open it
Opening the helm access panel reveals an array of wiring and circuit boards.

>x wiring
There's a lot of it.

* * *

Crash
An Interactive Disaster by Phil Riley
Release 17 / Serial number 221017 / Inform 7 build 6M62 (I6/v6.34 lib 6/12N) SD

Space Station Gangway
This is the pressurized bridge from Space Station Omicron-5 to the SS Usagi. Behind you is the familiar bulk of the huge station, largest outpost of the Space Authority in Deneb Sector. Before you is the aft airlock of the Usagi, beckoning you in.

[Better get a move on], you think.

>gonear pilot's console
I only understood you as far as wanting to gonear the pilot's chair.

>gonear pilot's chair
The Second Law of Thermodynamics, in one formulation, states that disorganization always increases in the absence of some outside force. A corollary is that things will always break down in the absence of someone to fix them. As a member of the repair corps of Space Station Omicron-5, you're that someone.

Your last assignment of the day, on the SS Usagi, a Space Marines fighting ship, looks routine enough. Fix the microwave and a jammed locker door, and then you're off for the day.

Bridge
This is where the captain, navigator, and pilot all sit. Large viewscreens give a full view of the space around the ship. To port you can see the blue-white disk of Deneb. Astern you can faintly see the fading embers of what was Space Station Omicron-5.
 
The pilot's and navigator's chairs sit before their respective consoles. The captain's chair, with command console, sits halfway between them and operations further aft.

You hear someone speaking aft of here.

>x pilot's console
I only understood you as far as wanting to examine the pilot's chair.

>x pilots console
You can't see any such thing.

>x console
The command console displays the red outline of a hand.

⇒ You can "touch command console" to touch your palm to it.

>x pilot chair
An ergonomically-countoured swivel chair designed for hours of stressful work.
[Nice chair.]

>x navigator chair
An ergonomically-countoured swivel chair designed for hours of stressful work.

>x pilot console
You can't see any such thing.

>x pilot's chair
An ergonomically-countoured swivel chair designed for hours of stressful work.

>x pilot's console
I only understood you as far as wanting to examine the pilot's chair.

>x helm
(the helm table)
The helm is a sloped table covered with cryptic readouts and touch controls. In the back is an access panel which is closed. A hex-shaped aperture is probably the locking mechanism.

>unlock access panel
You can't use multiple objects with that verb.

>unlock helm access panel
You must supply a second noun.

* * *

Crash
An Interactive Disaster by Phil Riley
Release 17 / Serial number 221017 / Inform 7 build 6M62 (I6/v6.34 lib 6/12N) SD

Space Station Gangway
This is the pressurized bridge from Space Station Omicron-5 to the SS Usagi. Behind you is the familiar bulk of the huge station, largest outpost of the Space Authority in Deneb Sector. Before you is the aft airlock of the Usagi, beckoning you in.

[Better get a move on], you think.

>n
Accessibility off.

The Second Law of Thermodynamics, in one formulation, states that disorganization always increases in the absence of some outside force. A corollary is that things will always break down in the absence of someone to fix them. As a member of the repair corps of Space Station Omicron-5, you're that someone.

Your last assignment of the day, on the SS Usagi, a Space Marines fighting ship, looks routine enough. Fix the microwave and a jammed locker door, and then you're off for the day.

Space Station Gangway
This is the pressurized bridge from Space Station Omicron-5 to the SS Usagi. Behind you is the familiar bulk of the huge station, largest outpost of the Space Authority in Deneb Sector. Before you is the aft airlock of the Usagi, beckoning you in.

[Better get a move on], you think.

⇒ Tip: Type "help" to learn about this game, and interactive fiction in general.

* * *

>a
Engineering Deck
The engineering crew is responsible for keeping the physical ship operating. They are in charge of every physical aspect of the ship, from the engines to hull integrity to the life support system.

The engineering deck consists of a large console giving a comprehensive view of the physical status of the ship. There is an airlock to starboard. The operations deck continues forward from here, and there are other exits to aft and port.

You hear someone speaking to fore.

A device labeled "Suit Recharging Station" is here. It is shaped like a chair with nozzles protruding from either arm.

>a
Engine Room
This where the combustion process is controlled. The aft wall is dominated by the operating panel section of the fusion engine. Monitoring electronics and controls cover the other two walls. A doorway opens forward to the Engineering Deck.

There is a large screen on the forward wall. It displays nothing right now. There is a large button below the diagram labeled "Test".

You can see a broken JL-758 here.

>x screen
The diagram screen is black.

I beg your pardon?

>f
Engineering Deck
The engineering crew is responsible for keeping the physical ship operating. They are in charge of every physical aspect of the ship, from the engines to hull integrity to the life support system.

The engineering deck consists of a large console giving a comprehensive view of the physical status of the ship. There is an airlock to starboard. The operations deck continues forward from here, and there are other exits to aft and port.

You hear someone speaking to fore.

A device labeled "Suit Recharging Station" is here. It is shaped like a chair with nozzles protruding from either arm.

>f
Operations Deck
This is where all of the support activity for the bridge occurs. There are large consoles for environmental controls (which include gravity, temperature, and pressure), communications, and power systems here. The bridge continues forward from here, and engineering is aft. There is a door set in the floor with a ladder leading through it. Set in the frame of the door is a blue button.

You can see an equipment trunk (closed) here.

>f
Bridge
This is where the captain, navigator, and pilot all sit. Large viewscreens give a full view of the space around the ship. To port you can see the blue-white disk of Deneb. Astern you can faintly see the fading embers of what was Space Station Omicron-5.
 
The pilot's and navigator's chairs sit before their respective consoles. The captain's chair, with command console, sits halfway between them and operations further aft.

You hear someone speaking aft of here.

>a
Operations Deck
This is where all of the support activity for the bridge occurs. There are large consoles for environmental controls (which include gravity, temperature, and pressure), communications, and power systems here. The bridge continues forward from here, and engineering is aft. There is a door set in the floor with a ladder leading through it. Set in the frame of the door is a blue button.

You can see an equipment trunk (closed) here.

>l
Operations Deck
This is where all of the support activity for the bridge occurs. There are large consoles for environmental controls (which include gravity, temperature, and pressure), communications, and power systems here. The bridge continues forward from here, and engineering is aft. There is a door set in the floor with a ladder leading through it. Set in the frame of the door is a blue button.

You can see an equipment trunk (closed) here.

Master Sergeant R. Mu Arvax: "Hey, friend, we need to reboot the computer soon before it's too late."

>restart
Are you sure you want to restart?

* * *

Crash
An Interactive Disaster by Phil Riley
Release 17 / Serial number 221017 / Inform 7 build 6M62 (I6/v6.34 lib 6/12N) SD

Space Station Gangway
This is the pressurized bridge from Space Station Omicron-5 to the SS Usagi. Behind you is the familiar bulk of the huge station, largest outpost of the Space Authority in Deneb Sector. Before you is the aft airlock of the Usagi, beckoning you in.

[Better get a move on], you think.

>replace fuse
You don't have a suitable fuse.

>f
You pass into the aft airlock, the outer door closing behind you.

The Second Law of Thermodynamics, in one formulation, states that disorganization always increases in the absence of some outside force. A corollary is that things will always break down in the absence of someone to fix them. As a member of the repair corps of Space Station Omicron-5, you're that someone.

Your last assignment of the day, on the SS Usagi, a Space Marines fighting ship, looks routine enough. Fix the microwave and a jammed locker door, and then you're off for the day.

Aft Airlock
You are in the aft airlock. Outside is the gangway back to Space Station Omicron-5. Forward leads into the ship.

A pleasant androgynous voice says, "Welcome to the SS Usagi. This is the shipboard computer. Please feel free to call upon me for any information you may need. Use the command 'computer, help' for more information."

* * *

>u
Junction
This is a busy place when the ship is populated. To port and starboard are the crew quarters, aft is the closed door to the captain's private quarters, and fore is the galley. A ladder leads down to the staging area.

⇒ You can enter "hints" at any time for help in progressing in the game.
Attention all crew: command functions are offline and the computer is running with decreased capabilities. Full system reboot required.

>replace fuse
You don't have a suitable fuse.

>purloin fuse
Which do you mean, the fresh fuse or the blown fuse?

>fresh
[Purloined.]

>replace fuse
There is no fuse to replace.

>open panel
You open the panel, hanging on to the blue screw that held it shut.

The access panel opens to reveal a row of fuses, one of which is blown.

* * *

>replace fuse
(first removing the blown fuse)
You put the fresh fuse into the access panel.

>replace fuse
You've replaced the bad fuse. No need to play with the fuses anymore.

>close panel
When you try to close the access panel, the blue screw slips from your grasp, bounces once, rolls, and falls down the ladder well. At the bottom of the ladder, it bounces once more, right through the grill of an air scrubber intake. That screw's long gone.

>close panel
All of your screws are either too big or too small.

>replace fuse
You've replaced the bad fuse. No need to play with the fuses anymore.

>restart
Are you sure you want to restart?

>y
Crash
An Interactive Disaster by Phil Riley
Release 15 / Serial number 220926 / Inform 7 build 6M62 (I6/v6.34 lib 6/12N) SD

Space Station Gangway
This is the pressurized bridge from Space Station Omicron-5 to the SS Usagi. Behind you is the familiar bulk of the huge station, largest outpost of the Space Authority in Deneb Sector. Before you is the aft airlock of the Usagi, beckoning you in.

[Better get a move on], you think.

>f
You pass into the aft airlock, the outer door closing behind you.

The Second Law of Thermodynamics, in one formulation, states that disorganization always increases in the absence of some outside force. A corollary is that things will always break down in the absence of someone to fix them. As a member of the repair corps of Space Station Omicron-5, you're that someone.

Your last assignment of the day, on the SS Usagi, a Space Marines fighting ship, looks routine enough. Fix the microwave and a jammed locker door, and then you're off for the day.

Aft Airlock
You are in the aft airlock. Outside is the gangway back to Space Station Omicron-5. Forward leads into the ship.

A pleasant androgynous voice says, "Welcome to the SS Usagi. This is the shipboard computer. Please feel free to call upon me for any information you may need. Use the command 'computer, help' for more information."

* * *

>u
Junction
This is a busy place when the ship is populated. To port and starboard are the crew quarters, aft is the closed door to the captain's private quarters, and fore is the galley. A ladder leads down to the staging area.

⇒ You can enter "hints" at any time for help in progressing in the game.
Attention all crew: command functions are offline and the computer is running with decreased capabilities. Full system reboot required.

>repair panel
This is a hard one. You'll have to be more specific about how you do that.

>open panel
You open the panel, hanging on to the blue screw that held it shut.

The access panel opens to reveal a row of fuses, one of which is blown.

>repair panel
This is a hard one. You'll have to be more specific about how you do that.

>purloin fresh fuse
[Purloined.]

>repair panel
This is a hard one. You'll have to be more specific about how you do that.

>replace fuse
(first removing the blown fuse)
You put the fresh fuse into the access panel.

* * *

>f
Engineering Deck
The engineering crew is responsible for keeping the physical ship operating. They are in charge of every physical aspect of the ship, from the engines to hull integrity to the life support system.

The engineering deck consists of a large console giving a comprehensive view of the physical status of the ship. There is an airlock to starboard. The operations deck continues forward from here, and there are other exits to aft and port.

You hear someone speaking to fore.

A device labeled "Suit Recharging Station" is here. It is shaped like a chair with nozzles protruding from either arm.

"9"

>f
Operations Deck
This is where all of the support activity for the bridge occurs. There are large consoles for environmental controls (which include gravity, temperature, and pressure), communications, and power systems here. The bridge continues forward from here, and engineering is aft. There is a door set in the floor with a ladder leading through it. Set in the frame of the door is a blue button.

⇒ You can always find out the current status by asking Arvax about the ship.

You can see an equipment trunk (closed) here.

Attention: current trajectory intersects the moon New Da Nang. Please correct course.

"8"

>ask arvax about ship
(the ss usagi)
"I'm sorry, I don't think the helm can be fixed -- not with the time you have left. You're going to have to destroy the ship."
[Oh god, this is it.]

"7"

>z
Time passes.

"6"

>z
Time passes.

Master Sergeant R. Mu Arvax: "You there, Usagi? We don't have much time."

"5"

>z
Time passes.

"4"

>z
Time passes.

Master Sergeant R. Mu Arvax: "You there, Usagi? We don't have much time."

"3"

>z
Time passes.

"2"

>z
Time passes.

Master Sergeant R. Mu Arvax: "You there, Usagi? We don't have much time."

"1"

>z
Time passes.

"0"

The Void Matter is injected into the fusion engine, causing an explosion that rips the ship apart. You are never aware of this, however, as you are instantly vaporized. If you had been aware, you would certainly have been pleased to know that your death saved the people of New Da Nang.

    *** You have died nobly. ***

In that game you scored 7 out of a possible 10, in 168 turns.

Well done! You made the ultimate sacrifice so that others might live. First, we award you one point each for:
- fixing the aft airlock door
- fixing the microwave oven
- fixing the equipment cabinet in the starboard-side crew quarters
- fixing the storage unit in the port-side crew quarters
- fixing the fusion engine
- fixing the captain's door

We also award you one point for saving New Da Nang. Congratulations!

Would you like to RESTART, RESTORE a saved game, QUIT, or UNDO the last command?

* * *

>f
Bridge
This is where the captain, navigator, and pilot all sit. Large viewscreens give a full view of the space around the ship. To port you can see the blue-white disk of Deneb. Astern you can faintly see the fading embers of what was Space Station Omicron-5.
 
The pilot's and navigator's chairs sit before the large helm console. The captain's chair, with command console, sits halfway between them and operations further aft.

You hear someone speaking aft of here.

Attention: current trajectory intersects the moon New Da Nang. Please correct course.

>open access panel
You can't use multiple objects with that verb.

>trace 5
[Parser tracing set to level 5.]

* * *

>hello
(addressing Master Sergeant R. Mu Arvax)
"Finally! Where've you been? I'm sad to see you invoked Mulgrew's emergency protocols, but that's water under the bridge. Now we need to try to salvage the situation."

"I'm trying to divert the ship from its collision course with New Da Nang, but there are some problems: the helm is not responding to any commands and the fuel injection specification for the fusion engine is incorrect. 

"To be honest, friend, the readouts I'm seeing about the state of helm control are dire. I'm not sure it can be fixed."

Attention: current trajectory intersects the moon New Da Nang. Please correct course.

>f
Bridge
This is where the captain, navigator, and pilot all sit. Large viewscreens give a full view of the space around the ship. To port you can see the blue-white disk of Deneb. Astern you can faintly see the fading embers of what was Space Station Omicron-5.
 
The pilot's and navigator's chairs sit before the large helm console. The captain's chair, with command console, sits halfway between them and operations further aft.

You hear someone speaking aft of here.

>unlock access panel
You must specify what you want to unlock the helm access panel with.

>unlock access panel with hex
You unlock the helm access panel.

>open it
Opening the helm access panel reveals a fused mass of wiring and circuit boards. It's ruined beyond repair.

>x wiring
It's ruined.

>x maze
It's ruined.

>a
Operations Deck
This is where all of the support activity for the bridge occurs. There are large consoles for environmental controls (which include gravity, temperature, and pressure), communications, and power systems here. The bridge continues forward from here, and engineering is aft. There is a door set in the floor with a ladder leading through it. Set in the frame of the door is a blue button.

⇒ You can always find out the current status by asking Arvax about the ship.

You can see an equipment trunk (closed) here.

>ask arvax about ship
(the ss usagi)
"I'm sorry, I don't think the helm can be fixed -- not with the time you have left. You're going to have to destroy the ship."
[Oh god, this is it.]

>ask arvax about ship
(the ss usagi)
"I'm sorry, I don't think the helm can be fixed -- not with the time you have left. You're going to have to destroy the ship."
[Oh god, this is it.]

* * *

>f
Bridge
This is where the captain, navigator, and pilot all sit. Large viewscreens give a full view of the space around the ship. To port you can see the blue-white disk of Deneb. Astern you can faintly see the fading embers of what was Space Station Omicron-5.
 
The pilot's and navigator's chairs sit before the large helm console. The captain's chair, with command console, sits halfway between them and operations further aft.

You hear someone speaking aft of here.

>x helm
(the helm table)
The helm is a sloped table covered with cryptic readouts and touch controls. In the back is an access panel which is closed. A hex-shaped aperture is probably the locking mechanism.

>open access panel
You can't use multiple objects with that verb.

>actions
Actions listing on.

>open access panel
You can't use multiple objects with that verb.

* * *

>a
Engine Room
This where the combustion process is controlled. The aft wall is dominated by the operating panel section of the fusion engine. Monitoring electronics and controls cover the other two walls. A doorway opens forward to the Engineering Deck.

There is a large diagram of the fuel injection process on the forward wall. There is a large button below the diagram labeled "Test".

You can see a broken JL-758 here.

>hint
Some players may find the temptation to rely on hints overwhelming, and you may prefer to remove temptation by disabling hints for the rest of this game. If you do so, however, you will not be able to access the hints unless you restart. Do you wish to disable hints? >

>no
Engine Room
This where the combustion process is controlled. The aft wall is dominated by the operating panel section of the fusion engine. Monitoring electronics and controls cover the other two walls. A doorway opens forward to the Engineering Deck.

There is a large diagram of the fuel injection process on the forward wall. There is a large button below the diagram labeled "Test".

You can see a broken JL-758 here.

* * *

>ask arvax about ship
(the ss usagi)
"You're back! Great job rebooting the computer -- I'm getting telemetry now."

"I'm trying to divert the ship from its collision course with New Da Nang, but there's a problem: the fuel injection specification for the fusion engine is incorrect."

You add an item ("adjust fuel injection specification") to your to-do list.

>ask arvax about ship
(the ss usagi)
"I'm trying to divert the ship from its collision course with New Da Nang, but there's a problem: the fuel injection specification for the fusion engine is incorrect."

>talk to arvax
You are already talking to Master Sergeant R. Mu Arvax.

>unfo
I'm not sure what you're trying to say. I might just not recognize the words you're using.

* * *

>undo
Operations Deck
[Previous turn undone.]

>undo
Operations Deck
[Previous turn undone.]

>[152] z
Time passes.

Attention all crew: command functions are offline and the computer is running with decreased capabilities. Full system reboot required.

>reboot
You can't reboot yourself.

Reboot complete.

>talk to arvax
"You're back! Great job rebooting the computer -- I'm getting telemetry now."

"I'm trying to divert the ship from its collision course with New Da Nang, but there's a problem: the fuel injection specification for the fusion engine is incorrect."

You add an item ("adjust fuel injection specification") to your to-do list.

>ask arvax about ship
(the ss usagi)
"I'm trying to divert the ship from its collision course with New Da Nang, but there's a problem: the fuel injection specification for the fusion engine is incorrect."

>l
Operations Deck
This is where all of the support activity for the bridge occurs. There are large consoles for environmental controls (which include gravity, temperature, and pressure), communications, and power systems here. The bridge continues forward from here, and engineering is aft. There is a door set in the floor with a ladder leading through it. Set in the frame of the door is a blue button.

⇒ You can always find out the current status by asking Arvax about the ship.

You can see an equipment trunk (closed) here.

>ask arvax about ship
(the ss usagi)
"I'm trying to divert the ship from its collision course with New Da Nang, but there's a problem: the fuel injection specification for the fusion engine is incorrect."

>restart
Are you sure you want to restart?

>y
Crash
An Interactive Disaster by Phil Riley
Release 15 / Serial number 221002 / Inform 7 build 6M62 (I6/v6.34 lib 6/12N) SD

Space Station Gangway
This is the pressurized bridge from Space Station Omicron-5 to the SS Usagi. Behind you is the familiar bulk of the huge station, largest outpost of the Space Authority in Deneb Sector. Before you is the aft airlock of the Usagi, beckoning you in.

[Better get a move on], you think.

* * *

>talk to arvax
"You're back! Great job rebooting the computer -- I'm getting telemetry now."

"I'm trying to divert the ship from its collision course with New Da Nang, but there's a problem: the fuel injection specification for the fusion engine is incorrect."

You add an item ("adjust fuel injection specification") to your to-do list.

* * *

>ask arvax about ship
(the ss usagi)
"I'm trying to divert the ship from its collision course with New Da Nang, but there's a problem: the fuel injection specification for the fusion engine is incorrect."

>ask arvax about ship
(the ss usagi)
"I'm trying to divert the ship from its collision course with New Da Nang, but there's a problem: the fuel injection specification for the fusion engine is incorrect."

* * *

>restart
Are you sure you want to restart?

Please answer yes or no.

>y
Crash
An Interactive Disaster by Phil Riley
Release 15 / Serial number 221002 / Inform 7 build 6M62 (I6/v6.34 lib 6/12N) SD

Space Station Gangway
This is the pressurized bridge from Space Station Omicron-5 to the SS Usagi. Behind you is the familiar bulk of the huge station, largest outpost of the Space Authority in Deneb Sector. Before you is the aft airlock of the Usagi, beckoning you in.

[Better get a move on], you think.

* * *

>ask arvax about ship
(the ss usagi)
"You're back! Great job rebooting the computer -- I'm getting telemetry now."

"I'm trying to divert the ship from its collision course with New Da Nang, but there's a problem: the fuel injection specification for the fusion engine is incorrect."

"I'm trying to divert the ship from its collision course with New Da Nang, but there's a problem: the fuel injection specification for the fusion engine is incorrect."

You add an item ("adjust fuel injection specification") to your to-do list.

* * *

>p
Machine Room
The machine room is where the physical work of Engineering takes place; for instance, machining new parts. There is a large counter lined with drawers here, as well as numerous saws, drills, and other pieces of equipment. You can leave to starboard.

There's a hand vac sitting on the counter.

>take vac
(the vac suit)
You already have that.

Attention all crew: command functions are offline and the computer is running with decreased capabilities. Full system reboot required.

>take hand vac
Taken.

>take
What do you want to take?

* * *

>a
Engine Room
This where the combustion process is controlled. The aft wall is dominated by the operating panel section of the fusion engine. Monitoring electronics and controls cover the other two walls. A doorway opens forward to the Engineering Deck.

There is a large screen on the forward wall. It displays nothing right now. There is a large button below the diagram labeled "Test".

>f
Engineering Deck
The engineering crew is responsible for keeping the physical ship operating. They are in charge of every physical aspect of the ship, from the engines to hull integrity to the life support system.

The engineering deck consists of a large console giving a comprehensive view of the physical status of the ship. There is an airlock to starboard. The operations deck continues forward from here, and there are other exits to aft and port.

You hear someone speaking to fore.

A device labeled "Suit Recharging Station" is here. It is shaped like a chair with nozzles protruding from either arm.

Attention all crew: command functions are offline and the computer is running with decreased capabilities. Full system reboot required.

>f
Operations Deck
This is where all of the support activity for the bridge occurs. There are large consoles for environmental controls (which include gravity, temperature, and pressure), communications, and power systems here. The bridge continues forward from here, and engineering is aft. There is a door set in the floor with a ladder leading through it. Set in the frame of the door is a blue button.

A large equipment trunk lies on the midship door, blocking it.

A man's voice comes over comms: "Usagi, are you there?"

[Finally, another person! I'm saved!]

⇒ By the way... you can get help about speaking to other characters by typing "help speech".

>push trunk
You push the trunk clear of the door.

>press blue button
The door slides open.

A man's voice comes over comms: "SS Usagi, come in! Is anyone there?"

⇒ You might try saying hello.

>d
Galley
This narrow space is barely enough room for two Marines to prepare and eat a meal. There is a counter with a drawer, and two stools, a microwave oven, and a large closet here. Pots and pans hang from hooks in the ceiling. A ladder leads up through the midship door, and you can leave aft.

On the starboard wall is a panel on which is a blue button. Tacked to the panel is the operator's manual for the midship door.

You hear someone speaking above.

>rules
Rules tracing now switched on. Type "rules off" to switch it off again, or "rules all" to include even rules which do not apply.

[Rule "reset report text rule" applies.]

* * *

>rules off
[Rule "After reading a command" applies.]
[Rule "declare everything initially unmentioned rule" applies.]
Rules tracing now switched off. Type "rules" to switch it on again.

>d
Galley
This narrow space is barely enough room for two Marines to prepare and eat a meal. There is a counter with a drawer, and two stools, a microwave oven, and a large closet here. Pots and pans hang from hooks in the ceiling. A ladder leads up through the midship door, and you can leave aft.

On the starboard wall is a panel on which is a blue button. Tacked to the panel is the operator's manual for the midship door.

You hear someone speaking above.

>u
Operations Deck
This is where all of the support activity for the bridge occurs. There are large consoles for environmental controls (which include gravity, temperature, and pressure), communications, and power systems here. The bridge continues forward from here, and engineering is aft. There is a door set in the floor with a ladder leading through it. Set in the frame of the door is a blue button.

You can see an equipment trunk (closed) here.

A man's voice comes over comms: "Come in, Usagi, Come in, Usagi."

⇒ You might try saying hello.

>d
Galley
This narrow space is barely enough room for two Marines to prepare and eat a meal. There is a counter with a drawer, and two stools, a microwave oven, and a large closet here. Pots and pans hang from hooks in the ceiling. A ladder leads up through the midship door, and you can leave aft.

On the starboard wall is a panel on which is a blue button. Tacked to the panel is the operator's manual for the midship door.

You hear someone speaking above.

* * *

Crash
An Interactive Disaster by Phil Riley
Release 17 / Serial number 221017 / Inform 7 build 6M62 (I6/v6.34 lib 6/12N) SD

Space Station Gangway
This is the pressurized bridge from Space Station Omicron-5 to the SS Usagi. Behind you is the familiar bulk of the huge station, largest outpost of the Space Authority in Deneb Sector. Before you is the aft airlock of the Usagi, beckoning you in.

[Better get a move on], you think.

>test wiring
>--> The following tests are available:
'test airlock'
'test spacewalk'
'test microwave'
'test cabinet'
'test storage'
'test wiring1'
'test planetfall'
'test staging'
'test tether'
'test captain'
'test arvax'
'test reboot'
'test fuel'
'test win'
'test protocols'
'test explode'
'test nobly'
'test escape'
'test walkthrough'

* * *

>unlock keypad
(with the small key)
You open the front panel of the keypad, revealing a bundle of wiring.

* * *

>unlock keypad
the keypad.
(with the small key)
You open the front panel of the keypad, revealing a bundle of wiring.

* * *

>close it
You close the keypad.

>type
What do you want to type on?

* * *

>keypad
As you press a key, the storage unit starts buzzing continuously. The display lights up with random characters, and you smell the distinct odor of burning wires. The bottom drawer pops out a centimeter or two.

You add an item ("fix the storage unit") to your to-do list.

>unlock keypad
(with the small key)
You open the front panel of the keypad, revealing a bundle of wiring. You can see the problem immediately -- two wires with worn insulation are in contact, causing a short-circuit.

>tape wires
You don't have any tape.

>purloin tape
[Purloined.]

>fix wires
This is a hard one. You'll have to be more specific about how you do that.

>tape wires
You wrap the wires in electrical tape and close the keypad.

You cross out an item ("fix the storage unit") on your to-do list.

[Your score has just gone up by one point.]

>type 345
The display flashes "Close Drawer".

>close drawer
Which do you mean, the top drawer or the bottom drawer?

>bottom
You're unable to close the drawer. I think you'll need to open it all the way first.

>purloin knife
[Purloined.]

>open bottom drawer with knife
You wedge the knife into the seam and lever the drawer open, revealing the red access card.

>take card
Taken.

* * *

>bottom
You close the bottom drawer.

>type 345345
The storage unit buzzes and the display lights up "ERROR".

>type on keypad
The storage unit buzzes and the display lights up "ERROR".

Attention all crew: command functions are offline and the computer is running with decreased capabilities. Full system reboot required.

* * *

>unlock keypad
What do you want to unlock the keypad with?

* * *

>unlock keypad with key
You open the front panel of the keypad, revealing a bundle of wiring.

>undo
Port-Side Crew Quarters
[Previous turn undone.]

>unlock keypad
What do you want to unlock the keypad with?

>key
I didn't understand that sentence.

>unlock keypad with key
You open the front panel of the keypad, revealing a bundle of wiring.

* * *

>x wiring
Two of the wires are crossed, leading to a short circuit.

>showme wiring
wiring - thing
location: in the helm access panel , which is part of the helm table in Bridge
singular-named, improper-named; unlit, inedible, fixed in place, scenery, unseen, unfamiliar, screwed
list grouping key: none
printed name: "wiring"
printed plural name: none
indefinite article: none
description: "There's a lot of it."
initial appearance: none
last utterance: none
readable text: none
voice locale: yourself

* * *

>x wiring
Two of the wires are crossed, leading to a short circuit.

>x wires
Two of the wires are crossed, leading to a short circuit.

>take wiring
That's hardly portable.

>purloin tape
[Purloined.]

>tape wiring
You wrap the wires in electrical tape and close the keypad.

It seems you completed something ("fix the storage unit") that wasn't on your to-do list. You note it down.

[Your score has just gone up by one point.]

>x unit
The storage unit consists of top and bottom drawers, with an attached keypad and display. There is a keyhole under the keypad. Both drawers are closed.

* * *

>type
What do you want to type on?

>keypad
You poke a few keys at random. Nothing happens.

>type on the keypad
You poke a few keys at random. Nothing happens.

>actions
Actions listing on.

>type on the keypad
[contentlessly typing on the keypad]
You poke a few keys at random. Nothing happens.
[contentlessly typing on the keypad - succeeded]

>type on me
[contentlessly typing on yourself]
You can't type on yourself.
[contentlessly typing on yourself - failed the Check contentlessly typing on something when the noun is not typable]

>x keypad
[examining the keypad]
A standard 0-9 keypad with a "*" and "#". Below the keys is a small keyhole.

[examining the keypad - succeeded]

>open the keypad
[opening the keypad]
It seems to be locked.
[opening the keypad - failed the can't open what's locked rule]

>unlock the keypad
(with the small key)
[unlocking the keypad with the small key]
[(1) opening the keypad]
You open the front panel of the keypad, revealing a bundle of wiring.
[(1) opening the keypad - succeeded]

[unlocking the keypad with the small key - succeeded]

Attention all crew: command functions are offline and the computer is running with decreased capabilities. Full system reboot required.

>type
What do you want to type on?

>keypad
[contentlessly typing on the keypad]
You need to close the keypad before you can type on it.
[contentlessly typing on the keypad - failed the Check contentlessly typing on the port keypad when the port keypad is open]

>close it
[closing the keypad]
You close the keypad.
[closing the keypad - succeeded]

>type
What do you want to type on?

>keypad
[contentlessly typing on the keypad]
You poke a few keys at random. Nothing happens.
[contentlessly typing on the keypad - succeeded]

>type 345345
[typing "345345" on the keypad]
[typing "345345" on the keypad - succeeded]

>type 9467
[typing "9467" on the keypad]
The top drawer slides open, revealing a copy of Planetfall.

[typing "9467" on the keypad - succeeded]

* * *

>x wirint
You can't see any such thing.

>x wiring
You see nothing special about the storage wiring.

>close keypad
You close the keypad.

>x wiring
You can't see any such thing.

>l;
I'm not sure what you're trying to say. I might just not recognize the words you're using.

>l
Port-Side Crew Quarters
All crew members who aren't the captain sleep in this or the opposite-side bunk room. This one sleeps two in a bunk bed, done up with military precision. There is a large cabinet here, stretching almost to the ceiling. It is closed. Mounted in the wall is a crew personal storage unit. The sole exit is to starboard.

>x wires
You can't see any such thing.

* * *

Crash
An Interactive Disaster by Phil Riley
Release 17 / Serial number 221017 / Inform 7 build 6M62 (I6/v6.34 lib 6/12N) SD

Space Station Gangway
This is the pressurized bridge from Space Station Omicron-5 to the SS Usagi. Behind you is the familiar bulk of the huge station, largest outpost of the Space Authority in Deneb Sector. Before you is the aft airlock of the Usagi, beckoning you in.

[Better get a move on], you think.

>unlock
What do you want to unlock?

>unlock me
You must supply a second noun.

* * *

>open unit
That can only be opened by typing the correct code on the keypad.

>unlock keypad
You open the front panel of the keypad, revealing a bundle of wiring.

* * *

Crash
An Interactive Disaster by Phil Riley
Release 17 / Serial number 221017 / Inform 7 build 6M62 (I6/v6.34 lib 6/12N) SD

Space Station Gangway
This is the pressurized bridge from Space Station Omicron-5 to the SS Usagi. Behind you is the familiar bulk of the huge station, largest outpost of the Space Authority in Deneb Sector. Before you is the aft airlock of the Usagi, beckoning you in.

[Better get a move on], you think.

>unlock me
What do you want to unlock yourself with?

>unlock me with me
(first taking yourself)
You are always self-possessed.

* * *

Crash
An Interactive Disaster by Phil Riley
Release 17 / Serial number 221017 / Inform 7 build 6M62 (I6/v6.34 lib 6/12N) SD

Space Station Gangway
This is the pressurized bridge from Space Station Omicron-5 to the SS Usagi. Behind you is the familiar bulk of the huge station, largest outpost of the Space Authority in Deneb Sector. Before you is the aft airlock of the Usagi, beckoning you in.

[Better get a move on], you think.

>x computer
The computer is only available onboard the ship.

>n
I'm not sure what you're trying to say. I might just not recognize the words you're using.

>f
You pass into the aft airlock, the outer door closing behind you.

The Second Law of Thermodynamics, in one formulation, states that disorganization always increases in the absence of some outside force. A corollary is that things will always break down in the absence of someone to fix them. As a member of the repair corps of Space Station Omicron-5, you're that someone.

Your last assignment of the day, on the SS Usagi, a Space Marines fighting ship, looks routine enough. Fix the microwave and a jammed locker door, and then you're off for the day.

Aft Airlock
You are in the aft airlock. Outside is the gangway back to Space Station Omicron-5. Forward leads into the ship.

A pleasant androgynous voice says, "Welcome to the SS Usagi. This is the shipboard computer. Please feel free to call upon me for any information you may need. Use the command 'computer, help' for more information."

>x computer
The computer isn't really here.