Crash
An Interactive Disaster by Phil Riley
Release 6 / Serial number 220819 / Inform 7 build 6M62 (I6/v6.34 lib 6/12N) SD

Space Station Gangway
This is the pressurized bridge from Space Station Omicron-5 to the SS Usagi. Behind you is the familiar bulk of the huge station, largest outpost of the Space Authority in Deneb Sector. Before you is the aft airlock of the Usagi, beckoning you in.

[Better get a move on], you think.

* * *

>wear suit
(first taking the vac suit)
You put on the vac suit.

>turn on boots
You switch the Magnetic boots on.

* * *

>hello
(addressing Master Sergeant R. Mu Arvax)
"You're back! Great job rebooting the computer -- I'm getting telemetry now.

>ask arvax about engine
(the fusion engine)
"I'm seeing the engine fully online. Now you need to get the fuel specification right."

You add an item ("adjust fuel injection specification") to your to-do list.

>ask arvax about engine status
"I'm afraid I don't have anything to say about that."

>ask arvax about jl-758
Which do you mean, the brand-new JL-758 or the broken JL-758?

>brand-new
"I'm afraid I don't have anything to say about that."

* * *

>f
Operations Deck
This is where all of the support activity for the bridge occurs. There are large consoles for environmental controls (which include gravity, temperature, and pressure), communications, and power systems here. The bridge continues forward from here, and engineering is aft. There is a door set in the floor with a ladder leading through it. Set in the frame of the door is a blue button.

A large equipment trunk lies on the midship door, blocking it.

A man's voice comes over comms: "SS Usagi, come in! Is anyone there?"

[Finally, another person! I'm saved!]

⇒ By the way... you can get help about speaking to other characters by typing "help speech".

⇒ You might try saying hello.

>hello
(addressing the caller)
You call out "Yes! I'm here! I'm here! What's going on?"

The caller responds, "Ahoy there, SS Usagi, good to hear from you. Seems like you're a bit out of sorts, and we'd like to help you out. But before we get into that, who am I speaking to? Tell me about yourself."

* * *

>yes
"Great, great. Now let's get to work.

 "The first thing I need you to do is reboot the system, using the computer. Once you do that, hopefully I'll be able to access ship controls. You'll have to use my access code: say 'compu--"

Master Sergeant R. Mu Arvax's voice breaks up and another voice comes over comms. "SS Usagi, this is Captain Jane Mulgrew, please come in. Repeat, this is Captain Mulgrew of the SS Usagi, Usagi come in."

[Somebody else?]

>hello
(addressing Captain Jane Mulgrew)
Captain Mulgrew responds, "Hello there, Usagi. That's my ship you've got there. Be careful with her.

"We've been listening in and we've heard your communications with Arvax. He had us jammed for a while, but we managed to break through and here we are. Now it's very important that you understand this: Arvax is not your friend. His allegiances lie with Deneb IV, not with the Space Authority. He would like nothing more than to see this ship wipe out a few neighborhoods on New Da Nang.

"So what we need you to do is deny Arvax by shutting down any access to the ship's controls from the outside by invoking the emergency protocols. That will put the ship in a state where we can board and take control of the ship. What do you say? Do you have any questions?"

Master Sergeant R. Mu Arvax's voice comes back over the radio: "You there still, Usagi? I think I lost you for a second."

[Oh no, who should I trust?]

>ask arvax about code
"Just say 'Computer, access code 2'."

>computer, access code 2
Welcome, Master Sergeant R. Mu Arvax. Logging you in.

* * *

>z
Time passes.

Reboot complete.

>hello
(addressing Master Sergeant R. Mu Arvax)
"You're back! Great job rebooting the computer -- I'm getting telemetry now."

>ask arvax about engine
Which do you mean, the brand-new JL-758 or engine status?

>brand-new
"I'm afraid I don't have anything to say about that."

>ask about engine status
"Hey, you sound tired. If you need a rest, lower the gravity setting. You should find it in the operations deck somewhere."

"I'm afraid I don't have anything to say about that."

>ask about usagi
"I'm trying to divert the ship from its collision course with New Da Nang, but there are some problems: there is some physical issue with the engine and the fuel injection specification for the fusion engine is incorrect."

You add an item ("adjust fuel injection specification") to your to-do list.

You add an item ("fix the engine") to your to-do list.

>ask about engine
Which do you mean, the brand-new JL-758 or engine status?

>s
"We don't have time for that!"

"I'm trying to divert the ship from its collision course with New Da Nang, but there are some problems: there is some physical issue with the engine and the fuel injection specification for the fusion engine is incorrect."

>f
Bridge
This is where the captain, navigator, and pilot all sit. Large viewscreens give a full view of the space around the ship. To port you can see the blue-white disk of Deneb. Astern you can faintly see the fading embers of what was Space Station Omicron-5.
 
The pilot's and navigator's chairs sit before their respective consoles. The captain's chair, with command console, sits halfway between them and operations further aft.

You hear someone speaking aft of here.

>f
The only obvious exit is aft (to operations deck).

>a
Operations Deck
This is where all of the support activity for the bridge occurs. There are large consoles for environmental controls (which include gravity, temperature, and pressure), communications, and power systems here. The bridge continues forward from here, and engineering is aft. There is a door set in the floor with a ladder leading through it. Set in the frame of the door is a blue button.

A large equipment trunk lies on the midship door, blocking it.

>a
Engineering Deck
The engineering crew is responsible for keeping the physical ship operating. They are in charge of every physical aspect of the ship, from the engines to hull integrity to the life support system.

The engineering deck consists of a large console giving a comprehensive view of the physical status of the ship. There is an airlock to starboard. The operations deck continues forward from here, and there are other exits to aft and port.

You hear someone speaking to fore.

A device labeled "Suit Recharging Station" is here. It is shaped like a chair with nozzles protruding from either arm.

>a
Engine Room
This where the combustion process is controlled. The aft wall is dominated by the operating panel of the fusion engine. Monitoring electronics and controls cover the other two walls. A doorway opens forward to the Engineering Deck.

There is a large diagram of the fuel injection process on the forward wall. There is a large button below the diagram labeled "Test".

>x engine
(the fusion engine)
The portion of the engine directly accessible from the engine room is a formidable machine. You wouldn't dare touch any of the various dials, components, hatches, etc. that adorn the surface. At your feet a part of the engine juts out -- it looks broken.

>f
Engineering Deck
The engineering crew is responsible for keeping the physical ship operating. They are in charge of every physical aspect of the ship, from the engines to hull integrity to the life support system.

The engineering deck consists of a large console giving a comprehensive view of the physical status of the ship. There is an airlock to starboard. The operations deck continues forward from here, and there are other exits to aft and port.

You hear someone speaking to fore.

A device labeled "Suit Recharging Station" is here. It is shaped like a chair with nozzles protruding from either arm.

>f
Operations Deck
This is where all of the support activity for the bridge occurs. There are large consoles for environmental controls (which include gravity, temperature, and pressure), communications, and power systems here. The bridge continues forward from here, and engineering is aft. There is a door set in the floor with a ladder leading through it. Set in the frame of the door is a blue button.

A large equipment trunk lies on the midship door, blocking it.

Master Sergeant R. Mu Arvax: "You there, Usagi? We don't have much time."

>ask about engine
Which do you mean, the brand-new JL-758, engine status, the fusion engine, the engine diagram, the engine room monitors, or the broken JL-758?

>fusion
"It looks like you need to replace the engine stabilizer. It's the kind of thing you might have on board."

>ask computer about engine status
The SS Usagi employs a Luna Spacewerks Parsec VI. The shipboard engine is currently non-functional. It needs a replacement JL-758 engine stabilizer.

* * *

>ask arvax about engine
Which do you mean, the brand-new JL-758 or engine status?

>status
"It looks like you need to replace the engine stabilizer. It's the kind of thing you might have on board."

>ask about jl-758
"Hey, you sound tired. If you need a rest, lower the gravity setting. You should find it in the operations deck somewhere."

"I'm afraid I don't have anything to say about that."

* * *

>status
"It looks like you need to replace the engine stabilizer. It's the kind of thing you might have on board."

>ask arvax about engine status
"I'm afraid I don't have anything to say about that."

Master Sergeant R. Mu Arvax: "You there, Usagi? We don't have much time."

>ask arvax about fusion engine
"We don't have time for that!"

"I'm trying to divert the ship from its collision course with New Da Nang, but there are some problems: there is some physical issue with the engine and the fuel injection specification for the fusion engine is incorrect."

You add an item ("adjust fuel injection specification") to your to-do list.

You add an item ("fix the engine") to your to-do list.

>rules
Rules tracing now switched on. Type "rules off" to switch it off again, or "rules all" to include even rules which do not apply.

[Rule "reset report text rule" applies.]

>ask arvax about engine status
[Rule "After reading a command" applies.]
[Rule "After deciding the scope of the player when the current stuck thing of the chewing gum is not the player" applies.]
[Rule "After deciding the scope of the player when location is Operations" applies.]
[Rule "computer is everywhere rule" applies.]
[Rule "After deciding the scope of the player when the current stuck thing of the chewing gum is not the player" applies.]
[Rule "After deciding the scope of the player when location is Operations" applies.]
[Rule "computer is everywhere rule" applies.]
[Rule "After deciding the scope of the player when the current stuck thing of the chewing gum is not the player" applies.]
[Rule "After deciding the scope of the player when location is Operations" applies.]
[Rule "computer is everywhere rule" applies.]
[Rule "After deciding the scope of the player when the current stuck thing of the chewing gum is not the player" applies.]
[Rule "After deciding the scope of the player when location is Operations" applies.]
[Rule "computer is everywhere rule" applies.]
[Rule "After deciding the scope of the player when the current stuck thing of the chewing gum is not the player" applies.]
[Rule "After deciding the scope of the player when location is Operations" applies.]
[Rule "computer is everywhere rule" applies.]
[Rule "declare everything initially unmentioned rule" applies.]
[Rule "announce items from multiple object lists rule" applies.]
[Rule "set pronouns from items from multiple object lists rule" applies.]
[Rule "before stage rule" applies.]
[Rule "Before doing something to Arvax" applies.]
[Rule "Before" applies.]
[Rule "new instead stage rule" applies.]
[Rule "Instead of quizzing Arvax about engine status" applies.]
[Rule "announce items from multiple object lists rule" applies.]
[Rule "set pronouns from items from multiple object lists rule" applies.]
[Rule "before stage rule" applies.]
[Rule "Before doing something to Arvax" applies.]
[Rule "Before" applies.]
[Rule "new instead stage rule" applies.]
[Rule "investigate player's awareness before action rule" applies.]
[Rule "player aware of his own actions rule" applies.]
[Rule "check stage rule" applies.]
[Rule "block asking about something unknown rule" applies.]
[Rule "block asking rule" applies.]
"I'm afraid I don't have anything to say about that."

[Rule "pre-report rule" applies.]
[Rule "post-report rule" applies.]
[Rule "A first turn sequence rule" applies.]
[Rule "post-report rule" applies.]
[Rule "every turn stage rule" applies.]
[Rule "Every turn when ( not talking about asking mulgrew questions ) and computer-rebooting is false and protocols-in-progress is false and last-moves is false" applies.]
[Rule "reset protocol rule" applies.]
[Rule "Every turn" applies.]
[Rule "close open doors rule" applies.]
[Rule "A last turn sequence rule" applies.]
[Rule "notify score changes rule" applies.]
[Rule "reset report text rule" applies.]

* * *

>status
"It looks like you need to replace the engine stabilizer. It's the kind of thing you might have on board."

>ask arvax about mulgrew
"Hey, you sound tired. If you need a rest, lower the gravity setting. You should find it in the operations deck somewhere."

"Wonder where she went? It's suspicious that she disappeared after you didn't follow orders."

>ask arvax about card
"I'm afraid I don't have anything to say about that."

>ask arvax about operation
"I'm afraid I don't have anything to say about that."

>rules
Rules tracing now switched on. Type "rules off" to switch it off again, or "rules all" to include even rules which do not apply.

[Rule "reset report text rule" applies.]

* * *

>i
[Rule "After reading a command" applies.]
[Rule "declare everything initially unmentioned rule" applies.]
[Rule "announce items from multiple object lists rule" applies.]
[Rule "set pronouns from items from multiple object lists rule" applies.]
[Rule "before stage rule" applies.]
[Rule "Before" applies.]
[Rule "new instead stage rule" applies.]
[Rule "investigate player's awareness before action rule" applies.]
[Rule "player aware of his own actions rule" applies.]
[Rule "check stage rule" applies.]
[Rule "carry out stage rule" applies.]
[Rule "print empty inventory rule" applies.]
[Rule "print standard inventory rule" applies.]
You are carrying:
  a vac suit (being worn) with chewing gum stuck to it
  a broken sensor
  Bertie the Bear™
  some pair of slippers
  a To-Do list
  a repair corps uniform (being worn)
  a toolbox
[Rule "after stage rule" applies.]

[Rule "investigate player's awareness after action rule" applies.]
[Rule "report stage rule" applies.]
[Rule "report other people taking inventory rule" applies.]
[Rule "pre-report rule" applies.]
[Rule "last specific action-processing rule" applies.]
[Rule "A first turn sequence rule" applies.]
[Rule "post-report rule" applies.]
[Rule "every turn stage rule" applies.]
[Rule "Every turn when ( not talking about asking mulgrew questions ) and computer-rebooting is false and protocols-in-progress is false and last-moves is false" applies.]
[Rule "reset protocol rule" applies.]
[Rule "Every turn" applies.]
[Rule "close open doors rule" applies.]
[Rule "A last turn sequence rule" applies.]
[Rule "notify score changes rule" applies.]
[Rule "reset report text rule" applies.]

>ask arvax about deneb
[Rule "After reading a command" applies.]
[Rule "After deciding the scope of the player when the current stuck thing of the chewing gum is not the player" applies.]
[Rule "After deciding the scope of the player when location is Operations" applies.]
[Rule "computer is everywhere rule" applies.]
[Rule "After deciding the scope of the player when the current stuck thing of the chewing gum is not the player" applies.]
[Rule "After deciding the scope of the player when location is Operations" applies.]
[Rule "computer is everywhere rule" applies.]
[Rule "After deciding the scope of the player when the current stuck thing of the chewing gum is not the player" applies.]
[Rule "After deciding the scope of the player when location is Operations" applies.]
[Rule "computer is everywhere rule" applies.]
[Rule "After deciding the scope of the player when the current stuck thing of the chewing gum is not the player" applies.]
[Rule "After deciding the scope of the player when location is Operations" applies.]
[Rule "computer is everywhere rule" applies.]
[Rule "After deciding the scope of the player when the current stuck thing of the chewing gum is not the player" applies.]
[Rule "After deciding the scope of the player when location is Operations" applies.]
[Rule "computer is everywhere rule" applies.]
Which do you mean, Deneb System, Deneb IV, Deneb II, Deneb sector, the Deneb separatists, or Deneb (star)?

>ask arvax about deneb iV
[Rule "After reading a command" applies.]
[Rule "After deciding the scope of the player when the current stuck thing of the chewing gum is not the player" applies.]
[Rule "After deciding the scope of the player when location is Operations" applies.]
[Rule "computer is everywhere rule" applies.]
[Rule "After deciding the scope of the player when the current stuck thing of the chewing gum is not the player" applies.]
[Rule "After deciding the scope of the player when location is Operations" applies.]
[Rule "computer is everywhere rule" applies.]
[Rule "After deciding the scope of the player when the current stuck thing of the chewing gum is not the player" applies.]
[Rule "After deciding the scope of the player when location is Operations" applies.]
[Rule "computer is everywhere rule" applies.]
[Rule "After deciding the scope of the player when the current stuck thing of the chewing gum is not the player" applies.]
[Rule "After deciding the scope of the player when location is Operations" applies.]
[Rule "computer is everywhere rule" applies.]
[Rule "After deciding the scope of the player when the current stuck thing of the chewing gum is not the player" applies.]
[Rule "After deciding the scope of the player when location is Operations" applies.]
[Rule "computer is everywhere rule" applies.]
[Rule "declare everything initially unmentioned rule" applies.]
[Rule "announce items from multiple object lists rule" applies.]
[Rule "set pronouns from items from multiple object lists rule" applies.]
[Rule "before stage rule" applies.]
[Rule "Before doing something to Arvax" applies.]
[Rule "Before" applies.]
[Rule "new instead stage rule" applies.]
[Rule "investigate player's awareness before action rule" applies.]
[Rule "player aware of his own actions rule" applies.]
[Rule "check stage rule" applies.]
[Rule "carry out stage rule" applies.]
[Rule "after stage rule" applies.]
[Rule "you're tired rule" applies.]
[Rule "investigate player's awareness after action rule" applies.]
[Rule "report stage rule" applies.]
[Rule "reset turns in state rule" applies.]
[Rule "standard response rule" applies.]
[Rule "Response of Arvax when asked about Deneb IV" applies.]
"What a sad story. The founders were thoroughly admirable idealists whose vision has now been corrupted by power-hungry extremists."
[Rule "pre-report rule" applies.]
[Rule "last specific action-processing rule" applies.]

[Rule "A first turn sequence rule" applies.]
[Rule "post-report rule" applies.]
[Rule "every turn stage rule" applies.]
[Rule "Every turn when ( not talking about asking mulgrew questions ) and computer-rebooting is false and protocols-in-progress is false and last-moves is false" applies.]
[Rule "reset protocol rule" applies.]
[Rule "Every turn" applies.]
[Rule "close open doors rule" applies.]
[Rule "A last turn sequence rule" applies.]
[Rule "notify score changes rule" applies.]
[Rule "reset report text rule" applies.]

>rules off
[Rule "After reading a command" applies.]
[Rule "declare everything initially unmentioned rule" applies.]
Rules tracing now switched off. Type "rules" to switch it on again.

>ask arvax about deneb iV
"What a sad story. The founders were thoroughly admirable idealists whose vision has now been corrupted by power-hungry extremists."

>ask arvax about operation dalmatian
"I'm afraid I don't have anything to say about that."

* * *

>trace 6
[Parser tracing set to level 6.]

* * *

>trace off
[ "trace" trace / "off" off ]
[Parsing for the verb 'trace' (4 lines)]

[line 0 * -> TraceOn]
 [line 0 token 1 word 2 : END]

[line 1 * number -> TraceLevel]
 [line 1 token 1 word 2 : number]
  [token resulted in failure with error type 3]

[line 2 * 'on' -> TraceOn]
[line rejected for not ending with correct preposition]

[line 3 * 'off' -> TraceOff]
 [line 3 token 1 word 2 : 'off']
  [token resulted in success]
 [line 3 token 2 word 3 : END]
[Line successfully parsed]
Trace off.

>ask arvax about bridge
"I'm afraid I don't have anything to say about that."

* * *

>f
Bridge
This is where the captain, navigator, and pilot all sit. Large viewscreens give a full view of the space around the ship. To port you can see the blue-white disk of Deneb. Astern you can faintly see the fading embers of what was Space Station Omicron-5.
 
The pilot's and navigator's chairs sit before their respective consoles. The captain's chair, with command console, sits halfway between them and operations further aft.

You hear someone speaking aft of here.

* * *

>f
The only obvious exit is aft (to operations deck).

>u
The only obvious exit is aft (to operations deck).

>a
Operations Deck
This is where all of the support activity for the bridge occurs. There are large consoles for environmental controls (which include gravity, temperature, and pressure), communications, and power systems here. The bridge continues forward from here, and engineering is aft. There is a door set in the floor with a ladder leading through it. Set in the frame of the door is a blue button.

A large equipment trunk lies on the midship door, blocking it.

A man's voice comes over comms: "If there's anyone on the Usagi, please respond!"

>u
The obvious exits are fore (to bridge), aft (to engineering deck) and down.

>s
The obvious exits are fore (to bridge), aft (to engineering deck) and down.

A man's voice comes over comms: "If there's anyone on the Usagi, please respond!"

⇒ You might try saying hello.

>take slippers
You already have those.

>look under bed
You can't see any such thing.

>get trunk
The trunk is far too heavy to lift by yourself.

A man's voice comes over comms: "Come in, Usagi, Come in, Usagi."

>open it
It seems to be locked.

>take present
You can't see any such thing.

>open it
It seems to be locked.

A man's voice comes over comms: "Usagi, are you there?"

⇒ You might try saying hello.

>take eyes
You can't see any such thing.

>p
The obvious exits are fore (to bridge), aft (to engineering deck) and down.

>d
There's an equipment trunk blocking the door.

A man's voice comes over comms: "SS Usagi, come in! Is anyone there?"

>drop trunk
The equipment trunk is already here.

>stand on trunk
That's not something you can stand on.

A man's voice comes over comms: "Come in, Usagi, Come in, Usagi."

⇒ You might try saying hello.

>take broken sensor
You already have that.

>put optical sensor in panel
You can't see any such thing.

>take suit
You already have that.

A man's voice comes over comms: "SS Usagi, come in! Is anyone there?"

>wear it
You're already wearing that!

>turn on mag boots
That's already on.

A man's voice comes over comms: "If there's anyone on the Usagi, please respond!"

⇒ You might try saying hello.

>a
Engineering Deck
The engineering crew is responsible for keeping the physical ship operating. They are in charge of every physical aspect of the ship, from the engines to hull integrity to the life support system.

The engineering deck consists of a large console giving a comprehensive view of the physical status of the ship. There is an airlock to starboard. The operations deck continues forward from here, and there are other exits to aft and port.

You hear someone speaking to fore.

A device labeled "Suit Recharging Station" is here. It is shaped like a chair with nozzles protruding from either arm.

>out
Engineering Airlock
You are in the engineering airlock. Outside, the space to starboard looks so empty and peaceful it's hard to imagine the awful sight astern.

>out
Outside the Engineering Airlock (vacuum)
You are standing on the hull of the ship, outside the engineering airlock, secured by your vac suit's mag boots. Most of the hull is taken up by the protrusions of various machinery, antennae, radio dishes, and heat sinks. There is a clear path to port among the obstructions. You can also go in to the airlock.

A hook protrudes from the hull next to the airlock door.

Your vac suit pings gently to indicate you have expended a unit of air.

>f
The obvious exits are port (to hull of the usagi (vacuum)), inside (to engineering airlock) and outside.

Your vac suit pings gently to indicate you have expended a unit of air.

>s
The obvious exits are port (to hull of the usagi (vacuum)), inside (to engineering airlock) and outside.

Your vac suit pings gently to indicate you have expended a unit of air.

>vent air
You let a unit of air out of the suit.

Your vac suit pings gently to indicate you have expended a unit of air.

>s
The obvious exits are port (to hull of the usagi (vacuum)), inside (to engineering airlock) and outside.

Your vac suit pings gently to indicate you have expended a unit of air.

>in
Engineering Airlock
You are in the engineering airlock. Outside, the space to starboard looks so empty and peaceful it's hard to imagine the awful sight astern.

>p
Engineering Deck
The engineering crew is responsible for keeping the physical ship operating. They are in charge of every physical aspect of the ship, from the engines to hull integrity to the life support system.

The engineering deck consists of a large console giving a comprehensive view of the physical status of the ship. There is an airlock to starboard. The operations deck continues forward from here, and there are other exits to aft and port.

You hear someone speaking to fore.

A device labeled "Suit Recharging Station" is here. It is shaped like a chair with nozzles protruding from either arm.

>sit in recharger
The nozzles on either side of the chair connect with the suit. After a few moments, the machine emits a pleasant "ping", the nozzles retract, and you stand up.

>f
Operations Deck
This is where all of the support activity for the bridge occurs. There are large consoles for environmental controls (which include gravity, temperature, and pressure), communications, and power systems here. The bridge continues forward from here, and engineering is aft. There is a door set in the floor with a ladder leading through it. Set in the frame of the door is a blue button.

A large equipment trunk lies on the midship door, blocking it.

>hello
(addressing the caller)
You call out "Yes! I'm here! I'm here! What's going on?"

The caller responds, "Ahoy there, SS Usagi, good to hear from you. Seems like you're a bit out of sorts, and we'd like to help you out. But before we get into that, who am I speaking to? Tell me about yourself."

* * *

>z
Time passes.

>rules
Rules tracing now switched on. Type "rules off" to switch it off again, or "rules all" to include even rules which do not apply.

[Rule "reset report text rule" applies.]

>z
[Rule "After reading a command" applies.]
[Rule "declare everything initially unmentioned rule" applies.]
[Rule "announce items from multiple object lists rule" applies.]
[Rule "set pronouns from items from multiple object lists rule" applies.]
[Rule "before stage rule" applies.]
[Rule "Before" applies.]
[Rule "new instead stage rule" applies.]
[Rule "investigate player's awareness before action rule" applies.]
[Rule "player aware of his own actions rule" applies.]
[Rule "check stage rule" applies.]
[Rule "carry out stage rule" applies.]
[Rule "after stage rule" applies.]
[Rule "investigate player's awareness after action rule" applies.]
[Rule "report stage rule" applies.]
[Rule "standard report waiting rule" applies.]
Time passes.
[Rule "pre-report rule" applies.]
[Rule "last specific action-processing rule" applies.]

[Rule "A first turn sequence rule" applies.]
[Rule "post-report rule" applies.]
[Rule "every turn stage rule" applies.]
[Rule "Every turn while computer-rebooting is true" applies.]

Reboot complete.

[Rule "reset protocol rule" applies.]
[Rule "Every turn" applies.]
[Rule "close open doors rule" applies.]
[Rule "A last turn sequence rule" applies.]
[Rule "scene description text rule" applies.]
[Rule "When End Game begins" applies.]
[Rule "notify score changes rule" applies.]
[Rule "reset report text rule" applies.]