Typing it on has no description.

Crash
An Interactive Disaster by Phil Riley
Release 18 / Serial number 221030 / Inform 7 build 6M62 (I6/v6.34 lib 6/12N) SD

Space Station Gangway
This is the pressurized bridge from Space Station Omicron-5 to the SS Usagi. Behind you is the familiar bulk of the huge station, largest outpost of the Space Authority in Deneb Sector. Before you is the aft airlock of the Usagi, beckoning you in.

[Better get a move on], you think.

>[f
I'm not sure what you're trying to say. I might just not recognize the words you're using.

>pf
PLANETFALL
Infocom interactive fiction - a science fiction story
Copyright (c) 1983 by Infocom, Inc. All rights reserved.
PLANETFALL is a registered trademark of Infocom, Inc.
Release 39 / Serial number 880501

Another routine day of drudgery aboard the Stellar Patrol Ship Feinstein. This morning's assignment for a certain lowly Ensign Seventh Class: scrubbing the filthy metal deck at the port end of Level Nine. With your Patrol-issue self-contained multi-purpose all-weather scrub brush you shine the floor with a diligence born of the knowledge that at any moment dreaded Ensign First Class Blather, the bane of your shipboard existence, could appear.

>x me
That's difficult unless your eyes are prehensile.

>x ensign
That's difficult unless your eyes are prehensile.

* * *

Typing it on has no description.

Crash
An Interactive Disaster by Phil Riley
Release 18 / Serial number 221030 / Inform 7 build 6M62 (I6/v6.34 lib 6/12N) SD

Space Station Gangway
This is the pressurized bridge from Space Station Omicron-5 to the SS Usagi. Behind you is the familiar bulk of the huge station, largest outpost of the Space Authority in Deneb Sector. Before you is the aft airlock of the Usagi, beckoning you in.

[Better get a move on], you think.

>f
You pass into the aft airlock, the outer door closing behind you.

The Second Law of Thermodynamics, in one formulation, states that disorganization always increases in the absence of some outside force. A corollary is that things will always break down in the absence of someone to fix them. As a member of the repair corps of Space Station Omicron-5, you're that someone.

Your last assignment of the day, on the SS Usagi, a Space Marines fighting ship, looks routine enough. Fix the microwave and a jammed cabinet door, and then you're off for the day.

Aft Airlock
You are in the aft airlock. Outside is the gangway back to Space Station Omicron-5. Forward leads into the ship.

A pleasant androgynous voice says, "Welcome to the SS Usagi. This is the shipboard computer. Please feel free to call upon me for any information you may need. Use the command 'computer, help' for more information."

* * *

>i
You are carrying:
  some chewing gum (being chewed)
  a To-Do list
  a repair corps uniform (being worn)
  a toolbox

>u
You climb the la--

***BOOM***

Press any key...

A gigantic force grabs the ship, knocking you off the ladder and sending you flying against an aft bulkhead. The inertial dampers are probably all that saved you from being smashed to jelly rather than just banged up. 

Press any key...

Some time later you find yourself lying on the floor of the staging area with a throbbing headache. Gingerly you push yourself to your knees and stand up. The vac suit locker has detached from its mounting and lies face down on the floor.

[Thank god I wasn't in the way of that.]

Looking outside --

[Holy -- ]

[Where's the station?].

Where Space Station Omicron-5 was, is now an expanding sphere of rubble, dimly lit by the blue light of far-off Deneb. The rubble is clearly receding behind the ship. [We're moving!]

[How am I going to get off this ship?]

Press any key...

Crash
An Interactive Disaster by Phil Riley
Release 18 / Serial number 221030 / Inform 7 build 6M62 (I6/v6.34 lib 6/12N) SD

Staging Area
This is the staging area of the ship, where marines prepare for missions. It is adjacent to the aft airlock. Locked compartments set into the walls hold various munitions. A ladder leads up into the rest of the ship. 

An equipment locker is sprawled across the room, with its door to the ground.
 
Through the airlock windows you see the blank space left by the destruction of Space Station Omicron-5.

What looks like part of an engine is stowed in a corner.

A vac suit is here, lying prone as if it were some malformed yellow person knocked unconscious by the shaking of the ship.

[What now?]

[I think I spit out my gum.]

>u
Junction
This is a busy place when the ship is populated. To port and starboard are the crew quarters, aft is the closed door to the captain's private quarters, and fore is the galley. A ladder leads down to the staging area.

⇒ You can enter "hints" at any time for help in progressing in the game.
Attention all crew: command functions are offline and the computer is running with decreased capabilities. Full system reboot required.

>f
Galley
This narrow space is barely enough room for two Marines to prepare and eat a meal. There is a counter with a drawer, and two stools, a microwave oven, and a large closet here. Pots and pans hang from hooks in the ceiling. A ladder leads up through the midship door, and you can leave aft.

On the starboard wall is a panel on which is a blue button. Tacked to the panel is the operator's manual for the midship door.

You faintly hear someone speaking above.

>x folding door
A closet with a folding door, set into the bulkhead.

* * *

>f
You enter the ship from the airlock. The inner door closes behind you.

Staging Area
This is the staging area of the ship, where marines prepare for missions. It is adjacent to the aft airlock. It houses a number of vac suits in an open locker, and various munitions in locked compartments set into the walls. A ladder leads up into the rest of the ship. 
Through the airlock windows you can see the gangway to Space Station Omicron-5.

What looks like part of an engine is stowed in a corner.

>u
You climb the la--

***BOOM***

Press any key...

A gigantic force grabs the ship, knocking you off the ladder and sending you flying against an aft bulkhead. The inertial dampers are probably all that saved you from being smashed to jelly rather than just banged up. 

Press any key...

Some time later you find yourself lying on the floor of the staging area with a throbbing headache. Gingerly you push yourself to your knees and stand up. The vac suit locker has detached from its mounting and lies face down on the floor.

[Thank god I wasn't in the way of that.]

Looking outside --

[Holy -- ]

[Where's the station?].

Where Space Station Omicron-5 was, is now an expanding sphere of rubble, dimly lit by the blue light of far-off Deneb. The rubble is clearly receding behind the ship. [We're moving!]

[How am I going to get off this ship?]

Press any key...

Crash
An Interactive Disaster by Phil Riley
Release 18 / Serial number 221030 / Inform 7 build 6M62 (I6/v6.34 lib 6/12N) SD

Staging Area
This is the staging area of the ship, where marines prepare for missions. It is adjacent to the aft airlock. Locked compartments set into the walls hold various munitions. A ladder leads up into the rest of the ship. 

An equipment locker is sprawled across the room, with its door to the ground.
 
Through the airlock windows you see the blank space left by the destruction of Space Station Omicron-5.

What looks like part of an engine is stowed in a corner.

A vac suit is here, lying prone as if it were some malformed yellow person knocked unconscious by the shaking of the ship.

[What now?]

[I think I spit out my gum.]

* * *

>f
Galley
This narrow space is barely enough room for two Marines to prepare and eat a meal. There is a counter with a drawer, and two stools, a microwave oven, and a large closet here. Pots and pans hang from hooks in the ceiling. A ladder leads up through the midship door, and you can leave aft.

On the starboard wall is a panel on which is a blue button. Tacked to the panel is the operator's manual for the midship door.

You faintly hear someone speaking above.

>x closet
A closet with a folding door, set into the bulkhead. It is closed.

>x folding door
The folding door is part of the closet. It is closed.

>open closet
You open the closet, revealing ten MREs and a microwavable dinner.

>x closet
A closet with a folding door, set into the bulkhead. It is open.

In the closet are ten MREs and a microwavable dinner.

>x folding door
The folding door is part of the closet. It is open.

>x bulkhead
You really don't need to worry about the wall.

* * *

Typing it on has no description.

Crash
An Interactive Disaster by Phil Riley
Release 18 / Serial number 221030 / Inform 7 build 6M62 (I6/v6.34 lib 6/12N) SD

Space Station Gangway
This is the pressurized bridge from Space Station Omicron-5 to the SS Usagi. Behind you is the familiar bulk of the huge station, largest outpost of the Space Authority in Deneb Sector. Before you is the aft airlock of the Usagi, beckoning you in.

[Better get a move on], you think.

>in
You pass into the aft airlock, the outer door closing behind you.

The Second Law of Thermodynamics, in one formulation, states that disorganization always increases in the absence of some outside force. A corollary is that things will always break down in the absence of someone to fix them. As a member of the repair corps of Space Station Omicron-5, you're that someone.

Your last assignment of the day, on the SS Usagi, a Space Marines fighting ship, looks routine enough. Fix the microwave and a jammed cabinet door, and then you're off for the day.

Aft Airlock
You are in the aft airlock. Outside is the gangway back to Space Station Omicron-5. Forward leads into the ship.

A pleasant androgynous voice says, "Welcome to the SS Usagi. This is the shipboard computer. Please feel free to call upon me for any information you may need. Use the command 'computer, help' for more information."

>out
Your work is in the ship, not outside.

>enter
You must supply a noun.

>restart
Are you sure you want to restart?

>y
Typing it on has no description.
Empty-space has no description.
Void Matter has no description.
Oganesson has no description.
Unobtainium has no description.
Red Matter has no description.
Liquid Copernicium has no description.
Anti-Helium has no description.
Tachyon Crystals has no description.
Input 1 has no description.
Input 2 has no description.
Input 3 has no description.
Input 4 has no description.

Crash
An Interactive Disaster by Phil Riley
Release 18 / Serial number 221030 / Inform 7 build 6M62 (I6/v6.34 lib 6/12N) SD

Space Station Gangway
This is the pressurized bridge from Space Station Omicron-5 to the SS Usagi. Behind you is the familiar bulk of the huge station, largest outpost of the Space Authority in Deneb Sector. Before you is the aft airlock of the Usagi, beckoning you in.

[Better get a move on], you think.

>enter
You must supply a noun.

>in
You pass into the aft airlock, the outer door closing behind you.

The Second Law of Thermodynamics, in one formulation, states that disorganization always increases in the absence of some outside force. A corollary is that things will always break down in the absence of someone to fix them. As a member of the repair corps of Space Station Omicron-5, you're that someone.

Your last assignment of the day, on the SS Usagi, a Space Marines fighting ship, looks routine enough. Fix the microwave and a jammed cabinet door, and then you're off for the day.

Aft Airlock
You are in the aft airlock. Outside is the gangway back to Space Station Omicron-5. Forward leads into the ship.

A pleasant androgynous voice says, "Welcome to the SS Usagi. This is the shipboard computer. Please feel free to call upon me for any information you may need. Use the command 'computer, help' for more information."

* * *

Typing it on has no description.

Crash
An Interactive Disaster by Phil Riley
Release 18 / Serial number 221030 / Inform 7 build 6M62 (I6/v6.34 lib 6/12N) SD

Space Station Gangway
This is the pressurized bridge from Space Station Omicron-5 to the SS Usagi. Behind you is the familiar bulk of the huge station, largest outpost of the Space Authority in Deneb Sector. Before you is the aft airlock of the Usagi, beckoning you in.

[Better get a move on], you think.

>pf
PLANETFALL
Infocom interactive fiction - a science fiction story
Copyright (c) 1983 by Infocom, Inc. All rights reserved.
PLANETFALL is a registered trademark of Infocom, Inc.
Release 39 / Serial number 880501

Another routine day of drudgery aboard the Stellar Patrol Ship Feinstein. This morning's assignment for a certain lowly Ensign Seventh Class: scrubbing the filthy metal deck at the port end of Level Nine. With your Patrol-issue self-contained multi-purpose all-weather scrub brush you shine the floor with a diligence born of the knowledge that at any moment dreaded Ensign First Class Blather, the bane of your shipboard existence, could appear.

>x brush
You see nothing special about the Patrol-issue self-contained multi-purpose scrub brush.

* * *

>x bulkhead
The escape pod bulkhead is closed.

>q
You stop playing Planetfall. Time to save the ship.

The Second Law of Thermodynamics, in one formulation, states that disorganization always increases in the absence of some outside force. A corollary is that things will always break down in the absence of someone to fix them. As a member of the repair corps of Space Station Omicron-5, you're that someone.

Your last assignment of the day, on the SS Usagi, a Space Marines fighting ship, looks routine enough. Fix the microwave and a jammed cabinet door, and then you're off for the day.

Space Station Gangway
This is the pressurized bridge from Space Station Omicron-5 to the SS Usagi. Behind you is the familiar bulk of the huge station, largest outpost of the Space Authority in Deneb Sector. Before you is the aft airlock of the Usagi, beckoning you in.

⇒ Tip: Type "help" to learn about this game, and interactive fiction in general.

* * *

>x me
That's difficult unless your eyes are prehensile.

>x RM
You can't see any such thing.

* * *

>z
Time passes.

The alien ambassador from the planet Blow'k-bibben-Gordo ambles toward you from down the corridor. He is munching on something resembling an enormous stalk of celery, and he leaves a trail of green slime on the deck. He stops nearby, and you wince as a pool of slime begins forming beneath him on your newly-polished deck. The ambassador wheezes loudly and hands you a brochure outlining his planet's major exports.

>x brochure
"The leading export of Blow'k-bibben-Gordo is the adventure game

          *** PLANETFALL ***

written by S. Eric Meretzky.
Buy one today. Better yet, buy a thousand."

The ambassador asks where Admiral Smithers can be found.

* * *

Typing it on has no description.

Crash
An Interactive Disaster by Phil Riley
Release 18 / Serial number 221030 / Inform 7 build 6M62 (I6/v6.34 lib 6/12N) SD

Space Station Gangway
This is the pressurized bridge from Space Station Omicron-5 to the SS Usagi. Behind you is the familiar bulk of the huge station, largest outpost of the Space Authority in Deneb Sector. Before you is the aft airlock of the Usagi, beckoning you in.

[Better get a move on], you think.

>say asdfa
(to the shipboard computer)
You can only talk to the computer on board the ship.

>hello
There's no one here but you.

>say hello to bear
You can't see any such thing.

>restart
Are you sure you want to restart?

>y
light-meter has no description.
screwdriver has no description.
wrench has no description.
pliers has no description.
fasteners has no description.
Destroying the ship has no description.
Corporal Delores Franck has no description.
Gunnery Sergeant Somchai Khotpanya has no description.
Private First Class Friedrich Jäger has no description.
Private Akin Abimbola has no description.
photo of Pluto has no description.
folding door has no description.
copy of Planetfall has no description.
Typing it on has no description.
air gauge has no description.
air gauge has no description.
air gauge has no description.
air gauge has no description.
air gauge has no description.
air gauge has no description.
ensign seventh class has no description.
Patrol-issue self-contained multi-purpose scrub brush has no description.
Slime has no description.
brochure has no description.
escape pod bulkhead has no description.
cell door has no description.
graffiti has no description.
floor has no description.
Empty-space has no description.
Void Matter has no description.
Oganesson has no description.
Unobtainium has no description.
Red Matter has no description.
Liquid Copernicium has no description.
Anti-Helium has no description.
Tachyon Crystals has no description.
Input 1 has no description.
Input 2 has no description.
Input 3 has no description.
Input 4 has no description.
special vac suit's air gauge has no description.

Crash
An Interactive Disaster by Phil Riley
Release 18 / Serial number 221030 / Inform 7 build 6M62 (I6/v6.34 lib 6/12N) SD

Space Station Gangway
This is the pressurized bridge from Space Station Omicron-5 to the SS Usagi. Behind you is the familiar bulk of the huge station, largest outpost of the Space Authority in Deneb Sector. Before you is the aft airlock of the Usagi, beckoning you in.

[Better get a move on], you think.

>f
You pass into the aft airlock, the outer door closing behind you.

The Second Law of Thermodynamics, in one formulation, states that disorganization always increases in the absence of some outside force. A corollary is that things will always break down in the absence of someone to fix them. As a member of the repair corps of Space Station Omicron-5, you're that someone.

Your last assignment of the day, on the SS Usagi, a Space Marines fighting ship, looks routine enough. Fix the microwave and a jammed cabinet door, and then you're off for the day.

Aft Airlock
You are in the aft airlock. Outside is the gangway back to Space Station Omicron-5. Forward leads into the ship.

A pleasant androgynous voice says, "Welcome to the SS Usagi. This is the shipboard computer. Please feel free to call upon me for any information you may need. Use the command 'computer, help' for more information."

* * *

>take gum
You unstick the chewing gum from the repair corps uniform.

Attention all crew: command functions are offline and the computer is running with decreased capabilities. Full system reboot required.

>take gum
You already have that.

>shew it
I'm not sure what you're trying to say. I might just not recognize the words you're using.

>chew it
You put the chewing gum in your mouth.

>wear suit
(first taking the vac suit)
You put on the vac suit.

* * *

>u
Junction
This is a busy place when the ship is populated. To port and starboard are the crew quarters, aft is the closed door to the captain's private quarters, and fore is the galley. A ladder leads down to the staging area.

⇒ You can enter "hints" at any time for help in progressing in the game.

>turn on boots
You switch the Magnetic boots on.

>e
I'm not sure what you're trying to say. I might just not recognize the words you're using.

>s
Starboard-Side Crew Quarters
All crew members who aren't the captain sleep in this or the opposite-side bunk room. This one sleeps two in a bunk bed, done up with military precision. There is a large cabinet here, stretching almost to the ceiling. It is closed. Mounted in the wall is a crew personal storage unit. The sole exit is to port.

In a shocking lapse of military precision, there is a sticky note attached to the bed post.

A pair of slippers peeks out from under the bed.

>get on bed
As you clamber up, it looks like there's something wrong with the cabinet door.

>fix door
You unscrew the old screw and replace it with a new one from your toolbox.

You cross out an item ("fix the cabinet") on your to-do list.

[Your score has just gone up by one point.]

>undo
Starboard-Side Crew Quarters
[Previous turn undone.]

* * *

>d
You get off the top bunk.

Starboard-Side Crew Quarters
All crew members who aren't the captain sleep in this or the opposite-side bunk room. This one sleeps two in a bunk bed, done up with military precision. There is a large cabinet here, stretching almost to the ceiling. It is closed. Mounted in the wall is a crew personal storage unit. The sole exit is to port.

In a shocking lapse of military precision, there is a sticky note attached to the bed post.

A pair of slippers peeks out from under the bed.

>fix door
This is a hard one. You'll have to be more specific about how you do that.

>u
The only obvious exit is port (to junction).

>climb bed
As you clamber up, it looks like there's something wrong with the cabinet door.

>fix door
You unscrew the old screw and replace it with a new one from your toolbox.

You cross out an item ("fix the cabinet") on your to-do list.

[Your score has just gone up by one point.]

>d
You get off the top bunk.

Starboard-Side Crew Quarters
All crew members who aren't the captain sleep in this or the opposite-side bunk room. This one sleeps two in a bunk bed, done up with military precision. There is a large cabinet here, stretching almost to the ceiling. It is closed. Mounted in the wall is a crew personal storage unit. The sole exit is to port.

In a shocking lapse of military precision, there is a sticky note attached to the bed post.

A pair of slippers peeks out from under the bed.

* * *

>take slippers
As you lean to take the slippers, you notice something under the bed.

>look under bed
You find a black trunk and move it out from under the bottom bunk.

Starboard-Side Crew Quarters
All crew members who aren't the captain sleep in this or the opposite-side bunk room. This one sleeps two in a bunk bed, done up with military precision. There is a large cabinet here, stretching almost to the ceiling. It is closed. Mounted in the wall is a crew personal storage unit. The sole exit is to port.

In a shocking lapse of military precision, there is a sticky note attached to the bed post.

You can also see a black trunk (closed) here.

Attention all crew: command functions are offline and the computer is running with decreased capabilities. Full system reboot required.

>open trunk
You open the black trunk, revealing a present.

* * *

>open present
[I'll go to hell for this, but here goes...]

You rip off the wrapping paper and open the box. Inside is a stuffed bear you recognize as Bertie the Bear™. You discard the paper and box.

>x paper
The paper, which is adorned with cartoon animals in primary colors prancing around the words "Happy Birthday", is ripped beyond repair.

>x box
(the toolbox)
Your toolbox holds wrenches, screwdrivers, pliers, and an assortment of various fasteners.

>x cardboard box
A plain cardboard box, big enough to hold Bertie the Bear™.

>x bear
Bertie the Bear™ is a massively popular toy. It accepts voice commands, and its eyes, actually advanced optical sensors, can differentiate between individuals. This bear's blindly staring eyes are unnerving.

>x eyes
They're well disguised, but the eyes are clearly top-of-the-line optical sensors that you might see in more serious uses, such as in facial recognition devices.

>take sensors
[Am I really going to do this? Yes, yes, I am, apparently.]

You grasp one of the eyes and give it a tug, first softly then harder. Eventually it gives and you extract the eye from the bear. Upon examination you discover that the eye is in fact an optical sensor in camouflage. It looks like you didn't pull it carefully enough, however, because the connector at the end has been damaged.

You try again more carefully with the second eye, and manage to produce an undamaged optical sensor.

>x bear
Bertie the Bear™ is a massively popular toy. It accepts voice commands, and its eyes, actually advanced optical sensors, can differentiate between individuals. This bear seems to be missing his eyes.

>x eyes
You can't see any such thing.

>x sensor
The optical sensor is a small component with a two-pronged connector on the back and a blue metallic circle on the other.

>i
You are carrying:
  a new optical sensor
  Bertie the Bear™
  some slippers
  a vac suit (being worn)
  some chewing gum (being chewed)
  a To-Do list
  a repair corps uniform (being worn)
  a toolbox

>bear, hello
Bertie the Bear™ has better things to do.

>hello
There's no one here but you.

>say hello to bertie
Bertie the Bear™ has no batteries, apparently.

>take trunk
Taken.

Attention all crew: command functions are offline and the computer is running with decreased capabilities. Full system reboot required.

>i
You are carrying:
  a black trunk (open but empty)
  a new optical sensor
  Bertie the Bear™
  some slippers
  a vac suit (being worn)
  some chewing gum (being chewed)
  a To-Do list
  a repair corps uniform (being worn)
  a toolbox

>put bertie in trunk
You put Bertie the Bear™ into the black trunk.

>i
You are carrying:
  a black trunk (open)
    Bertie the Bear™
  a new optical sensor
  some slippers
  a vac suit (being worn)
  some chewing gum (being chewed)
  a To-Do list
  a repair corps uniform (being worn)
  a toolbox

>close trunk
You close the black trunk.

>open trunk
You open the black trunk, revealing Bertie the Bear™.

>i
You are carrying:
  a black trunk (open)
    Bertie the Bear™
  a new optical sensor
  some slippers
  a vac suit (being worn)
  some chewing gum (being chewed)
  a To-Do list
  a repair corps uniform (being worn)
  a toolbox

I beg your pardon?

>p
Junction
This is a busy place when the ship is populated. To port and starboard are the crew quarters, aft is the closed door to the captain's private quarters, and fore is the galley. A ladder leads down to the staging area.

* * *

>d
Staging Area
This is the staging area of the ship, where marines prepare for missions. It is adjacent to the aft airlock. Locked compartments set into the walls hold various munitions. A ladder leads up into the rest of the ship. 

An equipment locker is sprawled across the room, with its door to the ground.
 
Through the airlock windows you see the blank space left by the destruction of Space Station Omicron-5.

What looks like part of an engine is stowed in a corner.

>a
You try to enter the airlock, but the automatic door fails to open for you.
[It's always just opened in the past.]

You add an item ("fix the airlock door") to your to-do list.

>open door
No need. Just go aft.

>open airlock
Which do you mean, Aft Airlock or the Airlock door?

>aft airlock door
You can't see any such thing.

>open door
No need. Just go aft.

>open aft airlock
No need. Just go aft.

>a
You try to enter the airlock, but the automatic door fails to open for you.

>x door
The airlock door is an imposing solid barrier between vacuum and safety. It is colored yellow with red warning symbols on it. Above the door is a panel of electronic components.

>x panel
The component panel is too high.

Attention all crew: command functions are offline and the computer is running with decreased capabilities. Full system reboot required.

>drop trunk
You place the black trunk near the airlock door.

* * *

>stand on trunk
(first closing the black trunk)
You get onto the black trunk.

>x panel
The prominent features of the panel are two optical sensors. One of them has become partially detached and looks broken.

>replace sensor
You remove the broken sensor and insert the fresh sensor into the empty socket.
[There. That should do it.]

You cross out an item ("fix the airlock door") on your to-do list.

[Your score has just gone up by one point.]

>undo
Staging Area
[Previous turn undone.]

>fix panel
This is a hard one. You'll have to be more specific about how you do that.

>fix sensor
(the new optical sensor)
This is a hard one. You'll have to be more specific about how you do that.

>replace sensor
You remove the broken sensor and insert the fresh sensor into the empty socket.
[There. That should do it.]

You cross out an item ("fix the airlock door") on your to-do list.

[Your score has just gone up by one point.]

>a
(first getting off the black trunk)

Aft Airlock
You are in the aft airlock. Outside is the blackness of space, speckled with the dying embers of what was once Space Station Omicron-5. Forward leads into the ship.

* * *

>a
Outside the Aft Airlock (vacuum)
You are standing on the hull of the ship, outside the aft airlock, secured by your vac suit's mag boots. Most of the hull is taken up by the protrusions of various machinery, antennae, radio dishes, and heat sinks. There is a clear path to fore among the obstructions. You can also go in to the airlock.

A hook protrudes from the hull next to the airlock door.

Your vac suit pings gently to indicate you have expended a unit of air.

>in
Aft Airlock
You are in the aft airlock. Outside is the blackness of space, speckled with the dying embers of what was once Space Station Omicron-5. Forward leads into the ship.

>out
Outside the Aft Airlock (vacuum)
You are standing on the hull of the ship, outside the aft airlock, secured by your vac suit's mag boots. Most of the hull is taken up by the protrusions of various machinery, antennae, radio dishes, and heat sinks. There is a clear path to fore among the obstructions. You can also go in to the airlock.

A hook protrudes from the hull next to the airlock door.

Your vac suit pings gently to indicate you have expended a unit of air.

>x hook
A post extends from the hull here, with a heavyweight snap hook on the end. The hook is unattached.

Your vac suit pings gently to indicate you have expended a unit of air.

>x hull
The hull is covered with all kinds of machinery, antennae, radio dishes, and heat sinks. You should probably leave them alone. Your skills as a mechanic don't extend to specialized spaceship repair.

Your vac suit pings gently to indicate you have expended a unit of air.

>outer
I'm not sure what you're trying to say. I might just not recognize the words you're using.

>x usagi
As an out-of-atmosphere vessel, The SS Usagi has a hull dotted with the many devices and machines that keep the ship running.

Your vac suit pings gently to indicate you have expended a unit of air.

>x machinery
The hull is covered with all kinds of machinery, antennae, radio dishes, and heat sinks. You should probably leave them alone. Your skills as a mechanic don't extend to specialized spaceship repair.

Your vac suit pings gently to indicate you have expended a unit of air.

>touch machinery
You should probably leave that alone.

Your vac suit pings gently to indicate you have expended a unit of air.

>l
Outside the Aft Airlock (vacuum)
You are standing on the hull of the ship, outside the aft airlock, secured by your vac suit's mag boots. Most of the hull is taken up by the protrusions of various machinery, antennae, radio dishes, and heat sinks. There is a clear path to fore among the obstructions. You can also go in to the airlock.

A hook protrudes from the hull next to the airlock door.

Your vac suit pings gently to indicate you have expended a unit of air.

>s
The obvious exits are fore, inside (to aft airlock) and outside.

Your vac suit pings gently to indicate you have expended a unit of air.

>f
Hull of the Usagi (vacuum)
Here the path runs aft to the aft airlock and starboard to the engineering airlock. Your path to starboard is blocked by a piece of debris lodged in the hull. [Whatever happened, this was part of it. It's fortunate it didn't penetrate further into the hull.] It's going to be tough to get over; it doesn't look magnetic, so your mag boots won't stick to it. You'll need to be careful.

There is a hook set in the hull here.

It looks like you could break off a small piece of debris.

A stern voice in your helmet intones "Air levels critical. Seek a pressurized location immediately."

>x debris
(the small piece of debris)
It seems like a chunk of what might have been terracotta tile before it was blown up.

A stern voice in your helmet intones "Air levels critical. Seek a pressurized location immediately."

>take i
You can't see any such thing.

>s
You attempt to climb over the debris. Just when you think you're over, your foot catches, and you lose your hold. The result: you're floating about a foot from the hull, unable to make contact with your mag boots to pull yourself down. You're barely moving relative to the hull, but you're stuck here. The bright side? You broke down the debris enough that it's no longer a barrier.

[Okay, stay calm. Don't freak out.]

Hull of the Usagi (vacuum, floating)
Here the path runs aft to the aft airlock and starboard to the engineering airlock. Where there used to be a large embedded chunk of debris blocking the path, now there is a scattering of rubble.

There is a hook set in the hull here.

A stern voice in your helmet intones "Air levels critical. Seek a pressurized location immediately."

>vent suit
You vent a bit of air from your suit. It propels you just a tiny amount toward the hull, but it's enough. One agonizing minute later, you're attached to the hull again.

[Oh thank god! I thought I was a goner.]

Hull of the Usagi (vacuum)
Here the path runs aft to the aft airlock and starboard to the engineering airlock. Where there used to be a large embedded chunk of debris blocking the path, now there is a scattering of rubble.

There is a hook set in the hull here.

A stern voice in your helmet intones "Air levels critical. Seek a pressurized location immediately."

>s
Outside the Engineering Airlock (vacuum)
You are standing on the hull of the ship, outside the engineering airlock, secured by your vac suit's mag boots. Most of the hull is taken up by the protrusions of various machinery, antennae, radio dishes, and heat sinks. There is a clear path to port among the obstructions. You can also go in to the airlock.

A hook protrudes from the hull next to the airlock door.

An alarm sounds and a voice says "Air expended" on repeat.

>in
Welcome back, visitor. I hope your spacewalk was uneventful.

Engineering Airlock
You are in the engineering airlock. Outside, the space to starboard looks so empty and peaceful it's hard to imagine the awful sight astern.

⇒ astern: behind or toward the rear of a ship, spaceship or aircraft.

* * *

>sit
(on the engineering console)
That's not something you can sit down on.

>sit on station
The nozzles on either side of the chair connect with the suit. After a few moments, the machine emits a pleasant "ping", the nozzles retract, and you stand up.

>out
Engineering Airlock
You are in the engineering airlock. Outside, the space to starboard looks so empty and peaceful it's hard to imagine the awful sight astern.

* * *

>out
Outside the Engineering Airlock (vacuum)
You are standing on the hull of the ship, outside the engineering airlock, secured by your vac suit's mag boots. Most of the hull is taken up by the protrusions of various machinery, antennae, radio dishes, and heat sinks. There is a clear path to port among the obstructions. You can also go in to the airlock.

A hook protrudes from the hull next to the airlock door.

Your vac suit pings gently to indicate you have expended a unit of air.

>p
Hull of the Usagi (vacuum)
Here the path runs aft to the aft airlock and starboard to the engineering airlock. Where there used to be a large embedded chunk of debris blocking the path, now there is a scattering of rubble.

There is a hook set in the hull here.

Your vac suit pings gently to indicate you have expended a unit of air.

>x hook
A post extends from the hull here, with a heavyweight snap hook on the end. The hook is unattached.

Your vac suit pings gently to indicate you have expended a unit of air.

>i
You are carrying:
  some slippers
  a vac suit (being worn)
  some chewing gum (being chewed)
  a To-Do list
  a repair corps uniform (being worn)
  a toolbox

Your vac suit pings gently to indicate you have expended a unit of air.

>hook slippers to hook
I'm not sure what you're trying to say. I might just not recognize the words you're using.

>attach slippers to hook
You would achieve nothing by this.

Your vac suit pings gently to indicate you have expended a unit of air.

>jump
You can't even begin to jump in these mag boots.

Your vac suit pings gently to indicate you have expended a unit of air.

>turn off boots
You switch the Magnetic boots off.

Your vac suit pings gently to indicate you have expended a unit of air.

>jump
You propel yourself away from the ship, realizing too late you have no way to get back. You drift through the blackness of space until your air runs out and you suffocate.

    *** You have died ***

In that game you scored 2 out of a possible 10, in 85 turns.

Your death was completely pointless and preventable. All the same we grudgingly award you one point each for what you did accomplish, which was:
- fixing the equipment cabinet in the starboard-side crew quarters
- fixing the aft airlock door

Would you like to RESTART, RESTORE a saved game, QUIT, or UNDO the last command?

>undo
Hull of the Usagi (vacuum)
[Previous turn undone.]

>s
You take a step on the hull of the ship, and keep going, and going... Should have turned those mag boots on.
[Oops.]

    *** You float forever in the vastness of space ***

In that game you scored 2 out of a possible 10, in 85 turns.

Your death was completely pointless and preventable. All the same we grudgingly award you one point each for what you did accomplish, which was:
- fixing the equipment cabinet in the starboard-side crew quarters
- fixing the aft airlock door

Would you like to RESTART, RESTORE a saved game, QUIT, or UNDO the last command?

>undo
Hull of the Usagi (vacuum)
[Previous turn undone.]

>turn on boots
You switch the Magnetic boots on.

Your vac suit pings gently to indicate you have expended a unit of air.

>l
Hull of the Usagi (vacuum)
Here the path runs aft to the aft airlock and starboard to the engineering airlock. Where there used to be a large embedded chunk of debris blocking the path, now there is a scattering of rubble.

There is a hook set in the hull here.

Your vac suit pings gently to indicate you have expended a unit of air.

>x engineering airlock
You can't see any such thing.

>x rubble
Receding behind the SS Usagi, the explosion of Space Station Omicron-5 sadly fades. [That's where I lived.]

Your vac suit pings gently to indicate you have expended a unit of air.

>x omicron-5
The space station is now just an expanding cloud of debris, receding behind the ship.

Your vac suit pings gently to indicate you have expended a unit of air.

>x station
The space station is now just an expanding cloud of debris, receding behind the ship.

Your vac suit pings gently to indicate you have expended a unit of air.

>x space
Which do you mean, deep space or the Space Station Omicron-5?

>x deep space
The blue-white disk of the supergiant Deneb looms largest in your view, but even it is just a small spot in the deep blackness of space.

Your vac suit pings gently to indicate you have expended a unit of air.

>s
Outside the Engineering Airlock (vacuum)
You are standing on the hull of the ship, outside the engineering airlock, secured by your vac suit's mag boots. Most of the hull is taken up by the protrusions of various machinery, antennae, radio dishes, and heat sinks. There is a clear path to port among the obstructions. You can also go in to the airlock.

A hook protrudes from the hull next to the airlock door.

Your vac suit pings gently to indicate you have expended a unit of air.

>x hook
A post extends from the hull here, with a heavyweight snap hook on the end. The hook is unattached.

Your vac suit pings gently to indicate you have expended a unit of air.

>x hook
A post extends from the hull here, with a heavyweight snap hook on the end. The hook is unattached.

Your vac suit pings gently to indicate you have expended a unit of air.

* * *

>x post
A post extends from the hull here, with a heavyweight snap hook on the end. The hook is unattached.

Your vac suit pings gently to indicate you have expended a unit of air.

>in
Engineering Airlock
You are in the engineering airlock. Outside, the space to starboard looks so empty and peaceful it's hard to imagine the awful sight astern.

>x airlock
The airlock is the last defense against the great uncaring vacuum of outer space.

>x space
On this side of the ship, space looks calm and empty. [Maybe it was a nightmare...]

>out
Outside the Engineering Airlock (vacuum)
You are standing on the hull of the ship, outside the engineering airlock, secured by your vac suit's mag boots. Most of the hull is taken up by the protrusions of various machinery, antennae, radio dishes, and heat sinks. There is a clear path to port among the obstructions. You can also go in to the airlock.

A hook protrudes from the hull next to the airlock door.

Your vac suit pings gently to indicate you have expended a unit of air.

>in
Engineering Airlock
You are in the engineering airlock. Outside, the space to starboard looks so empty and peaceful it's hard to imagine the awful sight astern.

>in
Engineering Deck
The engineering crew is responsible for keeping the physical ship operating. They are in charge of every physical aspect of the ship, from the engines to hull integrity to the life support system.

The engineering deck consists of a large console giving a comprehensive view of the physical status of the ship. There is an airlock to starboard. The operations deck continues forward from here, and there are doorways aft and port, to the engine room and machine room respectively.

You hear someone speaking to fore.

A device labeled "Suit Recharging Station" is here. It is shaped like a chair with nozzles protruding from either arm.

>x airlock
The airlock door is to starboard.

>x space
On this side of the ship, space looks calm and empty. [Maybe it was a nightmare...]

>x deck
You can't see any such thing.

>x console
The engineering console is huge, boasting an incomprehensible array of controls and monitors of the physical state of the ship. You dare not mess with it.

>x array
You can't see any such thing.

>x controls
Without a degree in starship engineering, trying to understand these controls is pointless.

* * *

>x monitors
Without a degree in starship engineering, trying to understand these controls is pointless.

>mess with it
I'm not sure how you would do that.

>mess with console
I SAID YOU DARE NOT MESS WITH IT!

>a
Engine Room
This where the combustion process is controlled. The aft wall is dominated by the operating panel section of the fusion engine. Monitoring electronics and controls cover the other two walls. A doorway opens forward to the Engineering Deck.

There is a large screen on the forward wall. It displays nothing right now. There is a large button below the diagram labeled "Test".

>x aft wall
I only understood you as far as wanting to examine aft.

>x wall
You really don't need to worry about the wall.

Attention all crew: command functions are offline and the computer is running with decreased capabilities. Full system reboot required.

>x operating pane
I only understood you as far as wanting to examine the operating panel.

>x operating panel
Without a degree in fusion propulsion, trying to understand these controls is pointless.

>x engine
(the fusion engine)
The portion of the engine directly accessible from the engine room is a formidable machine. You wouldn't dare touch any of the various dials, components, hatches, etc. that adorn the surface. At your feet a part of the engine juts out -- it looks broken.

You add an item ("fix the engine") to your to-do list.

>x list
You have the following items on your to-do list: fix the microwave and fix the engine. You have finished the following: fix the cabinet and fix the airlock door.

>x electronics
Without a degree in fusion propulsion, trying to understand these controls is pointless.

>x controls
Without a degree in fusion propulsion, trying to understand these controls is pointless.

>x screen
The diagram screen is black.

>x button
A square, yellow button with large capital letters saying "TEST".

>press button
Nothing happens.

>f
Engineering Deck
The engineering crew is responsible for keeping the physical ship operating. They are in charge of every physical aspect of the ship, from the engines to hull integrity to the life support system.

The engineering deck consists of a large console giving a comprehensive view of the physical status of the ship. There is an airlock to starboard. The operations deck continues forward from here, and there are doorways aft and port, to the engine room and machine room respectively.

You hear someone speaking to fore.

A device labeled "Suit Recharging Station" is here. It is shaped like a chair with nozzles protruding from either arm.

>p
Machine Room
The machine room is where the physical work of Engineering takes place; for instance, machining new parts. There is a large counter lined with drawers here, as well as numerous saws, drills, and other pieces of equipment. You can leave to starboard.

There's a hand vac sitting on the counter.

* * *

>x drawers
Under the counter is a row of drawers which are closed.

>x counter
A long surface made of some composite material, this counter does an admirable job of keeping things off the floor.

On the machine room counter is a portable hand-held vacuum cleaner.

>x saws
The machine room boasts an impressive array of tools, none of which you have call to use for now.

>l
Machine Room
The machine room is where the physical work of Engineering takes place; for instance, machining new parts. There is a large counter lined with drawers here, as well as numerous saws, drills, and other pieces of equipment. You can leave to starboard.

There's a hand vac sitting on the counter.

>take vac
(the vac suit)
You already have that.

Attention all crew: command functions are offline and the computer is running with decreased capabilities. Full system reboot required.

>take hand
Taken.

>open drawers
You open the machine room drawers, revealing a small key, a roll of electrical tape, a hex-shaped tool, and a fresh fuse.

>take all
small key: Taken.
roll of electrical tape: Taken.
hex-shaped tool: Taken.
fresh fuse: Taken.

>x key
A small steel key.

>x tape
Electrical tape always comes in handy. Perhaps not as handy as duct tape, but pretty handy. There's enough here to last you for a while.

>x tool
Which do you mean, the hex-shaped tool or the toolbox?

>hex
It's got a long handle like a screwdriver, but the end is a hexagon with some complex-looking ridges on it.

>x fuse
A small yellow cartridge fuse.

>s
Engineering Deck
The engineering crew is responsible for keeping the physical ship operating. They are in charge of every physical aspect of the ship, from the engines to hull integrity to the life support system.

The engineering deck consists of a large console giving a comprehensive view of the physical status of the ship. There is an airlock to starboard. The operations deck continues forward from here, and there are doorways aft and port, to the engine room and machine room respectively.

You hear someone speaking to fore.

A device labeled "Suit Recharging Station" is here. It is shaped like a chair with nozzles protruding from either arm.

>f
Operations Deck
This is where all of the support activity for the bridge occurs. There are large consoles for environmental controls (which include gravity, temperature, and pressure), communications, and power systems here. The bridge continues forward from here, and engineering is aft. There is a door set in the floor with a ladder leading through it. Set in the frame of the door is a blue button.

A large equipment trunk lies on the midship door, blocking it.

A man's voice comes over comms: "SS Usagi, come in! Is anyone there?"

[Finally, another person! I'm saved!]

⇒ By the way... you can get help about speaking to other characters by typing "help speech".⇒ You might try saying hello.

>z
Chew, chew, chew...

>z
Chew, chew, chew...

A man's voice comes over comms: "Usagi, are you there?"

>z
Chew, chew, chew...

>z
Chew, chew, chew...

A man's voice comes over comms: "SS Usagi, come in! Is anyone there?"

⇒ You might try saying hello.

>hello
(addressing the caller)
You call out "Yes! I'm here! I'm here! What's going on?"

The caller responds, "Ahoy there, SS Usagi, good to hear from you. Seems like you're a bit out of sorts, and we'd like to help you out. But before we get into that, who am I speaking to? Tell me about yourself."

You tell the caller that you're from the repair corps.

"Alright then, Sergeant Screwdriver, I'll fill you in. Space Station Omicron-5 was bombed by separatists from Deneb IV. By some miracle the Usagi was spared the worst of the blast; you were thrown clear of the station. Only problem is now you're hurtling towards New Da Nang, a heavily-populated moon of Deneb II. An impact there would kill not only you but potentially thousands of people more.

 "So we've got some work to do. I'm Master Sergeant R. Mu Arvax -- you can ask the ship computer about me. I'm going to try and help you get this ship under control again. First we have to establish, though, what the ship is currently doing. Normally, I'd be able to tap into the ship diagnostics and controls from here on Deneb III, but something seems to have gone wrong. So I'm going to need your help. Are you up to the task?"

[Sergeant Screwdriver, guy thinks he's funny.]

"Yes sir!" you proclaim, despite his lame joke.

"Great, great. Now let's get to work.

 "The first thing I need you to do is reboot the system, using the computer. Once you do that, hopefully I'll be able to access ship controls. You'll have to use my access code: say 'compu--"

Master Sergeant R. Mu Arvax's voice breaks up and another voice comes over comms. "SS Usagi, this is Captain Jane Mulgrew, please come in. Repeat, this is Captain Mulgrew of the SS Usagi, Usagi come in."

[Somebody else?]

>hello
(addressing Captain Jane Mulgrew)
Captain Mulgrew responds, "Hello there, Usagi. That's my ship you've got there. Be careful with her.

"We've been listening in and we've heard your communications with Arvax. He had us jammed for a while, but we managed to break through and here we are. Now it's very important that you understand this: Arvax is not your friend. His allegiances lie with Deneb IV, not with the Space Authority. He would like nothing more than to see this ship wipe out a few neighborhoods on New Da Nang.

"So what we need you to do is deny Arvax by shutting down any access to the ship's controls from the outside by invoking the emergency protocols. That will put the ship in a state where we can board and take control of the ship. What do you say? Do you have any questions?"

Master Sergeant R. Mu Arvax's voice comes back over the radio: "You there still, Usagi? I think I lost you for a second."

[Oh no, who should I trust?]

Attention all crew: command functions are offline and the computer is running with decreased capabilities. Full system reboot required.

>ask mulgrew about computer
"Ah yes, I suppose you'll need privileged access. Just say: 'computer, access code 3'."

>ask mulgrew about arvax
"Arvax is a traitor pure and simple. If you haven't yet, consult his file through through the ship computer."

>ask arvax about mulgrew
"Let me guess. She told you I'm a separatist stooge, right? I guess it's time to blow my cover. I've been cultivating that image for several years now to infiltrate Deneb IV. Here. Enter my access code: 'computer, access code 2' and look up 'Operation Dalmatian'."

>d
There's an equipment trunk blocking the door.

>push trunk
You push the trunk clear of the door.

Captain Mulgrew: "Calling the SS Usagi..."

>d
(first opening Midship Door)
You can't open that with your bare hands.

>press button
The door slides open.

Master Sergeant R. Mu Arvax: "Hey, friend, we need to reboot the computer soon before it's too late."

>d
Galley
This narrow space is barely enough room for two Marines to prepare and eat a meal. There is a counter with a drawer, and two stools, a microwave oven, and a large closet here. Pots and pans hang from hooks in the ceiling. A ladder leads up through the midship door, and you can leave aft.

On the starboard wall is a panel on which is a blue button. Tacked to the panel is the operator's manual for the midship door.

You hear someone speaking above.

>listen
You can hear someone talking above you, but their gender is unclear. They're talking in short bursts with pauses between them, and no one seems to be answering.

>a
Junction
This is a busy place when the ship is populated. To port and starboard are the crew quarters, aft is the closed door to the captain's private quarters, and fore is the galley. A ladder leads down to the staging area.

>d
Staging Area
This is the staging area of the ship, where marines prepare for missions. It is adjacent to the aft airlock. Locked compartments set into the walls hold various munitions. A ladder leads up into the rest of the ship. 

An equipment locker is sprawled across the room, with its door to the ground.
 
Through the airlock windows you see the blank space left by the destruction of Space Station Omicron-5.

What looks like part of an engine is stowed in a corner.

You can also see a black trunk (closed) here.

>x locker
The vac suit locker has fallen with its door to the ground. It looks pretty heavy.

>stand on locker
You get onto the vac suit locker.

>flip it over
It's much too heavy to turn over.

>u
(first getting off the vac suit locker)

Junction
This is a busy place when the ship is populated. To port and starboard are the crew quarters, aft is the closed door to the captain's private quarters, and fore is the galley. A ladder leads down to the staging area.

Attention all crew: command functions are offline and the computer is running with decreased capabilities. Full system reboot required.

>f
Galley
This narrow space is barely enough room for two Marines to prepare and eat a meal. There is a counter with a drawer, and two stools, a microwave oven, and a large closet here. Pots and pans hang from hooks in the ceiling. A ladder leads up through the midship door, and you can leave aft.

On the starboard wall is a panel on which is a blue button. Tacked to the panel is the operator's manual for the midship door.

You hear someone speaking above.

>u
Operations Deck
This is where all of the support activity for the bridge occurs. There are large consoles for environmental controls (which include gravity, temperature, and pressure), communications, and power systems here. The bridge continues forward from here, and engineering is aft. There is a door set in the floor with a ladder leading through it. Set in the frame of the door is a blue button.

You can see an equipment trunk (closed) here.

Captain Mulgrew: "Calling the SS Usagi..."

>turn gravity to 1
I only understood you as far as wanting to turn the gravity control.

>set gravity to 1
You got it. Physics has been changed at your whim.

>d
Galley
This narrow space is barely enough room for two Marines to prepare and eat a meal. There is a counter with a drawer, and two stools, a microwave oven, and a large closet here. Pots and pans hang from hooks in the ceiling. A ladder leads up through the midship door, and you can leave aft.

On the starboard wall is a panel on which is a blue button. Tacked to the panel is the operator's manual for the midship door.

You hear someone speaking above.

>f
The obvious exits are aft (to junction) and up (to operations deck).

>a
Junction
This is a busy place when the ship is populated. To port and starboard are the crew quarters, aft is the closed door to the captain's private quarters, and fore is the galley. A ladder leads down to the staging area.

* * *

>d
Staging Area
This is the staging area of the ship, where marines prepare for missions. It is adjacent to the aft airlock. Locked compartments set into the walls hold various munitions. A ladder leads up into the rest of the ship. 

An equipment locker is sprawled across the room, with its door to the ground.
 
Through the airlock windows you see the blank space left by the destruction of Space Station Omicron-5.

What looks like part of an engine is stowed in a corner.

You can also see a black trunk (closed) here.

>flip locker
I didn't understand that sentence.

>flip locker over
You turn over the locker. Now it's door-side-up.

>stand on it
You get onto the vac suit locker.

>open it
You open the locker and search through the contents of the locker. It's mostly broken vac suits, but you discover something interesting and take it: an EVA transport line, used for securing objects during extravehicular transit. You close the locker again.

>x locker
The locker has been flipped door-side-up.

>take suits
You already have that.

>x suits
A puffy yellow suit with an attached helmet and magnetic boots. The gloves are misshapen things, optimized for carrying weaponry, not precision work. There is a nozzle on the front through which air can be recharged or vented. Lights indicate the boots are currently on. A gauge indicates the suit has 32 units of air left.
[I always wanted one of these.]

⇒ You can vent air by using "vent suit."

>x suit
(the vac suit)
A puffy yellow suit with an attached helmet and magnetic boots. The gloves are misshapen things, optimized for carrying weaponry, not precision work. There is a nozzle on the front through which air can be recharged or vented. Lights indicate the boots are currently on. A gauge indicates the suit has 32 units of air left.

>take broken
The broken vac suits aren't important.

>take broken vac suit
The broken vac suits aren't important.

>u
(first getting off the vac suit locker)

Junction
This is a busy place when the ship is populated. To port and starboard are the crew quarters, aft is the closed door to the captain's private quarters, and fore is the galley. A ladder leads down to the staging area.

>open panel
You open the panel, hanging on to the blue screw that held it shut.

The access panel opens to reveal a row of fuses, one of which is blown.

>undo
Junction
[Previous turn undone.]

>unscrew panel
You open the panel, hanging on to the blue screw that held it shut.

The access panel opens to reveal a row of fuses, one of which is blown.

>screw panel
[Why should I close it when I haven't fixed it yet?]

>close panel
[Why should I close it when I haven't fixed it yet?]

>i
You are carrying:
  a blue screw
  an EVA transport line
  a fresh fuse
  a hex-shaped tool
  a roll of electrical tape
  a small key
  a portable hand-held vacuum cleaner
  some slippers
  a vac suit (being worn)
  some chewing gum (being chewed)
  a To-Do list
  a repair corps uniform (being worn)
  a toolbox

>replace fuse
(first removing the blown fuse)
You put the fresh fuse into the access panel.

* * *

>close panel
All of your screws are either too big or too small.

>close panel with gum
I only understood you as far as wanting to close the access panel.

>put gum on panel
(first spitting out the chewing gum)
You stick the chewing gum to the access panel.

>take it
You unstick the chewing gum from the access panel.

>put gum in panel
The used chewing gum doesn't belong in the access panel.

>x panel
The access panel is set in the bulkhead to the left of the door. It is open, leaving an empty hole where the screw was.

The panel holds a row of fresh fuses.

* * *

>close panel
All of your screws are either too big or too small.

>put gum on panel
(first spitting out the chewing gum)
You stick the chewing gum to the access panel.

>close panel
All of your screws are either too big or too small.

>take gum
You unstick the chewing gum from the access panel.

The chewing gum has become stuck to the blown fuse.

>stick panel with gum
Good idea, but it seems something needs to be screwed into the hole somehow.

>close panel with gum
Good idea, but it seems something needs to be screwed into the hole somehow.

>close foo with lfasdf
You can't see any such thing.

>close bear with panel
You can't see any such thing.

>i
You are carrying:
  a blown fuse with chewing gum stuck to it
  an EVA transport line
  a hex-shaped tool
  a roll of electrical tape
  a small key
  a portable hand-held vacuum cleaner
  some slippers
  a vac suit (being worn)
  a To-Do list
  a repair corps uniform (being worn)
  a toolbox

Attention all crew: command functions are offline and the computer is running with decreased capabilities. Full system reboot required.

>close tool with tape
Which do you mean, the hex-shaped tool or the toolbox?

>hex
I'm not sure how to do that.

>repair toolbox with gum
I'm not sure how to do that.

>repair panel with gum
Good idea, but it seems something needs to be screwed into the hole somehow.

>take gum
You unstick the chewing gum from the blown fuse.

>chew it
[Eww. That gum has gotten gross. No way.]

>stick gum to vac suit
You stick the chewing gum to the vac suit.

>put gum in hole
(first taking the chewing gum)
You unstick the chewing gum from the vac suit.

You push the gum into the hole.
[I hope this works.]

>take gum
Try as you might, you can't get the gum out of the hole.

>take all
fresh fuse: Taken.

>take all
But you don't see anything.

* * *

>take gum
Try as you might, you can't get the gum out of the hole.

>x gum
It's a used wad of pink chewing gum. It used to taste like grape, but now it tastes of nothing. It's stuck in the screw hole of the access panel.

>stick panel with gum
Good idea, but it seems something needs to be screwed into the hole somehow.

>close panel
You drive a screw into the gum and it holds. The panel is now closed.

You hear a series of beeps, and a voice says "Door now operational."

It seems you completed something ("fix the captain's door") that wasn't on your to-do list. You note it down.

[Your score has just gone up by one point.]

>undo
Junction
[Previous turn undone.]

>screw panel
You drive a screw into the gum and it holds. The panel is now closed.

You hear a series of beeps, and a voice says "Door now operational."

It seems you completed something ("fix the captain's door") that wasn't on your to-do list. You note it down.

[Your score has just gone up by one point.]

>undo
Junction
[Previous turn undone.]

>fasten panel
What do you want to fasten the access panel to?

>undo
Junction
[Previous turn undone.]

>fix panel
This is a hard one. You'll have to be more specific about how you do that.

>unfo
I'm not sure what you're trying to say. I might just not recognize the words you're using.

* * *

>close panel
When you try to close the access panel, the blue screw slips from your grasp, bounces once, rolls, and falls down the ladder well. At the bottom of the ladder, it bounces once more, right through the grill of an air scrubber intake. That screw's long gone.

>d
Staging Area
This is the staging area of the ship, where marines prepare for missions. It is adjacent to the aft airlock. Locked compartments set into the walls hold various munitions. A ladder leads up into the rest of the ship. 

An equipment locker is sprawled across the room. It has been turned door-side up.
 
Through the airlock windows you see the blank space left by the destruction of Space Station Omicron-5.

What looks like part of an engine is stowed in a corner.

There is an air scrubber intake in the wall here.

You can also see a banged-up suit and a black trunk (closed) here.

>x intake
This is an aperture through which air is pulled for recycling. Even if you knew how, you wouldn't dare open it for fear of wrecking the air scrubber.

>tape intake
That would achieve nothing.

* * *

Typing it on has no description.

Crash
An Interactive Disaster by Phil Riley
Release 18 / Serial number 221030 / Inform 7 build 6M62 (I6/v6.34 lib 6/12N) SD

Space Station Gangway
This is the pressurized bridge from Space Station Omicron-5 to the SS Usagi. Behind you is the familiar bulk of the huge station, largest outpost of the Space Authority in Deneb Sector. Before you is the aft airlock of the Usagi, beckoning you in.

[Better get a move on], you think.

>take all
But you don't see anything.

>rules
Rules tracing now switched on. Type "rules off" to switch it off again, or "rules all" to include even rules which do not apply.

[Rule "reset report text rule" applies.]

>take all
[Rule "After reading a command" applies.]
[Rule "After deciding the scope of the player when the location is offboard" applies.]
[Rule "computer is everywhere rule" applies.]
[Rule "very unlikely to mean taking what's already carried rule" applies.]
[Rule "very unlikely to mean taking what's already carried rule" applies.]
[Rule "very unlikely to mean taking what's already carried rule" applies.]
[Rule "exclude indirect possessions from take all rule" applies.]
[Rule "exclude scenery from take all rule" applies.]
[Rule "exclude scenery from take all rule" applies.]
[Rule "exclude scenery from take all rule" applies.]
[Rule "exclude scenery from take all rule" applies.]
[Rule "exclude scenery from take all rule" applies.]
[Rule "exclude scenery from take all rule" applies.]
[Rule "exclude indirect possessions from take all rule" applies.]
[Rule "exclude indirect possessions from take all rule" applies.]
[Rule "exclude indirect possessions from take all rule" applies.]
[Rule "exclude indirect possessions from take all rule" applies.]
[Rule "exclude indirect possessions from take all rule" applies.]
[Rule "exclude indirect possessions from take all rule" applies.]
[Rule "exclude people from take all rule" applies.]
[Rule "exclude indirect possessions from take all rule" applies.]
[Rule "exclude indirect possessions from take all rule" applies.]
[Rule "exclude indirect possessions from take all rule" applies.]
But you don't see anything.

* * *

Typing it on has no description.

Crash
An Interactive Disaster by Phil Riley
Release 18 / Serial number 221030 / Inform 7 build 6M62 (I6/v6.34 lib 6/12N) SD

Space Station Gangway
This is the pressurized bridge from Space Station Omicron-5 to the SS Usagi. Behind you is the familiar bulk of the huge station, largest outpost of the Space Authority in Deneb Sector. Before you is the aft airlock of the Usagi, beckoning you in.

[Better get a move on], you think.

>take alll
You can't see any such thing.

>take all
There are none at all available!

* * *

>a
Engineering Deck
The engineering crew is responsible for keeping the physical ship operating. They are in charge of every physical aspect of the ship, from the engines to hull integrity to the life support system.

The engineering deck consists of a large console giving a comprehensive view of the physical status of the ship. There is an airlock to starboard. The operations deck continues forward from here, and there are doorways aft and port, to the engine room and machine room respectively.

You hear someone speaking to fore.

A device labeled "Suit Recharging Station" is here. It is shaped like a chair with nozzles protruding from either arm.

>a
Engine Room
This where the combustion process is controlled. The aft wall is dominated by the operating panel section of the fusion engine. Monitoring electronics and controls cover the other two walls. A doorway opens forward to the Engineering Deck.

There is a large diagram of the fuel injection process on the forward wall. There is a large button below the diagram labeled "Test".

You can see a broken JL-758 here.

>a
The only obvious exit is fore (to engineering deck).

>x diagram
This is a diagram of the fuel injection process for the fusion engine. Printed above it is the label "Delphi Engine Controls Aleph-Null". Below that is a representation of the various inputs and the products created during the fuel injection process. Each input has a touch-sensitive surface which can be used to alter the diagram's settings.

       Input: 2 --  3 --  4 --
                ||    ||    ||
             ===vv====vv====vv===
Input 1:     -- >> -- >> -- >> --  Output
             ====================

        FUEL INJECTION SPECIFICATION INCOMPLETE

Key:    --   empty input or output
        AH   Anti-Helium
        LC   Liquid Copernicium*
        Og   Oganesson
        RM   Red Matter            
        TC   Tachyon Crystals
        Un   Unobtainium
        VM   Void Matter*

        * this substance can only be produced, not input.

⇒ Use "substance > input" to set each input. For instance, "Un > 3" sets input 3 to Unobtainium. You may also use "set <input> to <substance>" for the same effect. Use "disconnect <input>" to disconnect an input.

>x input 1
You can't see any such thing.

>x input
You can't see any such thing.

>x VM
You can't see any such thing.

>VM > 1
There is no input for that substance.

Attention: current trajectory intersects the moon New Da Nang. Please correct course.

>AH > 1
This is a diagram of the fuel injection process for the fusion engine. Printed above it is the label "Delphi Engine Controls Aleph-Null". Below that is a representation of the various inputs and the products created during the fuel injection process. Each input has a touch-sensitive surface which can be used to alter the diagram's settings.

       Input: 2 --  3 --  4 --
                ||    ||    ||
             ===vv====vv====vv===
Input 1:     AH >> -- >> -- >> --  Output
             ====================

        FUEL INJECTION SPECIFICATION INCOMPLETE

Key:    --   empty input or output
        AH   Anti-Helium
        LC   Liquid Copernicium*
        Og   Oganesson
        RM   Red Matter            
        TC   Tachyon Crystals
        Un   Unobtainium
        VM   Void Matter*

        * this substance can only be produced, not input.

⇒ Use "substance > input" to set each input. For instance, "Un > 3" sets input 3 to Unobtainium. You may also use "set <input> to <substance>" for the same effect. Use "disconnect <input>" to disconnect an input.

>accessibility on
I'm not sure what you're trying to say. I might just not recognize the words you're using.

* * *

>access on
I didn't understand that sentence.

>accessible on
Accessibility on.

>x diagram
This is a diagram of the fuel injection process for the fusion engine. Printed above it is the label "Delphi Engine Controls Aleph-Null". Below that is a representation of the various inputs and the products created during the fuel injection process. Each input has a touch-sensitive surface which can be used to alter the diagram's settings.

Input 1 is Anti-Helium. Input 2 is unset, so there is no product resulting from inputs 1 and 2. Input 3 isn't set. Input 4 isn't set.
The possible inputs are Anti-Helium, Oganesson, Red Matter, Tachyon Crystals, and Unobtainium. There are two additional possible outputs: Liquid Copernicium and Void Matter.

Tip: Use "substance > input" to set each input. For instance, "Un > 3" sets input 3 to Unobtainium. You may also use "set <input> to <substance>" for the same effect. Use "disconnect <input>" to disconnect an input.

* * *

>a
Engine Room
This where the combustion process is controlled. The aft wall is dominated by the operating panel section of the fusion engine. Monitoring electronics and controls cover the other two walls. A doorway opens forward to the Engineering Deck.

There is a large diagram of the fuel injection process on the forward wall. There is a large button below the diagram labeled "Test".

You can see a broken JL-758 here.

>x rm
You can't see any such thing.

>x diagram
This is a diagram of the fuel injection process for the fusion engine. Printed above it is the label "Delphi Engine Controls Aleph-Null". Below that is a representation of the various inputs and the products created during the fuel injection process. Each input has a touch-sensitive surface which can be used to alter the diagram's settings.

       Input: 2 --  3 --  4 --
                ||    ||    ||
             ===vv====vv====vv===
Input 1:     -- >> -- >> -- >> --  Output
             ====================

        FUEL INJECTION SPECIFICATION INCOMPLETE

Key:    --   empty input or output
        AH   Anti-Helium
        LC   Liquid Copernicium*
        Og   Oganesson
        RM   Red Matter            
        TC   Tachyon Crystals
        Un   Unobtainium
        VM   Void Matter*

        * this substance can only be produced, not input.

⇒ Use "substance > input" to set each input. For instance, "Un > 3" sets input 3 to Unobtainium. You may also use "set <input> to <substance>" for the same effect. Use "disconnect <input>" to disconnect an input.

>x red matter
I only understood you as far as wanting to examine the red access card.

>x anti-helium
You can't see any such thing.

* * *

Typing it on has no description.

Crash
An Interactive Disaster by Phil Riley
Release 18 / Serial number 221030 / Inform 7 build 6M62 (I6/v6.34 lib 6/12N) SD

Space Station Gangway
This is the pressurized bridge from Space Station Omicron-5 to the SS Usagi. Behind you is the familiar bulk of the huge station, largest outpost of the Space Authority in Deneb Sector. Before you is the aft airlock of the Usagi, beckoning you in.

[Better get a move on], you think.

>x floor
You can't see any such thing.

>f
You pass into the aft airlock, the outer door closing behind you.

The Second Law of Thermodynamics, in one formulation, states that disorganization always increases in the absence of some outside force. A corollary is that things will always break down in the absence of someone to fix them. As a member of the repair corps of Space Station Omicron-5, you're that someone.

Your last assignment of the day, on the SS Usagi, a Space Marines fighting ship, looks routine enough. Fix the microwave and a jammed cabinet door, and then you're off for the day.

Aft Airlock
You are in the aft airlock. Outside is the gangway back to Space Station Omicron-5. Forward leads into the ship.

A pleasant androgynous voice says, "Welcome to the SS Usagi. This is the shipboard computer. Please feel free to call upon me for any information you may need. Use the command 'computer, help' for more information."

>pf
PLANETFALL
Infocom interactive fiction - a science fiction story
Copyright (c) 1983 by Infocom, Inc. All rights reserved.
PLANETFALL is a registered trademark of Infocom, Inc.
Release 39 / Serial number 880501

Another routine day of drudgery aboard the Stellar Patrol Ship Feinstein. This morning's assignment for a certain lowly Ensign Seventh Class: scrubbing the filthy metal deck at the port end of Level Nine. With your Patrol-issue self-contained multi-purpose all-weather scrub brush you shine the floor with a diligence born of the knowledge that at any moment dreaded Ensign First Class Blather, the bane of your shipboard existence, could appear.

>x floor
You see nothing special about the floor.

* * *

Typing it on has no description.

Crash
An Interactive Disaster by Phil Riley
Release 18 / Serial number 221030 / Inform 7 build 6M62 (I6/v6.34 lib 6/12N) SD

Space Station Gangway
This is the pressurized bridge from Space Station Omicron-5 to the SS Usagi. Behind you is the familiar bulk of the huge station, largest outpost of the Space Authority in Deneb Sector. Before you is the aft airlock of the Usagi, beckoning you in.

[Better get a move on], you think.

>x gum
It still tastes pretty good.

* * *

Typing it on has no description.

Crash
An Interactive Disaster by Phil Riley
Release 18 / Serial number 221030 / Inform 7 build 6M62 (I6/v6.34 lib 6/12N) SD

Space Station Gangway
This is the pressurized bridge from Space Station Omicron-5 to the SS Usagi. Behind you is the familiar bulk of the huge station, largest outpost of the Space Authority in Deneb Sector. Before you is the aft airlock of the Usagi, beckoning you in.

[Better get a move on], you think.

>x tools
Your toolbox holds wrenches, screwdrivers, pliers, and an assortment of various fasteners.

>x screwdrivers
All of your tools are top quality.