Would you like to use accessibility features like no ASCII art? (enter "y" for yes)

I beg your pardon?

>n
Space Station Gangway
This is the pressurized bridge from Space Station Omicron-5 to the SS Usagi. Behind you the safety of home, before you the promise of adventure... cleaning up after space marines. Such is the lot of the 95th Sanitation Division. Not what you dreamed of when you enlisted.

As is usual, the crew is all off the ship while you board to clean it. You usually have a partner, but today Private "Chubby" Franks has the flu, so it's your job alone.

To the fore is the aft airlock of the Usagi, beckoning you in.

[Better get a move on, I guess], you think.

⇒ For help with testing, enter "help test".

⇒ Tip: Type "help" to learn about this game, and interactive fiction in general.

>test onepass
(Testing.)

>[1] gonear onepass
Starboard-Side Bunks
All crew members who aren't the captain sleep in this or the opposite-side bunk room. This one sleeps four in two sets of bunks, one on the left and one on the right, all done up with military precision. There is a large locker here, stretching almost to the ceiling. It is closed. The sole exit is to port.

On the left bottom bunk is a OnePass.

A copy of Stars Magazine is just peeking from underneath the left bottom bunk.

>[2] take onepass
Taken.

>[3] slide onepass in slot
A light on the locker flashes red.

>[4] purloin id
(the military ID card)
[Purloined.]

>[5] put id in onepass
The OnePass swallows up the military ID card. It is now available when using the OnePass.

>[6] purloin steel key
[Purloined.]

>[7] slide onepass in slot
A green light by the lock starts flashing insistently.

>[8] unlock locker with key
You unlock the starboard-side equipment locker.

You open the starboard-side equipment locker, revealing a beacon.

* * *

Would you like to use accessibility features like no ASCII art? (enter "y" for yes)

>Y
Space Station Gangway
This is the pressurized bridge from Space Station Omicron-5 to the SS Usagi. Behind you the safety of home, before you the promise of adventure... cleaning up after Space Marines. Such is the lot of the 95th Sanitation Division. Not what you dreamed of when you enlisted.

As is usual, the crew is all off the ship while you board to clean it. You usually have a partner, but today Pvt "Chubby" Franks has the flu, so it's your job alone.

To the fore is the aft airlock of the Usagi, beckoning you in.

(You think "Better get a move on, I guess")

Tip: Type "help" to learn about this game, and interactive fiction in general.

>a
You can't go that way.

>y
There's no one here to talk to.

* * *

Would you like to use accessibility features like no ASCII art? (enter "y" for yes)

>accessible on
Accessibility on.

>gonear diagram
Engine Room
Though no engines are actually in this room, it is where the combustion process is controlled. Monitoring electronics and controls cover the walls. A wide doorway opens forward to the Engineering Deck, and small portals to port and starboard provide access to the two engine chambers. The main engine, which drives the two side engines, is beyond the aft wall.

There is a large diagram of the fuel injection process on the aft wall. There is a large button below the diagram labeled "Test".

>rebooted
Captain's Quarters
Neat and spartan, this cabin is the very model of a small fighting ship's captain's quarters. An impeccably organized desk is against one wall, while a typically spotless bed sits beneath a portrait of this very ship. There is a data terminal on the desk. Against a third wall is the captain's one indulgence: a set of free weights neatly put away in racks. You can exit to fore.

You can see a 9kg weight, a 15kg weight, a 29kg weight, a 32kg weight, and a 50kg weight here.

Tip: You may talk to the ship computer through the data terminal. You might try "computer, help" to get help on talking to the computer.

>x diagram
You can't see any such thing.

>gonear diagram
Engine Room
Though no engines are actually in this room, it is where the combustion process is controlled. Monitoring electronics and controls cover the walls. A wide doorway opens forward to the Engineering Deck, and small portals to port and starboard provide access to the two engine chambers. The main engine, which drives the two side engines, is beyond the aft wall.

There is a large diagram of the fuel injection process on the aft wall. There is a large button below the diagram labeled "Test".

>x it
This is a diagram of the fuel injection process for the main engine. Printed above it is the label "Delphi Engine Controls Aleph-Null". Below that is a representation of the various inputs and the products created during the fuel injection process. Each input has a touch-sensitive surface which can be used to alter the diagram's settings.

Input 1 is unset. Neither is Input 2 set. Input 3 isn't set.
Input 4 isn't set.

Tip: Use "substance > input" to set each input. For instance, "Un > 3" sets input 3 to Unobtainium. You may also use "set <input> to <substance>" for the same effect. Use "disconnect <input>" to disconnect an input.

* * *

>accessible on
Accessibility on.

>l
Space Station Gangway
This is the pressurized bridge from Space Station Omicron-5 to the SS Usagi. Behind you the safety of home, before you the promise of adventure... cleaning up after Space Marines. Such is the lot of the 95th Sanitation Division. Not what you dreamed of when you enlisted.

As is usual, the crew is all off the ship while you board to clean it. You usually have a partner, but today Pvt "Chubby" Franks has the flu, so it's your job alone.

To the fore is the aft airlock of the Usagi, beckoning you in.

(You think "Better get a move on, I guess")

Tip: Type "help" to learn about this game, and interactive fiction in general.

* * *

>accessible on
Accessibility on.

>rebooted
Captain's Quarters
Neat and spartan, this cabin is the very model of a small fighting ship's captain's quarters. An impeccably organized desk is against one wall, while a typically spotless bed sits beneath a portrait of this very ship. There is a data terminal on the desk. Against a third wall is the captain's one indulgence: a set of free weights neatly put away in racks. You can exit to fore.

You can see a 9kg weight, a 15kg weight, a 29kg weight, a 32kg weight, and a 50kg weight here.

Tip: You may talk to the ship computer through the data terminal. You might try "computer, help" to get help on talking to the computer.

>gonear diagram
Engine Room
Though no engines are actually in this room, it is where the combustion process is controlled. Monitoring electronics and controls cover the walls. A wide doorway opens forward to the Engineering Deck, and small portals to port and starboard provide access to the two engine chambers. The main engine, which drives the two side engines, is beyond the aft wall.

There is a large diagram of the fuel injection process on the aft wall. There is a large button below the diagram labeled "Test".

>x diagram
The diagram screen is black.

* * *

>gonear diagram
Engine Room
Though no engines are actually in this room, it is where the combustion process is controlled. Monitoring electronics and controls cover the walls. A wide doorway opens forward to the Engineering Deck, and small portals to port and starboard provide access to the two engine chambers. The main engine, which drives the two side engines, is beyond the aft wall.

There is a large diagram of the fuel injection process on the aft wall. There is a large button below the diagram labeled "Test".

>x it
This is a diagram of the fuel injection process for the main engine. Printed above it is the label "Delphi Engine Controls Aleph-Null". Below that is a representation of the various inputs and the products created during the fuel injection process. Each input has a touch-sensitive surface which can be used to alter the diagram's settings.

Input 1 is unset. Neither is Input 2 set. Input 3 isn't set.Input 4 isn't set.

Tip: Use "substance > input" to set each input. For instance, "Un > 3" sets input 3 to Unobtainium. You may also use "set <input> to <substance>" for the same effect. Use "disconnect <input>" to disconnect an input.

* * *

Would you like to use accessibility features like no ASCII art? (enter "y" for yes)

>asdftkayasdf
Space Station Gangway
This is the pressurized bridge from Space Station Omicron-5 to the SS Usagi. Behind you the safety of home, before you the promise of adventure... cleaning up after Space Marines. Such is the lot of the 95th Sanitation Division. Not what you dreamed of when you enlisted.

As is usual, the crew is all off the ship while you board to clean it. You usually have a partner, but today Pvt "Chubby" Franks has the flu, so it's your job alone.

To the fore is the aft airlock of the Usagi, beckoning you in.

[Better get a move on, I guess], you think.

⇒ Tip: Type "help" to learn about this game, and interactive fiction in general.

* * *

Would you like to use accessibility features like no ASCII art? (enter "y" for yes)

>b
Space Station Gangway
This is the pressurized bridge from Space Station Omicron-5 to the SS Usagi. Behind you the safety of home, before you the promise of adventure... cleaning up after space marines. Such is the lot of the 95th Sanitation Division. Not what you dreamed of when you enlisted.

As is usual, the crew is all off the ship while you board to clean it. You usually have a partner, but today Private "Chubby" Franks has the flu, so it's your job alone.

To the fore is the aft airlock of the Usagi, beckoning you in.

[Better get a move on, I guess], you think.

⇒ For help with testing, enter "help test".

⇒ Tip: Type "help" to learn about this game, and interactive fiction in general.

* * *

>put all in onepass
Engineering Access Card: The OnePass swallows up the Engineering Access Card. It is now available when using the OnePass.
military ID card: The OnePass swallows up the military ID card. It is now available when using the OnePass.
extendable dusting device: That can't contain things.
hand-held micro-compressing vacuum cleaner: That can't contain things.
wallet: That can't contain things.
sonic decontaminator: That can't contain things.
maintenance crew access card: The OnePass swallows up the maintenance crew access card. It is now available when using the OnePass.

>slide onepass through slot
You slide the OnePass through the slot. The door buzzes three times, indicating the card is unreadable.

>vacuum slot
You vacuum the slot for a few seconds. That should do it.

>slide onepass through slot
You slide the OnePass through the slot.

I beg your pardon?

* * *

Would you like to use accessibility features like no ASCII art? (enter "y" for yes)

>break off debris
Space Station Gangway
This is the pressurized bridge from Space Station Omicron-5 to the SS Usagi. Behind you the safety of home, before you the promise of adventure... cleaning up after Space Marines. Such is the lot of the 95th Sanitation Division. Not what you dreamed of when you enlisted.

As is usual, the crew is all off the ship while you board to clean it. You usually have a partner, but today Pvt "Chubby" Franks has the flu, so it's your job alone.

To the fore is the aft airlock of the Usagi, beckoning you in.

[Better get a move on, I guess], you think.

⇒ For help with testing, enter "help test".

⇒ Tip: Type "help" to learn about this game, and interactive fiction in general.

>break off debris
You can't see any such thing.

* * *

>a
Outside the Aft Airlock (vacuum)
You are standing on the hull of the ship, outside the aft airlock, secured by your vac suit's mag boots. Most of the hull is taken up by the protrusions of various machinery, antennae, radio dishes, and heat sinks. There is a clear path to fore among the obstructions.

The aft airlock outer door is open.

Your vac suit pings gently to indicate you have expended a unit of air.

>break off debris
You can't see any such thing.

>break debris
You can't see any such thing.

>f
Hull of the Usagi (vacuum)
Here the path runs aft to the aft airlock and starboard to the engineering airlock. Your path to starboard is blocked by a piece of debris lodged in the hull.  It's going to be tough to get over; it doesn't look magnetic, so you'll have to do it without the help of your mag boots.

It looks like you could break off a small piece of debris.

Your vac suit pings gently to indicate you have expended a unit of air.

>break off debris
You break off a piece of the debris.

Your vac suit pings gently to indicate you have expended a unit of air.

>i
You are carrying:
  a small piece of debris
  a military ID card
  a wallet (open but empty)
  a vac suit (being worn)

Your vac suit pings gently to indicate you have expended a unit of air.

>break off debris
You already have that.

A stern voice in your helmet intones "Air levels critical. Seek a pressurized location immediately."

>break debris
(the small piece of debris)
Violence isn't the answer to this one.

A stern voice in your helmet intones "Air levels critical. Seek a pressurized location immediately."

>drop it
Dropped.

A stern voice in your helmet intones "Air levels critical. Seek a pressurized location immediately."

>break it
Violence isn't the answer to this one.

A stern voice in your helmet intones "Air levels critical. Seek a pressurized location immediately."

>break off debris
Taken.

A stern voice in your helmet intones "Air levels critical. Seek a pressurized location immediately."

* * *

Would you like to use accessibility features like no ASCII art? (enter "y" for yes)

>f
You pass through the aft airlock and into the ship, closing the airlock doors behind you.

Aft Entry
You are forward from the aft airlock, inside the ship. Beyond the airlock is the station gangway.

On your right is a control panel for the airlock. It consists of a green button to pressurize the airlock chamber, a yellow button to depressurize it, a red button to open and close the inner airlock door, and a blue button to open and close the outer airlock door.

The airlock is aft of here, and a ladder leads up to the ship proper.

The aft airlock inner door is closed.

>a
Your work is in the ship, not outside.

>u
Crew Quarters
This is a busy junction when the ship is populated. To port and starboard are the crew bunks, aft is the door to the captain's quarters, and fore is the galley. A ladder leads down to the aft airlock.

BOOM -- suddenly everything goes to hell. A bulkhead seems to hurtle towards you...
pain...
confusion...
blackness...
Somehow you're okay. Inertial dampers must have kicked in. Nevertheless, you feel like you were hit by a truck.
But what happened?

Crash
An Interactive Fiction by Phil Riley
Release 2 / Serial number 220618 / Inform 7 build 6M62 (I6/v6.34 lib 6/12N) SD

[Uhhhhh...]

>z
[What? Didn't get that. My brain is spinning too much. Try again.]

>z
Somewhere? (Where?) (lying on something comfortable)
Aaa cccc mmmmmmm www aaaa'a ttt ccccccc sssss in this or the opposite-side bunk room. This one ssssss ffff in ttt ssss oo bbbbb, one on the llll aaa ooo oo ttt rrrrr, aaa dddd uu wwww mmmmmmmm ppppppppp. There is a lllll eeeeeeeee ccccccc hhhh, ssssssssss aaaaaa to the ccccccc. Ii ii cccccc.

[Everything's a bit fuzzy.]

>z
You come to your senses lying on a bunk, not quite sure how you got here. You seem to have lost your equipment.

Port-Side Bunks (on the right bottom bunk)
[Okay, now things are coming into focus.]

All crew members who aren't the captain sleep in this or the opposite-side bunk room. This one sleeps four in two sets of bunks, one on the left and one on the right, all done up with military precision. There is a large locker here, stretching almost to the ceiling. It is closed. The sole exit is to starboard.

Something is affixed to the wall by the top left bunk.

A leather wallet lies discarded on the ground.

On the right top bunk is an extendable dusting device [that's mine].

You can also see a sonic decontaminator [also mine] here.

On the right bottom bunk you can see a hand-held micro-compressing vacuum cleaner [mine again. I really took a tumble.].

[Ohh my head hurts. What the heck happened? Better get back to the station pronto.]

>get up
You get off the right bottom bunk.

Port-Side Bunks
All crew members who aren't the captain sleep in this or the opposite-side bunk room. This one sleeps four in two sets of bunks, one on the left and one on the right, all done up with military precision. There is a large locker here, stretching almost to the ceiling. It is closed. The sole exit is to starboard.

Something is affixed to the wall by the top left bunk.

A leather wallet lies discarded on the ground.

On the right bottom bunk is a hand-held micro-compressing vacuum cleaner.

On the right top bunk is an extendable dusting device.

You can also see a sonic decontaminator here.

[Standing up makes me a little dizzy, oh my.]

[Okay now, back to the station -- let's see, I'm in Port-Side Bunks, so I need to go starboard and then down...]

>get all
sonic decontaminator: Taken.
wallet: Taken.
hand-held micro-compressing vacuum cleaner: Taken.
extendable dusting device: Taken.

>s
Crew Quarters
This is a busy junction when the ship is populated. To port and starboard are the crew bunks, aft is the door to the captain's quarters, and fore is the galley. A ladder leads down to the aft airlock.

>vacuum slot
You vacuum the slot for a few seconds. That should do it.

>a
The door stays shut as you try to go through it.

>swipe card in slot
You slide the maintenance crew access card through the slot. The Captain's door slides smoothly open. A pleasant ping indicates it now recognizes you as authorized.

>a
The Captain's door closes silently behind you.

Captain's Quarters
Neat and spartan, this cabin is the very model of a small fighting ship's captain's quarters. An impeccably organized desk is against one wall, while a typically spotless bed sits beneath a portrait of this very ship. There is a data terminal on the desk. Against a third wall is the captain's one indulgence: a set of free weights neatly put away in racks. You can exit to fore.

You can see a 9kg weight, a 15kg weight, a 29kg weight, a 32kg weight and a 50kg weight here.

⇒ You may talk to the ship computer through the data terminal. You might try "computer, help" to get help on talking to the computer."

>computer, help
"This is the ship computer of the SS Usagi. For a list of helpful commands and topics, please consult the terminal."

"Helpful commands: 

 - ask computer about <subject>
 - computer, emergency protocols: activates the ship's emergency protocols
 - computer, reboot
 - computer, access code <code>

>computer, reboot
"Authorization required."

>computer, emergency protocols
"Authorization required."

>computer, access code 34534
"Access denied."

>ask computer about computer
"This is the ship computer of the SS Usagi. For a list of helpful commands and topics, please consult the terminal."

"Helpful commands: 

 - ask computer about <subject>
 - computer, emergency protocols: activates the ship's emergency protocols
 - computer, reboot
 - computer, access code <code>

>ask computer about usagi
"Displaying available information on the SS Usagi."

The data terminal displays a screen of text:

"The SS Usagi is a light frigate in the Deneb system, with a crew of nine including the captain. It is currently helmed by Captain Jane Mulgrew. The ship's main drive is a Luna Spacewerks Parsec VI."

>ask computer about mulgrew
"Displaying available information on Captain Jane Mulgrew."

The data terminal displays a screen of text:

"Captain Mulgrew is one of the most decorated captains in the Deneb sector. She was the second-youngest graduate of the Orion Marine Academy. She received command of the SS Usagi after successfully leading the retaking of the capital of Pollux VI from Irion invaders from the moon of Pollux III."

>ask computer about orion marine academy
"I'm unable to give you any information about Orion Marine Academy."

>ask computer about drive
"Displaying available information on Luna Spacewerks Parsec VI."

The data terminal displays a screen of text:

"The Luna Spacewerks Parsec VI is a starship engine used mainly by the Space Authority to drive light frigate class vessels. It is powered by Liquid Copernicium."

>ask computer about space authority
"Displaying available information on Space Authority."

The data terminal displays a screen of text:

"The Space Authority is the governing body of most human-controlled space. Its military is known as the Space Force. The Space Authority is a socialist society with a representative democracy."

>ask computer about liquid copernicium
"Displaying available information on Liquid Copernicium."

The data terminal displays a screen of text:

"Liquid Copernicium is the liquid form of the element Copernicium. It is a common starship fuel. It can be created by injecting Oganesson into Red Matter."

>ask computer about copernicium
Which do you mean, Liquid Copernicium or Copernicium Element?

>element
"Displaying available information on Copernicium Element."

The data terminal displays a screen of text:

"Copernicium is an element with atomic number 112. It has symbol Cn. Its liquid form is a common starship fuel. The melting point of Copernicium is 15 ºC, and its boiling point is 73 ºC."

>ask computer about oganesson
"Displaying available information on Oganesson."

The data terminal displays a screen of text:

"Oganesson is an element with atomic number 118. It is often used to create Liquid Copernicium."

>ask computer about red matter
"Displaying available information on Red Matter."

The data terminal displays a screen of text:

"Red Matter is an unstable, possibly impossible substance created by injecting Tachyon Crystals into Unobtainium."

>ask computer about tachyon
"Displaying available information on Tachyon Crystals."

The data terminal displays a screen of text:

"Rather than containing or being formed of tachyons, tachyon crystals get their name from their use in detecting tachyons, due to their negative refractive index. The typical method of creating tachyon crystals is injecting Anti-Helium into Red Matter. Tachyon Crystals can be used in the creation of Void Matter."

>ask computer about void matter
"Displaying available information on Void Matter."

The data terminal displays a screen of text:

"Void Matter is essentially vacuum condensed into matter, according to the most comprehensible description we could find. It is an extremely unstable substance, and tends to explode catastrophically in the presence of high levels of energy. It can be created by injecting one source of tachyon crystals into another source of tachyon crystals."

>ask compuer about anti-helium
You can't see any such thing.

>ask computer about anti-helium
"Displaying available information on Anti-Helium."

The data terminal displays a screen of text:

"Anti-Helium is the anti-matter equivalent of Helium, possessing two positrons and two antiprotons. It is most notably used in the creation of Unobtainium and Tachyon Crystals."

>ask computer about unobtainium
"Displaying available information on Unobtainium."

The data terminal displays a screen of text:

"Unobtanium can only be acquired by the injection of Anti-Helium into Oganesson, hence its legendary reputation for being difficult to obtain."

>ask computer about injection
"Displaying available information on Fuel injection specification."

The data terminal displays a screen of text:

"Starship fuel injection is the process of "injecting" one substance into another, creating a third substance at a higher energy level. See "Substance Injection"."

>ask computer about substance injection
"Displaying available information on Substance Injection."

The data terminal displays a screen of text:

"A process by which one substance is "injected" into another to create a product substance. This is an asymmetric operation, in that injecting substance A into substance B generally yields a different result than injecting substance B into substance A. Note that most injection combinations result in no product substance, as the resulting matter decays too rapidly to capture."

>ask computer about arvax
"I'm unable to give you any information about arvax."

* * *

>f
You pass through the aft airlock and into the ship, closing the airlock doors behind you.

Aft Entry
You are forward from the aft airlock, inside the ship. Beyond the airlock is the station gangway.

On your right is a control panel for the airlock. It consists of a green button to pressurize the airlock chamber, a yellow button to depressurize it, a red button to open and close the inner airlock door, and a blue button to open and close the outer airlock door.

The airlock is aft of here, and a ladder leads up to the ship proper.

The aft airlock inner door is closed.

>rebooted
Captain's Quarters
Neat and spartan, this cabin is the very model of a small fighting ship's captain's quarters. An impeccably organized desk is against one wall, while a typically spotless bed sits beneath a portrait of this very ship. There is a data terminal on the desk. Against a third wall is the captain's one indulgence: a set of free weights neatly put away in racks. You can exit to fore.

You can see a 9kg weight, a 15kg weight, a 29kg weight, a 32kg weight and a 50kg weight here.

⇒ You may talk to the ship computer through the data terminal. You might try "computer, help" to get help on talking to the computer.

>f
The Captain's door opens as you approach, and closes silently behind you.

Crew Quarters
This is a busy junction when the ship is populated. To port and starboard are the crew bunks, aft is the door to the captain's quarters, and fore is the galley. A ladder leads down to the aft airlock.

>f
The Galley
This narrow space is barely enough room for two Marines to prepare and eat a meal. There is a counter with two stools, a microwave oven, and a large closet here. Pots and pans hang from hooks in the ceiling. A ladder leads up through the fore/aft door, and you can leave aft.

On the starboard wall is a panel on which is a blue button. Tacked to the panel is the operator's manual for the fore/aft door.

>u
Operations
This is where all of the support activity for the bridge occurs. There are large consoles for environmental controls, communications, and power systems here. The bridge continues forward from here, and engineering is aft. There is a door set in the floor with a ladder leading through it. Set in the frame of the door is a blue button.

A large equipment trunk lies on the Fore/Aft door, blocking it.

You can also see an extendable dusting device, a hand-held micro-compressing vacuum cleaner, a sonic decontaminator and a maintenance crew access card here.

A man's voice comes over comms: "Usagi, are you there?"

[Finally, another person! I'm saved!]

⇒ By the way... you can get help about speaking to other characters by typing "help speech".

⇒ You might try saying hello.

>hello
(addressing Master Sergeant R. Mu Arvax)
You call out "Yes! I'm here! I'm here! What's going on?"

Master Sergeant R. Mu Arvax responds, "Ahoy there, SS Usagi, good to hear from you. Seems like you're a bit out of sorts, and we'd like to help you out. But before we get into that, who am I speaking to? Tell me about yourself."

* * *

>f
You pass through the aft airlock and into the ship, closing the airlock doors behind you.

Aft Entry
You are forward from the aft airlock, inside the ship. Beyond the airlock is the station gangway.

On your right is a control panel for the airlock. It consists of a green button to pressurize the airlock chamber, a yellow button to depressurize it, a red button to open and close the inner airlock door, and a blue button to open and close the outer airlock door.

The airlock is aft of here, and a ladder leads up to the ship proper.

The aft airlock inner door is closed.

>u
[Uhhhhh...]

>z
[What? Didn't get that. My brain is spinning too much. Try again.]

* * *

>take all
sonic decontaminator: Taken.
wallet: Taken.
hand-held micro-compressing vacuum cleaner: Taken.
extendable dusting device: Taken.

>s
Crew Quarters
This is a busy junction when the ship is populated. To port and starboard are the crew bunks, aft is the door to the captain's quarters, and fore is the galley. A ladder leads down to the aft airlock.

>d
Aft Entry
You are forward from the aft airlock, inside the ship. Outside is empty space where you're used to seeing the station gangway. Far off you see the luminous embers of what might have been an explosion.

On your right is a control panel for the airlock. It consists of a green button to pressurize the airlock chamber, a yellow button to depressurize it, a red button to open and close the inner airlock door, and a blue button to open and close the outer airlock door.

The airlock is aft of here, and a ladder leads up to the ship proper.

The aft airlock inner door is closed.

[Holy... the station -- it's gone? Where the hell am I? What am I going to do?]

>u
Crew Quarters
This is a busy junction when the ship is populated. To port and starboard are the crew bunks, aft is the door to the captain's quarters, and fore is the galley. A ladder leads down to the aft airlock.

>slide access card through slot
You slide the maintenance crew access card through the slot. The door buzzes three times, indicating the card is unreadable.
[I don't understand. The card worked earlier today.]

>x slot
You see a substantial buildup of dust inside the Captain's door's slot.

>dust slot
The Captain's door's slot is too narrow for the duster to get in there.

>vacuum slot
You vacuum the slot for a few seconds. That should do it.

>slide access card through slot
You slide the maintenance crew access card through the slot. The Captain's door slides smoothly open. A pleasant ping indicates it now recognizes you as authorized.

>a
The Captain's door closes silently behind you.

Captain's Quarters
Neat and spartan, this cabin is the very model of a small fighting ship's captain's quarters. An impeccably organized desk is against one wall, while a typically spotless bed sits beneath a portrait of this very ship. There is a data terminal on the desk. Against a third wall is the captain's one indulgence: a set of free weights neatly put away in racks. You can exit to fore.

You can see a 9kg weight, a 15kg weight, a 29kg weight, a 32kg weight and a 50kg weight here.

⇒ You may talk to the ship computer through the data terminal. You might try "computer, help" to get help on talking to the computer."

>x desk
(the captain's desk)
The Captain's desk is a simple institutional metal desk with a single drawer which is closed. There is a data terminal on the desk.

>open desk
(the captain's desk)
You open the desk drawer, revealing a steel key and a strange device.

>take all from desk
(the desk drawer)
steel key: Taken.
strange device: Taken.

>x strange device
The strange device is an 8" x 11" rectangle about three inches thick. The top is largely taken up by a screen, except for two buttons, left and right. There is a thin slot on the close side, with a small button next to it.

>x data terminal
The data terminal displays the message "Basic access available. State security code for privileged access."

>ask computer for help
Try "computer, help" instead.

>computer, help
"This is the ship computer of the SS Usagi. For a list of helpful commands and topics, please consult the terminal."

"Helpful commands: 

 - ask computer about <subject>
 - computer, emergency protocols: activates the ship's emergency protocols
 - computer, reboot
 - computer, access code <code>

>ask computer about space station
"Displaying available information on the Space Station Omicron-5."

The data terminal displays a screen of text:

"The Deneb system outpost of the Space Authority."

>ask computer about ship
(the portrait of the ship)
"I'm unable to give you any information about the portrait of the ship."

>ask computer about this ship
"I'm unable to give you any information about this ship."

>i
You are carrying:
  a strange device
  a steel key
  an extendable dusting device
  a hand-held micro-compressing vacuum cleaner
  a wallet (closed)
  a sonic decontaminator
  a maintenance crew access card
  a military sanitation uniform (being worn)

>l
Captain's Quarters
Neat and spartan, this cabin is the very model of a small fighting ship's captain's quarters. An impeccably organized desk is against one wall, while a typically spotless bed sits beneath a portrait of this very ship. There is a data terminal on the desk. Against a third wall is the captain's one indulgence: a set of free weights neatly put away in racks. You can exit to fore.

You can see a 9kg weight, a 15kg weight, a 29kg weight, a 32kg weight and a 50kg weight here.

The desk drawer is open and empty.

>x portrait
The SS Usagi looks ungainly, as a vessel that travels in vacuum typically does, but it's truly a beautiful ship.

>ask computer about ss usagi
"Displaying available information on the SS Usagi."

The data terminal displays a screen of text:

"The SS Usagi is a light frigate in the Deneb system, with a crew of nine including the captain. It is currently helmed by Captain Jane Mulgrew. The ship's main drive is a Luna Spacewerks Parsec VI."

>ask computer about mulgrew
"Displaying available information on Captain Jane Mulgrew."

The data terminal displays a screen of text:

"Captain Mulgrew is one of the most decorated captains in the Deneb sector. She was the second-youngest graduate of the Orion Marine Academy. She received command of the SS Usagi after successfully leading the retaking of the capital of Pollux VI from Irion invaders from the moon of Pollux III."

>f
The Captain's door opens as you approach, and closes silently behind you.

Crew Quarters
This is a busy junction when the ship is populated. To port and starboard are the crew bunks, aft is the door to the captain's quarters, and fore is the galley. A ladder leads down to the aft airlock.

* * *

>f
The Galley
This narrow space is barely enough room for two Marines to prepare and eat a meal. There is a counter with two stools, a microwave oven, and a large closet here. Pots and pans hang from hooks in the ceiling. A ladder leads up through the fore/aft door, and you can leave aft.

On the starboard wall is a panel on which is a blue button. Tacked to the panel is the operator's manual for the fore/aft door.

>press blue button
A loud buzzer sounds and a red light flashes on the door, which stays resolutely shut.

You hear someone speaking above.

>read manual
Most of the manual is concerned with the technical details of the door, such as installation, maintainance, and repair. There is a small section towards the end detailing its safety features; for example: "To prevent injury, the Portmaster V S-65 will not open when it senses weight pressing upon it from above. In this case, an audible signal and a red warning light will indicate that an obstruction exists."

>a
Crew Quarters
This is a busy junction when the ship is populated. To port and starboard are the crew bunks, aft is the door to the captain's quarters, and fore is the galley. A ladder leads down to the aft airlock.

>p
Port-Side Bunks
All crew members who aren't the captain sleep in this or the opposite-side bunk room. This one sleeps four in two sets of bunks, one on the left and one on the right, all done up with military precision. There is a large locker here, stretching almost to the ceiling. It is closed. The sole exit is to starboard.

Something is affixed to the wall by the top left bunk.

>x locker
The locker features a traditional keyhole and a card slot.

>slide access card through slot
A light on the locker flashes red.

>i
You are carrying:
  a strange device
  a steel key
  an extendable dusting device
  a hand-held micro-compressing vacuum cleaner
  a wallet (closed)
  a sonic decontaminator
  a maintenance crew access card
  a military sanitation uniform (being worn)

>open wallet
You open the wallet, revealing a military ID card.

>take id card
Taken.

>slide id through slot
A green light by the lock starts flashing insistently.

>unlock locker with key
You unlock the port-side equipment locker.

You open the port-side equipment locker, revealing a vac suit.

>take vac suit
You can't carry that much weight.

>s
Crew Quarters
This is a busy junction when the ship is populated. To port and starboard are the crew bunks, aft is the door to the captain's quarters, and fore is the galley. A ladder leads down to the aft airlock.

>s
Starboard-Side Bunks
All crew members who aren't the captain sleep in this or the opposite-side bunk room. This one sleeps four in two sets of bunks, one on the left and one on the right, all done up with military precision. There is a large locker here, stretching almost to the ceiling. It is closed. The sole exit is to port.

A copy of Stars Magazine is just peeking from underneath the left bottom bunk.

⇒ You can ask for hints at any time by typing "hints".

>slide id through slot
A green light by the lock starts flashing insistently.

>unlock locker with key
You unlock the starboard-side equipment locker.

You open the starboard-side equipment locker, revealing a beacon.

>take beacon
Taken.

>x it
A device for broadcasting the location of an object in space.

>take magazine
[Not my kind of reading, actually, but what the heck.]Taken.

>read it
The cover features a picture of a Space Marine spacewalking in a vac suit. You page through the inside, but it's all in a language you don't recognize.

>get on top right bunk
You get onto the right top bunk.

From this height you can see something that looks like a yellow ID card on top of the equipment locker.

[Must have flown up there when everything went ka-blooey.]

>take yellow id
You can't reach the yellow ID card from here.

>x duster
The duster is a short device which extends to be a long one, sporting a cylindrical halo of electrostatic material at its end.

>dust locker
The bunks are just a little too far away from the locker.

>dust yellow id
The bunks are just a little too far away from the locker.

>p
(first getting off the right top bunk)

Crew Quarters
This is a busy junction when the ship is populated. To port and starboard are the crew bunks, aft is the door to the captain's quarters, and fore is the galley. A ladder leads down to the aft airlock.

>p
Port-Side Bunks
All crew members who aren't the captain sleep in this or the opposite-side bunk room. This one sleeps four in two sets of bunks, one on the left and one on the right, all done up with military precision. There is a large locker here, stretching almost to the ceiling. It is open and contains a vac suit. The sole exit is to starboard.

Something is affixed to the wall by the top left bunk.

>look under left bottom bunk
You find nothing of interest.

>look under right bottom bunk
You find a black trunk and move it out from under the right bottom bunk.

Port-Side Bunks
All crew members who aren't the captain sleep in this or the opposite-side bunk room. This one sleeps four in two sets of bunks, one on the left and one on the right, all done up with military precision. There is a large locker here, stretching almost to the ceiling. It is open and contains a vac suit. The sole exit is to starboard.

Something is affixed to the wall by the top left bunk.

You can see a black trunk (closed) here.

>take trunk
Taken.

>s
Crew Quarters
This is a busy junction when the ship is populated. To port and starboard are the crew bunks, aft is the door to the captain's quarters, and fore is the galley. A ladder leads down to the aft airlock.

>s
Starboard-Side Bunks
All crew members who aren't the captain sleep in this or the opposite-side bunk room. This one sleeps four in two sets of bunks, one on the left and one on the right, all done up with military precision. There is a large locker here, stretching almost to the ceiling. It is open and empty. The sole exit is to port.

>drop trunk
Dropped.

>stand on trunk
You get onto the black trunk.

From this height you can see something that looks like a yellow ID card on top of the equipment locker.

>dust yellow id
You extend the extendable dusting device and push the yellow ID card off of the starboard-side equipment locker. It lands on the floor.

>get yello id
You can't see any such thing.

>get yellow id
You can't see any such thing.

>get off
You get off the black trunk.

Starboard-Side Bunks
All crew members who aren't the captain sleep in this or the opposite-side bunk room. This one sleeps four in two sets of bunks, one on the left and one on the right, all done up with military precision. There is a large locker here, stretching almost to the ceiling. It is open and empty. The sole exit is to port.

What you thought was an ID card lies on the floor. Now that you're closer to it, though, you can see the words "Engineering Access Card" written on it.

You can also see a black trunk (closed) here.

>get card
(the Engineering Access Card)
Taken.

>x strange device
The strange device is an 8" x 11" rectangle about three inches thick. The top is largely taken up by a screen, except for two buttons, left and right. There is a thin slot on the close side, with a small button next to it.

>insert magazine into strange device
You insert the copy of Stars Magazine into the strange device, and the screen lights up. It looks like the copy of Stars Magazine, only translated into Standard Galactic.

The cover of Stars Magazine teases an issue full of Space Authority news exclusives, celebrity gossip, and useful space safety tips. It features a picture of a Space Marine spacewalking in a vac suit.

The galactic translator boasts a left button, a right button, and a small button next to a thin slot.

>press right button
The galactic translator flips forward a page.

Page 1 of Stars Magazine is a discussion of the political status of the separatist movement on Deneb IV. Booring.

The galactic translator boasts a left button, a right button, and a small button next to a thin slot.

>press right button
The galactic translator flips forward a page.

Page 2 of Stars Magazine follows the career of pop star Piscea Lycana. Not what you need to know about right now.

The galactic translator boasts a left button, a right button, and a small button next to a thin slot.

>g
The galactic translator flips forward a page.

Page 3 of Stars Magazine compares several models of personal ground-to-orbit vehicles. If only they'd come down in price...

The galactic translator boasts a left button, a right button, and a small button next to a thin slot.

>g
The galactic translator flips forward a page.

Page 4 of Stars Magazine is the astrology section. Apparently this month you will face an unanticipated challenge.

The galactic translator boasts a left button, a right button, and a small button next to a thin slot.

>g
The galactic translator flips forward a page.

Page 5 doesn't contain much of interest, just gossip and the occasional lifestyle piece.

The galactic translator boasts a left button, a right button, and a small button next to a thin slot.

>g
The galactic translator flips forward a page.

Page 6 of Stars Magazine is a tutorial in vac suit operation for the non-technical. It details all kinds of important aspects of the suit, including:

* How to take the suit on and off.
 * How to activate the suit: "Suit, activation code <code>"
 * The automatic pressurization system.
 * How to operate the mag boots: "Suit, mag boots on", "Suit, mag boots off".
 * Keeping an eye on the oxygen level: "Suit, report oxygen level".
 * Monitoring suit status: "Suit, report status".
 * How to look good while wearing the vac suit.

The article strongly emphasizes that a typical vac suit does not contain a propulsion system, so care must be taken not to be spun off into deep space.

Someone has scribbled 1 in the margin of the page.

The galactic translator boasts a left button, a right button, and a small button next to a thin slot.

>p
Crew Quarters
This is a busy junction when the ship is populated. To port and starboard are the crew bunks, aft is the door to the captain's quarters, and fore is the galley. A ladder leads down to the aft airlock.

>p
Port-Side Bunks
All crew members who aren't the captain sleep in this or the opposite-side bunk room. This one sleeps four in two sets of bunks, one on the left and one on the right, all done up with military precision. There is a large locker here, stretching almost to the ceiling. It is open and contains a vac suit. The sole exit is to starboard.

Something is affixed to the wall by the top left bunk.

>take vac suit
You can't carry that much weight.

>drop all
Engineering Access Card: Dropped.
beacon: Dropped.
military ID card: Dropped.
galactic translator: Dropped.
steel key: Dropped.
extendable dusting device: Dropped.
hand-held micro-compressing vacuum cleaner: Dropped.
wallet: Dropped.
sonic decontaminator: Dropped.
maintenance crew access card: Dropped.

>take vac suit
You can't carry that much weight.

>drop uniform
(first taking the military sanitation uniform off)
Dropped.

>take vac suit
Taken.

>wear it
You put on the vac suit.

>take wallet
Taken.

>suit, report status
"Suit deactivated."

>activate suit
BOOM activated.

>suit, report status
"Suit activated. Mag boots deactivated. Oxygen level at 15 units."

>gonear data terminal
Captain's Quarters
Neat and spartan, this cabin is the very model of a small fighting ship's captain's quarters. An impeccably organized desk is against one wall, while a typically spotless bed sits beneath a portrait of this very ship. There is a data terminal on the desk. Against a third wall is the captain's one indulgence: a set of free weights neatly put away in racks. You can exit to fore.

You can see a 9kg weight, a 15kg weight, a 29kg weight, a 32kg weight and a 50kg weight here.

The desk drawer is open and empty.

>computer, access code 3
"Welcome, Captain Jane Mulgrew. Logging you in."
The data terminal displays the logo of the space marines.

>computer, access code 2
"Welcome, caller. Logging you in."
The data terminal displays the logo of the space marines.

>computer, reboot
The ship's computer announces, "Beginning reboot. Take all appropriate precautions."

Red alert lights flash throughout the ship.

>f
The Captain's door opens as you approach, and closes silently behind you.

Crew Quarters
This is a busy junction when the ship is populated. To port and starboard are the crew bunks, aft is the door to the captain's quarters, and fore is the galley. A ladder leads down to the aft airlock.

>f
The Galley
This narrow space is barely enough room for two Marines to prepare and eat a meal. There is a counter with two stools, a microwave oven, and a large closet here. Pots and pans hang from hooks in the ceiling. A ladder leads up through the fore/aft door, and you can leave aft.

On the starboard wall is a panel on which is a blue button. Tacked to the panel is the operator's manual for the fore/aft door.

You hear someone speaking above.

>u
(first opening the Fore/Aft Door)
You can't open that with your bare hands.

>push button
A loud buzzer sounds and a red light flashes on the door, which stays resolutely shut.

You hear someone speaking above.

>gonear communications
Operations
This is where all of the support activity for the bridge occurs. There are large consoles for environmental controls, communications, and power systems here. The bridge continues forward from here, and engineering is aft. There is a door set in the floor with a ladder leading through it. Set in the frame of the door is a blue button.

A large equipment trunk lies on the Fore/Aft door, blocking it.

>hello
(addressing the caller)
"You're back! Great job rebooting the computer -- I'm getting telemetry now.

"I'm trying to divert the ship from its collision course with New Da Nang, but there are some problems: the helm is not responding to any commands, there is some physical issue with the starboard engine and the fuel injection specification for the main engine is incorrect."

>* stop doing that
Noted.

* * *

Would you like to use accessibility features like no ASCII art? (enter "y" for yes)

>g
Space Station Gangway
This is the pressurized bridge from Space Station Omicron-5 to the SS Usagi. Behind you the safety of home, before you the promise of adventure... cleaning up after space marines. Such is the lot of the 95th Sanitation Division. Not what you dreamed of when you enlisted.

As is usual, the crew is all off the ship while you board to clean it. You usually have a partner, but today Private "Chubby" Franks has the flu, so it's your job alone.

To the fore is the aft airlock of the Usagi, beckoning you in.

[Better get a move on, I guess], you think.

⇒ For help with testing, enter "help test".

⇒ Tip: Type "help" to learn about this game, and interactive fiction in general.

>gonear desk
(the desk drawer)
Captain's Quarters
Neat and spartan, this cabin is the very model of a small fighting ship's captain's quarters. An impeccably organized desk is against one wall, while a typically spotless bed sits beneath a portrait of this very ship. There is a data terminal on the desk. Against a third wall is the captain's one indulgence: a set of free weights neatly put away in racks. You can exit to fore.

You can see a 9kg weight, a 15kg weight, a 29kg weight, a 32kg weight, and a 50kg weight here.

⇒ You may talk to the ship computer through the data terminal. You might try "computer, help" to get help on talking to the computer.

>purloin vac suit
[Purloined.]

>activate suit
BOOM activated.

>suit, report
"Suit activated. Mag boots deactivated. Oxygen level at 15 units."

>suit, status
"Suit activated. Mag boots deactivated. Oxygen level at 15 units."

>suit, status report
"Suit activated. Mag boots deactivated. Oxygen level at 15 units."

>suit, report status
"Suit activated. Mag boots deactivated. Oxygen level at 15 units."

>suit, report oxygen level
The vac suit only has a limited number of commands it understands. That's not one of them.

* * *

Would you like to use accessibility features like no ASCII art? (enter "y" for yes)

>go
Space Station Gangway
This is the pressurized bridge from Space Station Omicron-5 to the SS Usagi. Behind you the safety of home, before you the promise of adventure... cleaning up after Space Marines. Such is the lot of the 95th Sanitation Division. Not what you dreamed of when you enlisted.

As is usual, the crew is all off the ship while you board to clean it. You usually have a partner, but today Pvt "Chubby" Franks has the flu, so it's your job alone.

To the fore is the aft airlock of the Usagi, beckoning you in.

[Better get a move on, I guess], you think.

⇒ For help with testing, enter "help test".

⇒ Tip: Type "help" to learn about this game, and interactive fiction in general.

>gonear microwave
The Galley
This narrow space is barely enough room for two Marines to prepare and eat a meal. There is a counter with two stools, a microwave oven, and a large closet here. Pots and pans hang from hooks in the ceiling. A ladder leads up through the fore/aft door, and you can leave aft.

On the starboard wall is a panel on which is a blue button. Tacked to the panel is the operator's manual for the fore/aft door.

>turn it on
It isn't something you can switch.

>open it
You open the microwave oven.

You faintly hear someone speaking above.

>l
The Galley
This narrow space is barely enough room for two Marines to prepare and eat a meal. There is a counter with two stools, a microwave oven, and a large closet here. Pots and pans hang from hooks in the ceiling. A ladder leads up through the fore/aft door, and you can leave aft.

On the starboard wall is a panel on which is a blue button. Tacked to the panel is the operator's manual for the fore/aft door.

>x microwave
You're supposed to be cleaning this microwave, but here you are.

You faintly hear someone speaking above.

* * *

Would you like to use accessibility features like no ASCII art? (enter "y" for yes)

>gone
Space Station Gangway
This is the pressurized bridge from Space Station Omicron-5 to the SS Usagi. Behind you the safety of home, before you the promise of adventure... cleaning up after Space Marines. Such is the lot of the 95th Sanitation Division. Not what you dreamed of when you enlisted.

As is usual, the crew is all off the ship while you board to clean it. You usually have a partner, but today Pvt "Chubby" Franks has the flu, so it's your job alone.

To the fore is the aft airlock of the Usagi, beckoning you in.

[Better get a move on, I guess], you think.

⇒ For help with testing, enter "help test".

⇒ Tip: Type "help" to learn about this game, and interactive fiction in general.

>gonear desk
(the desk drawer)
Captain's Quarters
Neat and spartan, this cabin is the very model of a small fighting ship's captain's quarters. An impeccably organized desk is against one wall, while a typically spotless bed sits beneath a portrait of this very ship. There is a data terminal on the desk. Against a third wall is the captain's one indulgence: a set of free weights neatly put away in racks. You can exit to fore.

You can see a 9kg weight, a 15kg weight, a 29kg weight, a 32kg weight, and a 50kg weight here.

⇒ You may talk to the ship computer through the data terminal. You might try "computer, help" to get help on talking to the computer.

>purloin suit
Which do you mean, the suit recharging station or the vac suit?

>vac
[Purloined.]

>wear it
(first removing the military sanitation uniform)
You put on the vac suit.

>activate vac suit
I didn't understand that sentence.

>activate suit
BOOM activated.

>suit, help
The following commands are available: 

 - suit, activation code <code> - suit, mag boots on - suit, mag boots off - suit, report status 
[That command asks to do something outside of play, so it can only make sense from you to me. The vac suit cannot be asked to do this.]

* * *

Would you like to use accessibility features like no ASCII art? (enter "y" for yes)

>gonear
Space Station Gangway
This is the pressurized bridge from Space Station Omicron-5 to the SS Usagi. Behind you the safety of home, before you the promise of adventure... cleaning up after Space Marines. Such is the lot of the 95th Sanitation Division. Not what you dreamed of when you enlisted.

As is usual, the crew is all off the ship while you board to clean it. You usually have a partner, but today Pvt "Chubby" Franks has the flu, so it's your job alone.

To the fore is the aft airlock of the Usagi, beckoning you in.

[Better get a move on, I guess], you think.

⇒ For help with testing, enter "help test".

⇒ Tip: Type "help" to learn about this game, and interactive fiction in general.

>gonear desk
(the desk drawer)
Captain's Quarters
Neat and spartan, this cabin is the very model of a small fighting ship's captain's quarters. An impeccably organized desk is against one wall, while a typically spotless bed sits beneath a portrait of this very ship. There is a data terminal on the desk. Against a third wall is the captain's one indulgence: a set of free weights neatly put away in racks. You can exit to fore.

You can see a 9kg weight, a 15kg weight, a 29kg weight, a 32kg weight, and a 50kg weight here.

⇒ You may talk to the ship computer through the data terminal. You might try "computer, help" to get help on talking to the computer.

>purloin magazine
[Purloined.]

>purloin translator
[Purloined.]

>put magazine in gadget
You insert the copy of Stars Magazine into the strange gadget, and the screen lights up. It looks like the copy of Stars Magazine, only translated into Standard Galactic.

The cover of Stars Magazine teases an issue full of Space Authority news exclusives, celebrity gossip, and useful space safety tips. It features a picture of a Space Marine spacewalking in a vac suit.

The galactic translator boasts a left button, a right button, and a small button next to a thin slot.

>press right button
The galactic translator flips forward a page.

Page 1 of Stars Magazine is a discussion of the political status of the separatist movement on Deneb IV. Booring.

The galactic translator boasts a left button, a right button, and a small button next to a thin slot.

* * *

>press right button
The galactic translator flips forward a page.

Page 2 of Stars Magazine follows the career of pop star Piscea Lycana. Not what you need to know about right now.

The galactic translator boasts a left button, a right button, and a small button next to a thin slot.

>press right button
The galactic translator flips forward a page.

Page 3 of Stars Magazine compares several models of personal ground-to-orbit vehicles. If only they'd come down in price...

The galactic translator boasts a left button, a right button, and a small button next to a thin slot.

>press right button
The galactic translator flips forward a page.

Page 4 of Stars Magazine is the astrology section. Apparently this month you will face an unanticipated challenge.

The galactic translator boasts a left button, a right button, and a small button next to a thin slot.

>press right button
The galactic translator flips forward a page.

Page 5 doesn't contain much of interest, just gossip and the occasional lifestyle piece.

The galactic translator boasts a left button, a right button, and a small button next to a thin slot.

>press right button
The galactic translator flips forward a page.

Page 6 of Stars Magazine is a tutorial in vac suit operation for the non-technical. It details all kinds of important aspects of the suit, including: 

 - How to take the suit on and off.
 - How to activate the suit: "Suit, activation code <code>"
 - The automatic pressurization system.
 - How to operate the mag boots: "Suit, mag boots on", "Suit, mag boots off".
 - Keeping an eye on the oxygen level: "Suit, report oxygen level".
 - Monitoring suit status: "Suit, report status".
 - How to look good while wearing the vac suit.

The article strongly emphasizes that a typical vac suit does not contain a propulsion system, so care must be taken not to be spun off into deep space.

Someone has scribbled 1 in the margin of the page.

The galactic translator boasts a left button, a right button, and a small button next to a thin slot.

>purloin vac suit
[Purloined.]

>wear it
(first removing the military sanitation uniform)
You put on the vac suit.

>suit, help
[That command asks to do something outside of play, so it can only make sense from you to me. The vac suit cannot be asked to do this.]

* * *

Would you like to use accessibility features like no ASCII art? (enter "y" for yes)

>gonear engineering airlock chamber
Engineering Airlock Chamber
You are in the Engineering airlock chamber. You're one door away from the great void of space. Both doors are closed; you'll have to open one to leave the airlock.

On your right is a control panel for the airlock. It consists of a green button to pressurize the airlock chamber, a yellow button to depressurize it, a red button to open and close the inner airlock door, and a blue button to open and close the outer airlock door.

The engineering airlock inner door is closed.

The engineering airlock outer door is closed.

>out
(first opening the engineering airlock outer door)
You cannot just open the engineering airlock outer door with your bare hands.

>purloin vac suit
[Purloined.]

* * *

>wear it
(first removing the military sanitation uniform)
You put on the vac suit.

>activate suit
BOOM activated.

>out
You take a step on the hull of the ship, and keep going, and going... Should have turned those mag boots on.

    *** You float forever in the vastness of space ***

Would you like to RESTART, RESTORE a saved game, QUIT, or UNDO the last command?

>undo
Engineering Airlock Chamber
[Previous turn undone.]

>l
Engineering Airlock Chamber
You are in the Engineering airlock chamber. You're one door away from the great void of space. Both doors are closed; you'll have to open one to leave the airlock.

On your right is a control panel for the airlock. It consists of a green button to pressurize the airlock chamber, a yellow button to depressurize it, a red button to open and close the inner airlock door, and a blue button to open and close the outer airlock door.

The engineering airlock inner door is closed.

The engineering airlock outer door is closed.

>rules
Rules tracing now switched on. Type "rules off" to switch it off again, or "rules all" to include even rules which do not apply.

>out
[Rule "redirect to GEP line input rule" applies.]
[Rule "After reading a command" applies.]
[Rule "declare everything initially unmentioned rule" applies.]
[Rule "Setting action variables for exiting" applies.]
[Rule "announce items from multiple object lists rule" applies.]
[Rule "set pronouns from items from multiple object lists rule" applies.]
[Rule "before stage rule" applies.]
[Rule "instead stage rule" applies.]
[Rule "investigate player's awareness before action rule" applies.]
[Rule "player aware of his own actions rule" applies.]
[Rule "check stage rule" applies.]
[Rule "convert exit into go out rule" applies.]
[Rule "standard set going variables rule" applies.]
[Rule "announce items from multiple object lists rule" applies.]
[Rule "set pronouns from items from multiple object lists rule" applies.]
[Rule "before stage rule" applies.]
[Rule "instead stage rule" applies.]
[Rule "Instead of going from a room ( called R ) to a room ( called R2 ) when player is wearing vac suit and the vac suit is not mag boots activated and R is offboard or R2 is offboard" applies.]
You take a step on the hull of the ship, and keep going, and going... Should have turned those mag boots on.

[Rule "when play ends stage rule" applies.]
[Rule "print player's obituary rule" applies.]

    *** You float forever in the vastness of space ***

[Rule "print the final question rule" applies.]
Would you like to RESTART, RESTORE a saved game, QUIT, or UNDO the last command?
[Rule "print the final prompt rule" applies.]

>undo
[Rule "redirect to GEP line input rule" applies.]
[Rule "standard respond to final question rule" applies.]
Engineering Airlock Chamber
[Previous turn undone.]

>rules off
[Rule "redirect to GEP line input rule" applies.]
[Rule "After reading a command" applies.]
[Rule "declare everything initially unmentioned rule" applies.]
Rules tracing now switched off. Type "rules" to switch it on again.

>go outside
You take a step on the hull of the ship, and keep going, and going... Should have turned those mag boots on.

    *** You float forever in the vastness of space ***

Would you like to RESTART, RESTORE a saved game, QUIT, or UNDO the last command?

>undo
Engineering Airlock Chamber
[Previous turn undone.]

>showme
Engineering Airlock Chamber - airlock-chamber
    engineering airlock inner door - inner airlock door
    yourself - person
        vac suit (worn)
        maintenance crew access card - access card
        sonic decontaminator
        hand-held micro-compressing vacuum cleaner
        extendable dusting device
        military sanitation uniform
    engineering airlock outer door - outer airlock door
    red button - inner-door-opener-button
    blue button - outer-door-opener-button
    green button - airlock-pressurize-button
    yellow button - airlock-depressurize-button

>showme outer door
(the engineering airlock outer door)
engineering airlock outer door - outer airlock door
location: in the Engineering Airlock Chamber
singular-named, improper-named; unlit, inedible, fixed in place, seen, familiar; closed, unopenable, unlocked
list grouping key: none
printed name: "engineering airlock outer door"
printed plural name: "outer airlock doors"
indefinite article: none
description: "This is the door between the airlock chamber and the rest of the ship. It is colored white with red warning symbols on it."
initial appearance: none
bulk: 1
dark description: none
help text: none
price: $0
page count: 0
mass: 0.0
last utterance: none
voice locale: yourself
other side: Outside the Engineering Airlock (vacuum)
chamber: Aft Airlock Chamber

>out
You take a step on the hull of the ship, and keep going, and going... Should have turned those mag boots on.

    *** You float forever in the vastness of space ***

Would you like to RESTART, RESTORE a saved game, QUIT, or UNDO the last command?

* * *

Would you like to use accessibility features like no ASCII art? (enter "y" for yes)

>gonear galley
Space Station Gangway
This is the pressurized bridge from Space Station Omicron-5 to the SS Usagi. Behind you the safety of home, before you the promise of adventure... cleaning up after space marines. Such is the lot of the 95th Sanitation Division. Not what you dreamed of when you enlisted.

As is usual, the crew is all off the ship while you board to clean it. You usually have a partner, but today Private "Chubby" Franks has the flu, so it's your job alone.

To the fore is the aft airlock of the Usagi, beckoning you in.

[Better get a move on, I guess], you think.

⇒ For help with testing, enter "help test".

⇒ Tip: Type "help" to learn about this game, and interactive fiction in general.

>x ceiling
You really don't need to worry about the ceiling.

>take pot
You can't see any such thing.

>take pan
You can't see any such thing.

>gonear galley
(The Galley)
The Galley
This narrow space is barely enough room for two Marines to prepare and eat a meal. There is a counter with two stools, a microwave oven, and a large closet here. Pots and pans hang from hooks in the ceiling. A ladder leads up through the fore/aft door, and you can leave aft.

On the starboard wall is a panel on which is a blue button. Tacked to the panel is the operator's manual for the fore/aft door.

>x ceiling
You really don't need to worry about the ceiling.

You faintly hear someone speaking above.

>take pot
Taken.

Apparently one of the hooks is loose. You jostle it while taking the skillet, and it falls out of the ceiling to the floor.

>x ceiling
(the ceiling hook)
The ceiling hook has a very long, pointy screw end.

You faintly hear someone speaking above.

>x galley ceiling
There's a little hole in the ceiling where a ceiling hook used to be.

>get on left top bunk
You can't see any such thing.

>l
The Galley
This narrow space is barely enough room for two Marines to prepare and eat a meal. There is a counter with two stools, a microwave oven, and a large closet here. Pots and pans hang from hooks in the ceiling. A ladder leads up through the fore/aft door, and you can leave aft.

On the starboard wall is a panel on which is a blue button. Tacked to the panel is the operator's manual for the fore/aft door.

A ceiling hook lies on the floor here.

You faintly hear someone speaking above.

>a
Crew Quarters
This is a busy junction when the ship is populated. To port and starboard are the crew bunks, aft is the door to the captain's quarters, and fore is the galley. A ladder leads down to the aft airlock.

⇒ You can ask for hints at any time by typing "hints".

BOOM -- suddenly everything goes to hell. A bulkhead seems to hurtle towards you...
pain...
confusion...
blackness...
Somehow you're okay. Inertial dampers must have kicked in. Nevertheless, you feel like you were hit by a truck.
But what happened?

Crash
An Interactive Fiction by Phil Riley
Release 4 / Serial number 220621 / Inform 7 build 6M62 (I6/v6.34 lib 6/12N) SD

[Where am I?]

>z
[What? Didn't get that. My brain is spinning too much. Try again.]

* * *

>exit
You get off the right bottom bunk.

Port-Side Bunks
All crew members who aren't the captain sleep in this or the opposite-side bunk room. This one sleeps four in two sets of bunks, one on the left and one on the right, all done up with military precision. There is a large locker here, stretching almost to the ceiling. It is closed. The sole exit is to starboard.

Something is affixed to the wall by the top left bunk.

A leather wallet lies discarded on the ground.

On the right bottom bunk is a hand-held micro-compressing vacuum cleaner.

On the right top bunk is an extendable dusting device.

You can also see a sonic decontaminator here.

[Standing up makes me a little dizzy, oh my.]

[Okay now, back to the station -- let's see, I'm in Port-Side Bunks, so I need to go starboard and then down...]

>get on left top bunk
Someone has taped a family photo to the wall here.

>l
Port-Side Bunks (on the left top bunk)
All crew members who aren't the captain sleep in this or the opposite-side bunk room. This one sleeps four in two sets of bunks, one on the left and one on the right, all done up with military precision. There is a large locker here, stretching almost to the ceiling. It is closed. The sole exit is to starboard.

Someone has taped a family photo to the wall here.

A leather wallet lies discarded on the ground.

On the right bottom bunk is a hand-held micro-compressing vacuum cleaner.

On the right top bunk is an extendable dusting device.

You can also see a sonic decontaminator here.

>x photo
Three children, a mother and father, and an old grandfather, under the glare of what you'd guess is Pollux.

>look behind photo
You can't see any such thing.

>get off
You get off the left top bunk.

Port-Side Bunks
All crew members who aren't the captain sleep in this or the opposite-side bunk room. This one sleeps four in two sets of bunks, one on the left and one on the right, all done up with military precision. There is a large locker here, stretching almost to the ceiling. It is closed. The sole exit is to starboard.

A family photo is taped to the wall by the top left bunk.

A leather wallet lies discarded on the ground.

On the right bottom bunk is a hand-held micro-compressing vacuum cleaner.

On the right top bunk is an extendable dusting device.

You can also see a sonic decontaminator here.

>x phoyo
You can't see any such thing.

>x photo
It's too far away to make out properly.

>get on left top bunk
You get onto the left top bunk.

>x photo
Three children, a mother and father, and an old grandfather, under the glare of what you'd guess is Pollux.

>get off bunk
(the left top bunk)
You get off the left top bunk.

Port-Side Bunks
All crew members who aren't the captain sleep in this or the opposite-side bunk room. This one sleeps four in two sets of bunks, one on the left and one on the right, all done up with military precision. There is a large locker here, stretching almost to the ceiling. It is closed. The sole exit is to starboard.

A family photo is taped to the wall by the top left bunk.

A leather wallet lies discarded on the ground.

On the right bottom bunk is a hand-held micro-compressing vacuum cleaner.

On the right top bunk is an extendable dusting device.

You can also see a sonic decontaminator here.

* * *

Would you like to use accessibility features like no ASCII art? (enter "y" for yes)

>gonear onepass
Space Station Gangway
This is the pressurized bridge from Space Station Omicron-5 to the SS Usagi. Behind you the safety of home, before you the promise of adventure... cleaning up after space marines. Such is the lot of the 95th Sanitation Division. Not what you dreamed of when you enlisted.

As is usual, the crew is all off the ship while you board to clean it. You usually have a partner, but today Private "Chubby" Franks has the flu, so it's your job alone.

To the fore is the aft airlock of the Usagi, beckoning you in.

[Better get a move on, I guess], you think.

⇒ For help with testing, enter "help test".

⇒ Tip: Type "help" to learn about this game, and interactive fiction in general.

>gonear onepass
Starboard-Side Bunks
All crew members who aren't the captain sleep in this or the opposite-side bunk room. This one sleeps four in two sets of bunks, one on the left and one on the right, all done up with military precision. There is a large locker here, stretching almost to the ceiling. It is closed. The sole exit is to port.

On the left bottom bunk is an OnePass.

A copy of Stars Magazine is just peeking from underneath the left bottom bunk.

>take onepass
Taken.

>x it
[These things are great. You just put all access cards in it, and then use it as a card instead.]

* * *

Would you like to use accessibility features like no ASCII art? (enter "y" for yes)

>gonear terminal
Captain's Quarters
Neat and spartan, this cabin is the very model of a small fighting ship's captain's quarters. An impeccably organized desk is against one wall, while a typically spotless bed sits beneath a portrait of this very ship. There is a data terminal on the desk. Against a third wall is the captain's one indulgence: a set of free weights neatly put away in racks. You can exit to fore.

You can see a 9kg weight, a 15kg weight, a 29kg weight, a 32kg weight, and a 50kg weight here.

⇒ You may talk to the ship computer through the data terminal. You might try "computer, help" to get help on talking to the computer.

>hints
Some players may find the temptation to rely on hints overwhelming, and you may prefer to remove temptation by disabling hints for the rest of this game. If you do so, however, you will not be able to access the hints unless you restart. Do you wish to disable hints? >

>no
Okay - but if you change your mind later you can use the HINTS OFF command to disable hints.

Sorry, no hints are available at this time.

* * *

>hints
Captain's Quarters
Neat and spartan, this cabin is the very model of a small fighting ship's captain's quarters. An impeccably organized desk is against one wall, while a typically spotless bed sits beneath a portrait of this very ship. There is a data terminal on the desk. Against a third wall is the captain's one indulgence: a set of free weights neatly put away in racks. You can exit to fore.

You can see a 9kg weight, a 15kg weight, a 29kg weight, a 32kg weight, and a 50kg weight here.

>rebooted
Captain's Quarters
Neat and spartan, this cabin is the very model of a small fighting ship's captain's quarters. An impeccably organized desk is against one wall, while a typically spotless bed sits beneath a portrait of this very ship. There is a data terminal on the desk. Against a third wall is the captain's one indulgence: a set of free weights neatly put away in racks. You can exit to fore.

You can see a 9kg weight, a 15kg weight, a 29kg weight, a 32kg weight, and a 50kg weight here.

>f
The Captain's door opens as you approach, and closes silently behind you.

Crew Quarters
This is a busy junction when the ship is populated. To port and starboard are the crew bunks, aft is the door to the captain's quarters, and fore is the galley. A ladder leads down to the aft airlock.

* * *

>f
The Galley
This narrow space is barely enough room for two Marines to prepare and eat a meal. There is a counter with two stools, a microwave oven, and a large closet here. Pots and pans hang from hooks in the ceiling. A ladder leads up through the fore/aft door, and you can leave aft.

On the starboard wall is a panel on which is a blue button. Tacked to the panel is the operator's manual for the fore/aft door.

>u
Operations
This is where all of the support activity for the bridge occurs. There are large consoles for environmental controls, communications, and power systems here. The bridge continues forward from here, and engineering is aft. There is a door set in the floor with a ladder leading through it. Set in the frame of the door is a blue button.

A large equipment trunk lies on the Fore/Aft door, blocking it.

You can also see an extendable dusting device, a hand-held micro-compressing vacuum cleaner, a sonic decontaminator, and a maintenance crew access card here.

Master Sergeant R. Mu Arvax: "You there, Usagi? We don't have much time."

>hello
(addressing Master Sergeant R. Mu Arvax)
"You're back! Great job rebooting the computer -- I'm getting telemetry now.

"I'm trying to divert the ship from its collision course with New Da Nang, but there are some problems: the helm is not responding to any commands, there is some physical issue with the starboard engine, and the fuel injection specification for the main engine is incorrect."

>d
The Galley
This narrow space is barely enough room for two Marines to prepare and eat a meal. There is a counter with two stools, a microwave oven, and a large closet here. Pots and pans hang from hooks in the ceiling. A ladder leads up through the fore/aft door, and you can leave aft.

On the starboard wall is a panel on which is a blue button. Tacked to the panel is the operator's manual for the fore/aft door.

>a
Crew Quarters
This is a busy junction when the ship is populated. To port and starboard are the crew bunks, aft is the door to the captain's quarters, and fore is the galley. A ladder leads down to the aft airlock.

>p
Port-Side Bunks
All crew members who aren't the captain sleep in this or the opposite-side bunk room. This one sleeps four in two sets of bunks, one on the left and one on the right, all done up with military precision. There is a large locker here, stretching almost to the ceiling. It is closed. The sole exit is to starboard.

Something is affixed to the wall by the top left bunk.

A leather wallet lies on the left bottom bunk.

[Okay now, back to the station -- let's see, I'm in Port-Side Bunks, so I need to go starboard and then down...]

>look under right bottom
You find a black trunk and move it out from under the right bottom bunk.

Port-Side Bunks
All crew members who aren't the captain sleep in this or the opposite-side bunk room. This one sleeps four in two sets of bunks, one on the left and one on the right, all done up with military precision. There is a large locker here, stretching almost to the ceiling. It is closed. The sole exit is to starboard.

Something is affixed to the wall by the top left bunk.

A leather wallet lies on the left bottom bunk.

You can see a black trunk (closed) here.

>take trunk
You can't carry that much weight.

>i
You are carrying:
  a vac suit (being worn)
  a military sanitation uniform (being worn)

>drop uniform
(first taking the military sanitation uniform off)
Dropped.

>take trunk
You can't carry that much weight.

>drop vac suit
(first taking the vac suit off)
Dropped.

>take trunk
Taken.

* * *

>s
Starboard-Side Bunks
All crew members who aren't the captain sleep in this or the opposite-side bunk room. This one sleeps four in two sets of bunks, one on the left and one on the right, all done up with military precision. There is a large locker here, stretching almost to the ceiling. It is closed. The sole exit is to port.

A copy of Stars Magazine is just peeking from underneath the left bottom bunk.

⇒ You can ask for hints at any time by typing "hints".

>drop trunk
Dropped.

* * *

>stand on trunk
You get onto the black trunk.

From this height you can see something that looks like a yellow ID card on top of the equipment locker.

>get off
You get off the black trunk.

Starboard-Side Bunks
All crew members who aren't the captain sleep in this or the opposite-side bunk room. This one sleeps four in two sets of bunks, one on the left and one on the right, all done up with military precision. There is a large locker here, stretching almost to the ceiling. It is closed. The sole exit is to port.

A copy of Stars Magazine is just peeking from underneath the left bottom bunk.

You can also see a black trunk (closed) here.

* * *

Would you like to use accessibility features like no ASCII art? (enter "y" for yes)

>gonearn
Space Station Gangway
This is the pressurized bridge from Space Station Omicron-5 to the SS Usagi. Behind you the safety of home, before you the promise of adventure... cleaning up after Space Marines. Such is the lot of the 95th Sanitation Division. Not what you dreamed of when you enlisted.

As is usual, the crew is all off the ship while you board to clean it. You usually have a partner, but today Pvt "Chubby" Franks has the flu, so it's your job alone.

To the fore is the aft airlock of the Usagi, beckoning you in.

[Better get a move on, I guess], you think.

⇒ For help with testing, enter "help test".

⇒ Tip: Type "help" to learn about this game, and interactive fiction in general.

>gonear galley
The Galley
This narrow space is barely enough room for two Marines to prepare and eat a meal. There is a counter with two stools, a microwave oven, and a large closet here. Pots and pans hang from hooks in the ceiling. A ladder leads up through the fore/aft door, and you can leave aft.

On the starboard wall is a panel on which is a blue button. Tacked to the panel is the operator's manual for the fore/aft door.

>z
Time passes.

>z
Time passes.

You hear someone speaking faintly above.

* * *

Would you like to use accessibility features like no ASCII art? (enter "y" for yes)

>gonn
Space Station Gangway
This is the pressurized bridge from Space Station Omicron-5 to the SS Usagi. Behind you the safety of home, before you the promise of adventure... cleaning up after Space Marines. Such is the lot of the 95th Sanitation Division. Not what you dreamed of when you enlisted.

As is usual, the crew is all off the ship while you board to clean it. You usually have a partner, but today Pvt "Chubby" Franks has the flu, so it's your job alone.

To the fore is the aft airlock of the Usagi, beckoning you in.

[Better get a move on, I guess], you think.

⇒ For help with testing, enter "help test".

⇒ Tip: Type "help" to learn about this game, and interactive fiction in general.

>gonear terminal
Captain's Quarters
Neat and spartan, this cabin is the very model of a small fighting ship's captain's quarters. An impeccably organized desk is against one wall, while a typically spotless bed sits beneath a portrait of this very ship. There is a data terminal on the desk. Against a third wall is the captain's one indulgence: a set of free weights neatly put away in racks. You can exit to fore.

You can see a 9kg weight, a 15kg weight, a 29kg weight, a 32kg weight, and a 50kg weight here.

⇒ You may talk to the ship computer through the data terminal. You might try "computer, help" to get help on talking to the computer.

>purloin strange device
[Purloined.]

>purloin military id
[Purloined.]

>put id in device
Which do you mean, the strange device or the extendable dusting device?

>strange
You insert the military ID card into the strange device, but nothing happens.

* * *

Would you like to use accessibility features like no ASCII art? (enter "y" for yes)

>help
Welcome to Crash by Phil Riley. There are a few things about this game you may want to be aware of.

Text adventures (also known as interactive fiction) have a number of conventions and common commands. Some are:

Move by entering the direction you want to travel. You can use abbreviations, such as "n" for "north" and "u" for "up". 

 - look (or l): prints a description of your surroundings.
 - take <something>: moves something from your surroundings to your person.
 - drop <something>: opposite of take.
 - sit on <something>, get up: what they sound like.
 - examine <something> (or x): get a more detailed description (sometimes) of something.
 - unlock <something> with <something>, open <something>
 - press <a button>
 - inventory (or i): list what the player is carrying.
 - wait (or z): pass one turn doing nothing.

If there's something else you'd like to try, type it in and see what happens!

You can ask for hints at any time by typing "hints". Note that the available hints will vary from time to time, and there may not be any hints available when you ask.

There are a few ways in which this game differs from many text adventures:

First, we use nautical directions: fore, aft, port, starboard, up, down, in, and out. ("f", "a", "p", "s", "u", "d", "in", and "out")

Fore is the direction towards the front of the ship, that is, the usual direction of travel. Aft is the opposite of fore. Port is the direction to your left when you're facing fore. Starboard is the opposite of port. You can remember port from starboard by remembering that "port" and "left" have the same number of letters.

Up and down are relative to the shipboard artificial gravity. This gravity doesn't extend beyond the hull. Instead, outside we have the radial directions in (toward the center of mass of the ship) and out (away from the center of mass).

Second, two new commands: 

 - clean <something> or dust <something>: you're a cleaner, you need to be able to clean.
 - slide <something> through <a card slot>: some of the doors in the game require access cards.

In part of the game, we use ASCII art to represent what's going on. If you'd like to turn this art off, use "ASCII off". You can turn it on again using "ASCII on".

And finally, [text that looks like this] is the main character's, i.e., your, thoughts.

>hints
Some players may find the temptation to rely on hints overwhelming, and you may prefer to remove temptation by disabling hints for the rest of this game. If you do so, however, you will not be able to access the hints unless you restart. Do you wish to disable hints? >

* * *

>hints
Space Station Gangway
This is the pressurized bridge from Space Station Omicron-5 to the SS Usagi. Behind you the safety of home, before you the promise of adventure... cleaning up after Space Marines. Such is the lot of the 95th Sanitation Division. Not what you dreamed of when you enlisted.

As is usual, the crew is all off the ship while you board to clean it. You usually have a partner, but today Pvt "Chubby" Franks has the flu, so it's your job alone.

To the fore is the aft airlock of the Usagi, beckoning you in.

[Better get a move on, I guess], you think.

⇒ Tip: Type "help" to learn about this game, and interactive fiction in general.

>f
You pass through the aft airlock and into the ship, closing the airlock doors behind you.

Aft Entry
You are forward from the aft airlock, inside the ship. Beyond the airlock is the station gangway.

On your right is a control panel for the airlock. It consists of a green button to pressurize the airlock chamber, a yellow button to depressurize it, a red button to open and close the inner airlock door, and a blue button to open and close the outer airlock door.

The airlock is aft of here, and a ladder leads up to the ship proper.

The aft airlock inner door is closed.

>u
Crew Quarters
This is a busy junction when the ship is populated. To port and starboard are the crew bunks, aft is the door to the captain's quarters, and fore is the galley. A ladder leads down to the aft airlock.

⇒ You can ask for hints at any time by typing "hints".

BOOM -- suddenly everything goes to hell. A bulkhead seems to hurtle towards you...
pain...
confusion...
blackness...
Somehow you're okay. Inertial dampers must have kicked in. Nevertheless, you feel like you were hit by a truck.
But what happened?

Crash
An Interactive Fiction by Phil Riley
Release 2 / Serial number 220618 / Inform 7 build 6M62 (I6/v6.34 lib 6/12N) SD

[Uhhhhh...]

* * *

Would you like to use accessibility features like no ASCII art? (enter "y" for yes)

>help test
Useful commands to help with testing:

Any of the testing commands listed in Writing In Inform, particularly: 

 - SHOWME <something> - prints info about a thing or place; this can help you locate something you've lost.
 - PURLOIN <something> - move something to your inventory

Some commands special to this game: 

 - activate suit - magically activate the vac suit without doing the real work
 - familiar <something> - magically learn about a thing so that you can talk to people about it; normally you can't talk about something you're not familiar with
 - show all hints - allow access to all hints, before they'd ordinarily become available

There are a few commands that are spoilers in and of themselves. To see them, enter "help test spoilers". It's probably inadvisable to look at them until you've gone really deep into the game.

>help test spoilers
Useful commands to help with testing that might spoil the game: 

 - clear door - remove the obstruction from the fore/aft door
 - rebooted - jump to the end game, having rebooted the computer
 - protocols - jump to the end game, having invoked the emergency protocols
 - more time - add 50 turns to the time limit during the end game

* * *

Would you like to use accessibility features like no ASCII art? (enter "y" for yes)

>help test spoilers
Useful commands to help with testing that might spoil the game: 

 - clear door - remove the obstruction from the fore/aft door
 - rebooted - jump to the end game, having rebooted the computer
 - protocols - jump to the end game, having invoked the emergency protocols
 - more time - add 50 turns to the time limit during the end game

* * *

Would you like to use accessibility features like no ASCII art? (enter "y" for yes)

>more time
This command only works during the end game; i.e., after you've rebooted the computer or invoked the emergency protocols.

>rebooted
Captain's Quarters
Neat and spartan, this cabin is the very model of a small fighting ship's captain's quarters. An impeccably organized desk is against one wall, while a typically spotless bed sits beneath a portrait of this very ship. There is a data terminal on the desk. Against a third wall is the captain's one indulgence: a set of free weights neatly put away in racks. You can exit to fore.

You can see a 9kg weight, a 15kg weight, a 29kg weight, a 32kg weight, and a 50kg weight here.

⇒ You may talk to the ship computer through the data terminal. You might try "computer, help" to get help on talking to the computer.

>more time
Turns left: 169.

>more time
Turns left: 219.

>more time
Turns left: 269.

* * *

Would you like to use accessibility features like no ASCII art? (enter "y" for yes)

>n
Space Station Gangway
This is the pressurized bridge from Space Station Omicron-5 to the SS Usagi. Behind you the safety of home, before you the promise of adventure... cleaning up after space marines. Such is the lot of the 95th Sanitation Division. Not what you dreamed of when you enlisted.

As is usual, the crew is all off the ship while you board to clean it. You usually have a partner, but today Private "Chubby" Franks has the flu, so it's your job alone.

To the fore is the aft airlock of the Usagi, beckoning you in.

[Better get a move on, I guess], you think.

⇒ For help with testing, enter "help test".

⇒ Tip: Type "help" to learn about this game, and interactive fiction in general.

>a
The only obvious exit is fore.

* * *

>d
The obvious exits are outside, aft (to outside the aft airlock (vacuum)) and starboard.

Your vac suit pings gently to indicate you have expended a unit of air.

>out
You propel yourself away from the ship, realizing too late you have no way to get back. You drift through the blackness of space until your air runs out and you suffocate.

    *** You have died ***

Would you like to RESTART, RESTORE a saved game, QUIT, or UNDO the last command?

>undo
Hull of the Usagi (vacuum)
[Previous turn undone.]

>f
The obvious exits are outside, aft (to outside the aft airlock (vacuum)) and starboard.

Your vac suit pings gently to indicate you have expended a unit of air.

>a
Outside the Aft Airlock (vacuum)
You are standing on the hull of the ship, outside the aft airlock, secured by your vac suit's mag boots. Most of the hull is taken up by the protrusions of various machinery, antennae, radio dishes, and heat sinks. There is a clear path to fore among the obstructions.

The aft airlock outer door is open.

Your vac suit pings gently to indicate you have expended a unit of air.

>d
The obvious exits are inside (to aft airlock chamber (vacuum)), outside and fore (to hull of the usagi (vacuum)).

Your vac suit pings gently to indicate you have expended a unit of air.

* * *

>e
You must use nautical directions: fore, aft, port, starboard, up, down, inside, or outside.

>a
The exits from here are Exits: FORE

* * *

>f
You pass through the aft airlock and into the ship, closing the airlock doors behind you.

Aft Entry
You are forward from the aft airlock, inside the ship. Beyond the airlock is the station gangway.

On your right is a control panel for the airlock. It consists of a green button to pressurize the airlock chamber, a yellow button to depressurize it, a red button to open and close the inner airlock door, and a blue button to open and close the outer airlock door.

The airlock is aft of here, and a ladder leads up to the ship proper.

The aft airlock inner door is closed.

* * *

>a
Your work is in the ship, not outside.

>e
You must use nautical directions: fore, aft, port, starboard, up, down, inside, or outside.

>in
⇒ Try going up: enter "u".

>u
Crew Quarters
This is a busy junction when the ship is populated. To port and starboard are the crew bunks, aft is the door to the captain's quarters, and fore is the galley. A ladder leads down to the aft airlock.

⇒ You can ask for hints at any time by typing "hints".

BOOM -- suddenly everything goes to hell. A bulkhead seems to hurtle towards you...
pain...
confusion...
blackness...
Somehow you're okay. Inertial dampers must have kicked in. Nevertheless, you feel like you were hit by a truck.
But what happened?

Crash
An Interactive Fiction by Phil Riley
Release 4 / Serial number 220620 / Inform 7 build 6M62 (I6/v6.34 lib 6/12N) SD

[Where am I?]

* * *

>a
Your work is in the ship, not outside.

>gonear room of subjects
Room of Subjects
This is where all subjects go.

You can see identity of the player here.

>a
Space Station Gangway
This is the pressurized bridge from Space Station Omicron-5 to the SS Usagi. Behind you the safety of home, before you the promise of adventure... cleaning up after space marines. Such is the lot of the 95th Sanitation Division. Not what you dreamed of when you enlisted.

As is usual, the crew is all off the ship while you board to clean it. You usually have a partner, but today Private "Chubby" Franks has the flu, so it's your job alone.

To the fore is the aft airlock of the Usagi, beckoning you in.

[Better get a move on, I guess], you think.

⇒ For help with testing, enter "help test".

⇒ Tip: Type "help" to learn about this game, and interactive fiction in general.

>f
You pass through the aft airlock and into the ship, closing the airlock doors behind you.

Aft Entry
You are forward from the aft airlock, inside the ship. Beyond the airlock is the station gangway.

On your right is a control panel for the airlock. It consists of a green button to pressurize the airlock chamber, a yellow button to depressurize it, a red button to open and close the inner airlock door, and a blue button to open and close the outer airlock door.

The airlock is aft of here, and a ladder leads up to the ship proper.

The aft airlock inner door is closed.

* * *

>a
Your work is in the ship, not outside.

>u
Crew Quarters
This is a busy junction when the ship is populated. To port and starboard are the crew bunks, aft is the door to the captain's quarters, and fore is the galley. A ladder leads down to the aft airlock.

⇒ You can ask for hints at any time by typing "hints".

BOOM -- suddenly everything goes to hell. A bulkhead seems to hurtle towards you...
pain...
confusion...
blackness...
Somehow you're okay. Inertial dampers must have kicked in. Nevertheless, you feel like you were hit by a truck.
But what happened?

Crash
An Interactive Fiction by Phil Riley
Release 4 / Serial number 220620 / Inform 7 build 6M62 (I6/v6.34 lib 6/12N) SD

[Where am I?]

>s
[What? Didn't get that. My brain is spinning too much. Try again.]

>s
Somewhere? (Where?) (lying on something comfortable)
Aaa cccc mmmmmmm www aaaa'a ttt ccccccc sssss in this or the opposite-side bunk room. This one ssssss ffff in ttt ssss oo bbbbb, one on the llll aaa ooo oo ttt rrrrr, aaa dddd uu wwww mmmmmmmm ppppppppp. There is a lllll eeeeeeeee ccccccc hhhh, ssssssssss aaaaaa to the ccccccc. Ii ii cccccc.

[Everything's a bit fuzzy.]

>s
You come to your senses lying on a bunk, not quite sure how you got here. You seem to have lost your equipment.

Port-Side Bunks (on the right bottom bunk)
[Okay, now things are coming into focus.]

All crew members who aren't the captain sleep in this or the opposite-side bunk room. This one sleeps four in two sets of bunks, one on the left and one on the right, all done up with military precision. There is a large locker here, stretching almost to the ceiling. It is closed. The sole exit is to starboard.

Something is affixed to the wall by the top left bunk.

A leather wallet lies discarded on the ground.

On the right top bunk is an extendable dusting device [that's mine].

You can also see a sonic decontaminator [also mine] here.

On the right bottom bunk you can see a hand-held micro-compressing vacuum cleaner [mine again. I really took a tumble.].

[Ohh my head hurts. What the heck happened? Better get back to the station pronto.]

* * *

>z
[What? Didn't get that. My brain is spinning too much. Try again.]

* * *

>z
Somewhere? (Where?) (lying on something comfortable)
Aaa cccc mmmmmmm www aaaa'a ttt ccccccc sssss in this or the opposite-side bunk room. This one ssssss ffff in ttt ssss oo bbbbb, one on the llll aaa ooo oo ttt rrrrr, aaa dddd uu wwww mmmmmmmm ppppppppp. There is a lllll eeeeeeeee ccccccc hhhh, ssssssssss aaaaaa to the ccccccc. Ii ii cccccc.

[Everything's a bit fuzzy.]

>z
You come to your senses lying on a bunk, not quite sure how you got here. You seem to have lost your equipment.

Port-Side Bunks (on the right bottom bunk)
[Okay, now things are coming into focus.]

All crew members who aren't the captain sleep in this or the opposite-side bunk room. This one sleeps four in two sets of bunks, one on the left and one on the right, all done up with military precision. There is a large locker here, stretching almost to the ceiling. It is closed. The sole exit is to starboard.

Something is affixed to the wall by the top left bunk.

A leather wallet lies discarded on the ground.

On the right top bunk is an extendable dusting device [that's mine].

You can also see a sonic decontaminator [also mine] and ceiling here.

On the right bottom bunk you can see a hand-held micro-compressing vacuum cleaner [mine again. I really took a tumble.].

[Ohh my head hurts. What the heck happened? Better get back to the station pronto.]

>s
(first getting off the right bottom bunk)
[Standing up makes me a little dizzy, oh my.]

Crew Quarters
This is a busy junction when the ship is populated. To port and starboard are the crew bunks, aft is the door to the captain's quarters, and fore is the galley. A ladder leads down to the aft airlock.

>d
Aft Entry
You are forward from the aft airlock, inside the ship. Outside is empty space where you're used to seeing the station gangway. Far off you see the luminous embers of what might have been an explosion.

On your right is a control panel for the airlock. It consists of a green button to pressurize the airlock chamber, a yellow button to depressurize it, a red button to open and close the inner airlock door, and a blue button to open and close the outer airlock door.

The airlock is aft of here, and a ladder leads up to the ship proper.

The aft airlock inner door is closed.

[Holy... the station -- it's gone? Where the hell am I? What am I going to do?]

>a
(first opening the aft airlock inner door)
You cannot just open the aft airlock inner door with your bare hands.

>u
Crew Quarters
This is a busy junction when the ship is populated. To port and starboard are the crew bunks, aft is the door to the captain's quarters, and fore is the galley. A ladder leads down to the aft airlock.

>s
Starboard-Side Bunks
All crew members who aren't the captain sleep in this or the opposite-side bunk room. This one sleeps four in two sets of bunks, one on the left and one on the right, all done up with military precision. There is a large locker here, stretching almost to the ceiling. It is closed. The sole exit is to port.

A copy of Stars Magazine is just peeking from underneath the left bottom bunk.

>p
Crew Quarters
This is a busy junction when the ship is populated. To port and starboard are the crew bunks, aft is the door to the captain's quarters, and fore is the galley. A ladder leads down to the aft airlock.

>f
The Galley
This narrow space is barely enough room for two Marines to prepare and eat a meal. There is a counter with two stools, a microwave oven, and a large closet here. Pots and pans hang from hooks in the ceiling. A ladder leads up through the fore/aft door, and you can leave aft.

On the starboard wall is a panel on which is a blue button. Tacked to the panel is the operator's manual for the fore/aft door.

You faintly hear someone speaking above.

>a
Crew Quarters
This is a busy junction when the ship is populated. To port and starboard are the crew bunks, aft is the door to the captain's quarters, and fore is the galley. A ladder leads down to the aft airlock.

>exit symbol ?
I only understood you as far as wanting to exit.

>exit symbol
Done.

>exit symbol
Done.

>a
The door stays shut as you try to go through it.

>f
The Galley
This narrow space is barely enough room for two Marines to prepare and eat a meal. There is a counter with two stools, a microwave oven, and a large closet here. Pots and pans hang from hooks in the ceiling. A ladder leads up through the fore/aft door, and you can leave aft.

On the starboard wall is a panel on which is a blue button. Tacked to the panel is the operator's manual for the fore/aft door.

* * *

>x ceiling
You really don't need to worry about ceiling.

* * *

>f
You pass through the aft airlock and into the ship, closing the airlock doors behind you.

Aft Entry
You are forward from the aft airlock, inside the ship. Beyond the airlock is the station gangway.

On your right is a control panel for the airlock. It consists of a green button to pressurize the airlock chamber, a yellow button to depressurize it, a red button to open and close the inner airlock door, and a blue button to open and close the outer airlock door.

The airlock is aft of here, and a ladder leads up to the ship proper.

The aft airlock inner door is closed.

>u
Crew Quarters
This is a busy junction when the ship is populated. To port and starboard are the crew bunks, aft is the door to the captain's quarters, and fore is the galley. A ladder leads down to the aft airlock.

⇒ You can ask for hints at any time by typing "hints".

BOOM -- suddenly everything goes to hell. A bulkhead seems to hurtle towards you...
pain...
confusion...
blackness...
Somehow you're okay. Inertial dampers must have kicked in. Nevertheless, you feel like you were hit by a truck.
But what happened?

Crash
An Interactive Fiction by Phil Riley
Release 4 / Serial number 220620 / Inform 7 build 6M62 (I6/v6.34 lib 6/12N) SD

[Where am I?]

>gonea
[What? Didn't get that. My brain is spinning too much. Try again.]

[Stop it.]

>a
Somewhere? (Where?) (lying on something comfortable)
Aaa cccc mmmmmmm www aaaa'a ttt ccccccc sssss in this or the opposite-side bunk room. This one ssssss ffff in ttt ssss oo bbbbb, one on the llll aaa ooo oo ttt rrrrr, aaa dddd uu wwww mmmmmmmm ppppppppp. There is a lllll eeeeeeeee ccccccc hhhh, ssssssssss aaaaaa to the ccccccc. Ii ii cccccc.

[Everything's a bit fuzzy.]

>a
You come to your senses lying on a bunk, not quite sure how you got here. You seem to have lost your equipment.

Port-Side Bunks (on the right bottom bunk)
[Okay, now things are coming into focus.]

All crew members who aren't the captain sleep in this or the opposite-side bunk room. This one sleeps four in two sets of bunks, one on the left and one on the right, all done up with military precision. There is a large locker here, stretching almost to the ceiling. It is closed. The sole exit is to starboard.

Something is affixed to the wall by the top left bunk.

A leather wallet lies discarded on the ground.

On the right top bunk is an extendable dusting device [that's mine].

You can also see a sonic decontaminator [also mine] here.

On the right bottom bunk you can see a hand-held micro-compressing vacuum cleaner [mine again. I really took a tumble.].

[Ohh my head hurts. What the heck happened? Better get back to the station pronto.]

>gonear aft airlock chamber
Aft Airlock Chamber
You are in the aft airlock chamber. You're one door away from the great void of space. Both doors are closed; you'll have to open one to leave the airlock.

On your right is a control panel for the airlock. It consists of a green button to pressurize the airlock chamber, a yellow button to depressurize it, a red button to open and close the inner airlock door, and a blue button to open and close the outer airlock door.

The aft airlock inner door is closed.

The aft airlock outer door is closed.

>press yellow button
You wait several seconds for the chamber to depressurize. You hear a series of three beeps indicating the chamber is now in vacuum.

You are in vacuum. We'll spare you the details, but it isn't a pretty way to go.

    *** You have died ***

Would you like to RESTART, RESTORE a saved game, QUIT, or UNDO the last command?

>undo
Aft Airlock Chamber
[Previous turn undone.]

>rules
Rules tracing now switched on. Type "rules off" to switch it off again, or "rules all" to include even rules which do not apply.

>press yellow button
[Rule "redirect to GEP line input rule" applies.]
[Rule "After reading a command" applies.]
[Rule "After reading a command" applies.]
[Rule "declare everything initially unmentioned rule" applies.]
[Rule "announce items from multiple object lists rule" applies.]
[Rule "set pronouns from items from multiple object lists rule" applies.]
[Rule "before stage rule" applies.]
[Rule "instead stage rule" applies.]
[Rule "investigate player's awareness before action rule" applies.]
[Rule "player aware of his own actions rule" applies.]
[Rule "check stage rule" applies.]
[Rule "carry out stage rule" applies.]
[Rule "Carry out pressing an airlock-depressurize-button" applies.]
[Rule "after stage rule" applies.]
[Rule "investigate player's awareness after action rule" applies.]
[Rule "report stage rule" applies.]
[Rule "Report pressing an airlock-depressurize-button" applies.]
You wait several seconds for the chamber to depressurize. You hear a series of three beeps indicating the chamber is now in vacuum.
[Rule "last specific action-processing rule" applies.]

[Rule "A first turn sequence rule" applies.]
[Rule "every turn stage rule" applies.]
[Rule "Every turn when not talking about asking mulgrew questions" applies.]
[Rule "For asking for attention by Arvax while current conversation state is making contact" applies.]
[Rule "reset protocol rule" applies.]
[Rule "close open doors rule" applies.]
[Rule "deactivate equipment cabinets rule" applies.]
[Rule "second check vacuum rule" applies.]
You are in vacuum. We'll spare you the details, but it isn't a pretty way to go.

[Rule "when play ends stage rule" applies.]
[Rule "print player's obituary rule" applies.]

    *** You have died ***

[Rule "print the final question rule" applies.]
Would you like to RESTART, RESTORE a saved game, QUIT, or UNDO the last command?
[Rule "print the final prompt rule" applies.]

* * *

>x bunks
[What? Didn't get that. My brain is spinning too much. Try again.]

>z
Somewhere? (Where?) (lying on something comfortable)
Aaa cccc mmmmmmm www aaaa'a ttt ccccccc sssss in this or the opposite-side bunk room. This one ssssss ffff in ttt ssss oo bbbbb, one on the llll aaa ooo oo ttt rrrrr, aaa dddd uu wwww mmmmmmmm ppppppppp. There is a lllll eeeeeeeee ccccccc hhhh, ssssssssss aaaaaa to the ccccccc. Ii ii cccccc.

[Everything's a bit fuzzy.]

* * *

>x bunks
You can't use multiple objects with that verb.

>take bunks
What do you want to take those things from?

>bunks
You can't see any such thing.

>i
You are carrying:
  a maintenance crew access card
  a military sanitation uniform (being worn)

>get up
You get off the right bottom bunk.

Port-Side Bunks
All crew members who aren't the captain sleep in this or the opposite-side bunk room. This one sleeps four in two sets of bunks, one on the left and one on the right, all done up with military precision. There is a large locker here, stretching almost to the ceiling. It is closed. The sole exit is to starboard.

Something is affixed to the wall by the top left bunk.

A leather wallet lies discarded on the ground.

On the right bottom bunk is a hand-held micro-compressing vacuum cleaner.

On the right top bunk is an extendable dusting device.

You can also see a sonic decontaminator here.

[Standing up makes me a little dizzy, oh my.]

[Okay now, back to the station -- let's see, I'm in Port-Side Bunks, so I need to go starboard and then down...]

>take bunks
What do you want to take those things from?

>port-side bunks
You can't see any such thing.

* * *

>z
[What? Didn't get that. My brain is spinning too much. Try again.]

>l
Somewhere? (Where?) (lying on something comfortable)
Aaa cccc mmmmmmm www aaaa'a ttt ccccccc sssss in this or the opposite-side bunk room. This one ssssss ffff in ttt ssss oo bbbbb, one on the llll aaa ooo oo ttt rrrrr, aaa dddd uu wwww mmmmmmmm ppppppppp. There is a lllll eeeeeeeee ccccccc hhhh, ssssssssss aaaaaa to the ccccccc. Ii ii cccccc.

[Everything's a bit fuzzy.]

>help
[I'm having a bit of trouble here. Hang on, I'll get it together. Meanwhile, you could always try "look" and see what happens.]

>a
You come to your senses lying on a bunk, not quite sure how you got here. You seem to have lost your equipment.

Port-Side Bunks (on the right bottom bunk)
[Okay, now things are coming into focus.]

All crew members who aren't the captain sleep in this or the opposite-side bunk room. This one sleeps four in two sets of bunks, one on the left and one on the right, all done up with military precision. There is a large locker here, stretching almost to the ceiling. It is closed. The sole exit is to starboard.

Something is affixed to the wall by the top left bunk.

A leather wallet lies discarded on the ground.

On the right top bunk is an extendable dusting device [that's mine].

You can also see a sonic decontaminator [also mine] here.

On the right bottom bunk you can see a hand-held micro-compressing vacuum cleaner [mine again. I really took a tumble.].

[Ohh my head hurts. What the heck happened? Better get back to the station pronto.]

>s
(first getting off the right bottom bunk)
[Standing up makes me a little dizzy, oh my.]

Crew Quarters
This is a busy junction when the ship is populated. To port and starboard are the crew bunks, aft is the door to the captain's quarters, and fore is the galley. A ladder leads down to the aft airlock.

>open door with card
You slide the maintenance crew access card through the slot. The door buzzes three times, indicating the card is unreadable.
[I don't understand. The card worked earlier today.]

>open door with card
You slide the maintenance crew access card through the slot. The door buzzes three times, indicating the card is unreadable.

>open door with card
You slide the maintenance crew access card through the slot. The door buzzes three times, indicating the card is unreadable.

>ask computer about chicken
You can't see any such thing.

>ask computer about card
You can't see any such thing.

* * *

>take all
sonic decontaminator: Taken.
wallet: Taken.
hand-held micro-compressing vacuum cleaner: Taken.
extendable dusting device: Taken.

>purloin vac suit
[Purloined.]

>drop it
Dropped.

>take it
You can't carry that much weight.
⇒ The vac suit is very heavy. You may need to drop most of your possessions first.

>drop it
The vac suit is already here.

>take it
You can't carry that much weight.
⇒ The vac suit is very heavy. You may need to drop most of your possessions first.

* * *

>x bunks
You can't see any such thing.

>x bunk beds
You can't use multiple objects with that verb.

>take bunks
You can't see any such thing.

>take bunk beds
What do you want to take those things from?

>room
You can't see any such thing.

>x bunk
Which do you mean, the left top bunk, the left bottom bunk, the right bottom bunk, or the right top bunk?

>right top
One of a number of perfect regulation bunks.

On the right top bunk is an extendable dusting device.

>x all
You can't use multiple objects with that verb.

* * *

>s
(first getting off the right bottom bunk)
[Standing up makes me a little dizzy, oh my.]

Crew Quarters
This is a busy junction when the ship is populated. To port and starboard are the crew bunks, aft is the door to the captain's quarters, and fore is the galley. A ladder leads down to the aft airlock.

* * *

>open door with card
You slide the maintenance crew access card through the slot. The door buzzes three times, indicating the card is unreadable.
[I don't understand. The card worked earlier today.]

>unlock door with card
You slide the maintenance crew access card through the slot. The door buzzes three times, indicating the card is unreadable.

The Captain's door slides smoothly open. A pleasant ping indicates it now recognizes you as authorized.

>restart
Are you sure you want to restart?

>y
Would you like to use accessibility features like no ASCII art? (enter "y" for yes)

>n
Space Station Gangway
This is the pressurized bridge from Space Station Omicron-5 to the SS Usagi. Behind you the safety of home, before you the promise of adventure... cleaning up after Space Marines. Such is the lot of the 95th Sanitation Division. Not what you dreamed of when you enlisted.

As is usual, the crew is all off the ship while you board to clean it. You usually have a partner, but today Pvt "Chubby" Franks has the flu, so it's your job alone.

To the fore is the aft airlock of the Usagi, beckoning you in.

[Better get a move on, I guess], you think.

⇒ For help with testing, enter "help test".

⇒ Tip: Type "help" to learn about this game, and interactive fiction in general.

>f
You pass through the aft airlock and into the ship, closing the airlock doors behind you.

Aft Entry
You are forward from the aft airlock, inside the ship. Beyond the airlock is the station gangway.

On your right is a control panel for the airlock. It consists of a green button to pressurize the airlock chamber, a yellow button to depressurize it, a red button to open and close the inner airlock door, and a blue button to open and close the outer airlock door.

The airlock is aft of here, and a ladder leads up to the ship proper.

The aft airlock inner door is closed.

>u
[Where am I?]

>z
[What? Didn't get that. My brain is spinning too much. Try again.]

* * *

>s
(first getting off the right bottom bunk)
[Standing up makes me a little dizzy, oh my.]

Crew Quarters
This is a busy junction when the ship is populated. To port and starboard are the crew bunks, aft is the door to the captain's quarters, and fore is the galley. A ladder leads down to the aft airlock.

>rules
Rules tracing now switched on. Type "rules off" to switch it off again, or "rules all" to include even rules which do not apply.

>open door with card
[Rule "redirect to GEP line input rule" applies.]
[Rule "After reading a command" applies.]
[Rule "declare everything initially unmentioned rule" applies.]
[Rule "announce items from multiple object lists rule" applies.]
[Rule "set pronouns from items from multiple object lists rule" applies.]
[Rule "before stage rule" applies.]
[Rule "instead stage rule" applies.]
[Rule "investigate player's awareness before action rule" applies.]
[Rule "player aware of his own actions rule" applies.]
[Rule "check stage rule" applies.]
[Rule "Check sliding an access card ( called the card ) through a starship door ( called D )" applies.]
You slide the maintenance crew access card through the slot. The door buzzes three times, indicating the card is unreadable.
[I don't understand. The card worked earlier today.]

[Rule "A first turn sequence rule" applies.]
[Rule "every turn stage rule" applies.]
[Rule "Every turn when not talking about asking mulgrew questions" applies.]
[Rule "For asking for attention by Arvax while current conversation state is making contact" applies.]
[Rule "reset protocol rule" applies.]
[Rule "close open doors rule" applies.]
[Rule "deactivate equipment cabinets rule" applies.]
[Rule "A last turn sequence rule" applies.]
[Rule "notify score changes rule" applies.]

>open door with card
[Rule "redirect to GEP line input rule" applies.]
[Rule "After reading a command" applies.]
[Rule "declare everything initially unmentioned rule" applies.]
[Rule "announce items from multiple object lists rule" applies.]
[Rule "set pronouns from items from multiple object lists rule" applies.]
[Rule "before stage rule" applies.]
[Rule "instead stage rule" applies.]
[Rule "investigate player's awareness before action rule" applies.]
[Rule "player aware of his own actions rule" applies.]
[Rule "check stage rule" applies.]
[Rule "Check sliding an access card ( called the card ) through a starship door ( called D )" applies.]
You slide the maintenance crew access card through the slot. The door buzzes three times, indicating the card is unreadable.

[Rule "carry out stage rule" applies.]
[Rule "Carry out sliding an access card ( called the card ) through a starship door ( called D ) when D is closed" applies.]
[Rule "after stage rule" applies.]
[Rule "investigate player's awareness after action rule" applies.]
[Rule "report stage rule" applies.]
[Rule "Report sliding an access card through a starship door ( called D ) when door originally open is false" applies.]
The Captain's door slides smoothly open. A pleasant ping indicates it now recognizes you as authorized.

[Rule "last specific action-processing rule" applies.]
[Rule "A first turn sequence rule" applies.]
[Rule "every turn stage rule" applies.]
[Rule "Every turn when not talking about asking mulgrew questions" applies.]
[Rule "reset protocol rule" applies.]
[Rule "close open doors rule" applies.]
[Rule "deactivate equipment cabinets rule" applies.]
[Rule "A last turn sequence rule" applies.]
[Rule "notify score changes rule" applies.]

* * *

>take bunks
What do you want to take those things from?

>bunk
You can't see any such thing.

>get off bunk
(the right bottom bunk)
You get off the right bottom bunk.

Port-Side Bunks
All crew members who aren't the captain sleep in this or the opposite-side bunk room. This one sleeps four in two sets of bunks, one on the left and one on the right, all done up with military precision. There is a large locker here, stretching almost to the ceiling. It is closed. The sole exit is to starboard.

Something is affixed to the wall by the top left bunk.

A leather wallet lies discarded on the ground.

On the right bottom bunk is a hand-held micro-compressing vacuum cleaner.

On the right top bunk is an extendable dusting device.

You can also see a sonic decontaminator here.

[Okay now, back to the station -- let's see, I'm in Port-Side Bunks, so I need to go starboard and then down...]

>get on bunks
You can't see any such thing.

>x bunks
You can't use multiple objects with that verb.

>put card on bunks
You can't see any such thing.

>put card on bunk
Which do you mean, the left top bunk, the left bottom bunk, the right bottom bunk, or the right top bunk?

* * *

>gonear
What do you want to gonear?

>gonear onepass
Starboard-Side Bunks
All crew members who aren't the captain sleep in this or the opposite-side bunk room. This one sleeps four in two sets of bunks, one on the left and one on the right, all done up with military precision. There is a large locker here, stretching almost to the ceiling. It is closed. The sole exit is to port.

On the left bottom bunk is a OnePass.

A copy of Stars Magazine is just peeking from underneath the left bottom bunk.

>take it
[Not my kind of reading, actually, but what the heck.]Taken.

>take onepass
Taken.

>purloin id
(the military ID card)
[Purloined.]

* * *

>put onepass in locker
The starboard-side equipment locker is closed.

>slide onepass through slot
You can't see any such thing.

>i
You are carrying:
  a OnePass
  a copy of Stars Magazine
  a maintenance crew access card
  a sonic decontaminator
  a hand-held micro-compressing vacuum cleaner
  an extendable dusting device
  a military sanitation uniform (being worn)

>l
Starboard-Side Bunks
All crew members who aren't the captain sleep in this or the opposite-side bunk room. This one sleeps four in two sets of bunks, one on the left and one on the right, all done up with military precision. There is a large locker here, stretching almost to the ceiling. It is closed. The sole exit is to port.

>swipe onepass in slot
You can't see any such thing.

>x locker
The locker features a traditional keyhole and a card slot.

>swipe onepass in slot
You can't see any such thing.

* * *

>gonear aft airlock chamber
Aft Airlock Chamber
You are in the aft airlock chamber. You're one door away from the great void of space. Both doors are closed; you'll have to open one to leave the airlock.

On your right is a control panel for the airlock. It consists of a green button to pressurize the airlock chamber, a yellow button to depressurize it, a red button to open and close the inner airlock door, and a blue button to open and close the outer airlock door.

The aft airlock inner door is closed.

The aft airlock outer door is closed.

>press yellow button
You may not be a space marine, but you know enough not to depressurize a chamber when you're not in a vac suit.

>undo
Aft Airlock Chamber
[Previous turn undone.]

* * *

>rules
Rules tracing now switched on. Type "rules off" to switch it off again, or "rules all" to include even rules which do not apply.

>press yellow button
[Rule "redirect to GEP line input rule" applies.]
[Rule "After reading a command" applies.]
[Rule "After reading a command" applies.]
[Rule "declare everything initially unmentioned rule" applies.]
[Rule "announce items from multiple object lists rule" applies.]
[Rule "set pronouns from items from multiple object lists rule" applies.]
[Rule "before stage rule" applies.]
[Rule "instead stage rule" applies.]
[Rule "investigate player's awareness before action rule" applies.]
[Rule "player aware of his own actions rule" applies.]
[Rule "check stage rule" applies.]
[Rule "carry out stage rule" applies.]
[Rule "Carry out pressing an airlock-depressurize-button" applies.]
[Rule "after stage rule" applies.]
[Rule "investigate player's awareness after action rule" applies.]
[Rule "report stage rule" applies.]
[Rule "Report pressing an airlock-depressurize-button" applies.]
You wait several seconds for the chamber to depressurize. You hear a series of three beeps indicating the chamber is now in vacuum.
[Rule "last specific action-processing rule" applies.]

[Rule "A first turn sequence rule" applies.]
[Rule "every turn stage rule" applies.]
[Rule "Every turn when not talking about asking mulgrew questions" applies.]
[Rule "reset protocol rule" applies.]
[Rule "close open doors rule" applies.]
[Rule "deactivate equipment cabinets rule" applies.]
[Rule "second check vacuum rule" applies.]
You are in vacuum. We'll spare you the details, but it isn't a pretty way to go.

[Rule "when play ends stage rule" applies.]
[Rule "print player's obituary rule" applies.]

    *** You have died ***

[Rule "print the final question rule" applies.]
Would you like to RESTART, RESTORE a saved game, QUIT, or UNDO the last command?
[Rule "print the final prompt rule" applies.]

* * *

>gonear closet
The Galley
This narrow space is barely enough room for two Marines to prepare and eat a meal. There is a counter with two stools, a microwave oven, and a large closet here. Pots and pans hang from hooks in the ceiling. A ladder leads up through the fore/aft door, and you can leave aft.

On the starboard wall is a panel on which is a blue button. Tacked to the panel is the operator's manual for the fore/aft door.

>open it
You open the closet, revealing ten MREs.

>eat mre
(first taking the MRE)
You eat the MRE. Although it has the advantage of being self-heating, it is unfortunately thoroughly uninspired cuisine.

You hear someone speaking above.

>yell
That noun did not make sense in this context.

* * *

>gonear comms
There seems to be no such object anywhere in the model world.

* * *

>gonear communications
Operations
This is where all of the support activity for the bridge occurs. There are large consoles for environmental controls, communications, and power systems here. The bridge continues forward from here, and engineering is aft. There is a door set in the floor with a ladder leading through it. Set in the frame of the door is a blue button.

A large equipment trunk lies on the Fore/Aft door, blocking it.

>hello
(addressing the caller)
You call out "Yes! I'm here! I'm here! What's going on?"

The caller responds, "Ahoy there, SS Usagi, good to hear from you. Seems like you're a bit out of sorts, and we'd like to help you out. But before we get into that, who am I speaking to? Tell me about yourself."

>hello
You are already talking to the caller.

>ask arvax about usagi
"Great ship. I hope we can save her. And you."

>tell caller about me
You tell the caller that you're a ship cleaner of the 95th Sanitation Division.

"Alright then, Captain Clean, I'll fill you in. Space Station Omicron-5 was bombed by separatists from Deneb IV. By some miracle the Usagi was spared the worst of the blast; you were thrown clear of the station. Only problem is now you're hurtling towards New Da Nang, a heavily-populated moon of Deneb II. An impact there would kill not only you but potentially thousands of people more.

 "So we've got some work to do. I'm Master Sergeant R. Mu Arvax. I'm going to try and help you get this ship under control again. First we have to establish, though, what the ship is currently doing. Normally, I'd be able to tap into the ship diagnostics and controls from here on Deneb III, but something seems to have gone wrong. So I'm going to need your help. Are you up to the task?"

[Captain Clean, guy thinks he's funny.]

>arvax, repeat
Master Sergeant R. Mu Arvax said: "Alright then, Captain Clean, I'll fill you in. Space Station Omicron-5 was bombed by separatists from Deneb IV. By some miracle the Usagi was spared the worst of the blast; you were thrown clear of the station. Only problem is now you're hurtling towards New Da Nang, a heavily-populated moon of Deneb II. An impact there would kill not only you but potentially thousands of people more.

 "So we've got some work to do. I'm Master Sergeant R. Mu Arvax. I'm going to try and help you get this ship under control again. First we have to establish, though, what the ship is currently doing. Normally, I'd be able to tap into the ship diagnostics and controls from here on Deneb III, but something seems to have gone wrong. So I'm going to need your help. Are you up to the task?"

>arvax, repeat all
Master Sergeant R. Mu Arvax said: The caller responds, "Ahoy there, SS Usagi, good to hear from you. Seems like you're a bit out of sorts, and we'd like to help you out. But before we get into that, who am I speaking to? Tell me about yourself."

Master Sergeant R. Mu Arvax said: "Great ship. I hope we can save her. And you."

Master Sergeant R. Mu Arvax said: "Alright then, Captain Clean, I'll fill you in. Space Station Omicron-5 was bombed by separatists from Deneb IV. By some miracle the Usagi was spared the worst of the blast; you were thrown clear of the station. Only problem is now you're hurtling towards New Da Nang, a heavily-populated moon of Deneb II. An impact there would kill not only you but potentially thousands of people more.

 "So we've got some work to do. I'm Master Sergeant R. Mu Arvax. I'm going to try and help you get this ship under control again. First we have to establish, though, what the ship is currently doing. Normally, I'd be able to tap into the ship diagnostics and controls from here on Deneb III, but something seems to have gone wrong. So I'm going to need your help. Are you up to the task?"

* * *

>hello
(addressing the caller)
You call out "Yes! I'm here! I'm here! What's going on?"

The caller responds, "Ahoy there, SS Usagi, good to hear from you. Seems like you're a bit out of sorts, and we'd like to help you out. But before we get into that, who am I speaking to? Tell me about yourself."

>tell caller about me
You tell the caller that you're a ship cleaner of the 95th Sanitation Division.

"Alright then, Captain Clean, I'll fill you in. Space Station Omicron-5 was bombed by separatists from Deneb IV. By some miracle the Usagi was spared the worst of the blast; you were thrown clear of the station. Only problem is now you're hurtling towards New Da Nang, a heavily-populated moon of Deneb II. An impact there would kill not only you but potentially thousands of people more.

 "So we've got some work to do. I'm Master Sergeant R. Mu Arvax. I'm going to try and help you get this ship under control again. First we have to establish, though, what the ship is currently doing. Normally, I'd be able to tap into the ship diagnostics and controls from here on Deneb III, but something seems to have gone wrong. So I'm going to need your help. Are you up to the task?"

[Captain Clean, guy thinks he's funny.]

>arvax, repeat
"Alright then, Captain Clean, I'll fill you in. Space Station Omicron-5 was bombed by separatists from Deneb IV. By some miracle the Usagi was spared the worst of the blast; you were thrown clear of the station. Only problem is now you're hurtling towards New Da Nang, a heavily-populated moon of Deneb II. An impact there would kill not only you but potentially thousands of people more.

 "So we've got some work to do. I'm Master Sergeant R. Mu Arvax. I'm going to try and help you get this ship under control again. First we have to establish, though, what the ship is currently doing. Normally, I'd be able to tap into the ship diagnostics and controls from here on Deneb III, but something seems to have gone wrong. So I'm going to need your help. Are you up to the task?"

>arvax, repeat
"Alright then, Captain Clean, I'll fill you in. Space Station Omicron-5 was bombed by separatists from Deneb IV. By some miracle the Usagi was spared the worst of the blast; you were thrown clear of the station. Only problem is now you're hurtling towards New Da Nang, a heavily-populated moon of Deneb II. An impact there would kill not only you but potentially thousands of people more.

 "So we've got some work to do. I'm Master Sergeant R. Mu Arvax. I'm going to try and help you get this ship under control again. First we have to establish, though, what the ship is currently doing. Normally, I'd be able to tap into the ship diagnostics and controls from here on Deneb III, but something seems to have gone wrong. So I'm going to need your help. Are you up to the task?"

>arvax, repeat all
The caller responds, "Ahoy there, SS Usagi, good to hear from you. Seems like you're a bit out of sorts, and we'd like to help you out. But before we get into that, who am I speaking to? Tell me about yourself."

"Alright then, Captain Clean, I'll fill you in. Space Station Omicron-5 was bombed by separatists from Deneb IV. By some miracle the Usagi was spared the worst of the blast; you were thrown clear of the station. Only problem is now you're hurtling towards New Da Nang, a heavily-populated moon of Deneb II. An impact there would kill not only you but potentially thousands of people more.

 "So we've got some work to do. I'm Master Sergeant R. Mu Arvax. I'm going to try and help you get this ship under control again. First we have to establish, though, what the ship is currently doing. Normally, I'd be able to tap into the ship diagnostics and controls from here on Deneb III, but something seems to have gone wrong. So I'm going to need your help. Are you up to the task?"

* * *

>yes
"Great, great. Now let's get to work.

 "The first thing I need you to do is reboot the system, using the captain's data terminal. Once you do that, hopefully I'll be able to access ship controls. You'll have to use my security code: say 'computer, access code 2' and then..."

Master Sergeant R. Mu Arvax's voice breaks up and another voice comes over comms. "SS Usagi, this is Captain Jane Mulgrew, please come in. Repeat, this is Captain Mulgrew of the SS Usagi, Usagi come in."

[Somebody else?]

>hello
(addressing Captain Jane Mulgrew)
Captain Mulgrew responds, "Hello there, Usagi. That's my ship you've got there. Be careful with her.

"We've been listening in and we've heard your communications with Arvax. He had us jammed for a while, but we managed to break through and here we are. Now it's very important that you understand this: Arvax is not your friend. His allegiances lie with Deneb IV, not with the Space Authority. He would like nothing more than to see this ship wipe out a few neighborhoods on New Da Nang.

"So what we need you to do is deny Arvax by shutting down any access to the ship's controls from the outside by invoking the emergency protocols. That will put the ship in a state where we can board and take control of the ship. What do you say? Do you have any questions?"

Master Sergeant R. Mu Arvax's voice comes back over the radio: "You there still, Usagi? I think I lost you for a second."

[Oh no, how am I going to tell whom to trust?]

>ask arvax about deneb
Which do you mean, Deneb System, Deneb IV, Deneb II, or Deneb sector?

>iv
"What a sad story. The founders were thoroughly admirable idealists whose vision has now been corrupted by power-hungry extremists."

>ask arvax about separatists
"Merely killing terrorists won't gain the Space Authority sympathy on Deneb IV. We need to be friends to the people there, who are just as threatened by the separatists as we are."

>ask mulgrew about deneb iv
"Beautiful planet, held hostage by those terrorist maniacs."

>ask mulgrew about arvax
"Arvax is a traitor pure and simple. If you haven't yet, consult his file through my data terminal in my quarters."

>ask arvax about mulgrew
"Let me guess. She told you I'm a separatist stooge, right? I guess it's time to blow my cover. I've been cultivating that image for several years now to infiltrate Deneb IV. Here. Look up "Operation Dalmatian" in Mulgrew's data terminal."

>gonear desk
(the desk drawer)
Captain's Quarters
Neat and spartan, this cabin is the very model of a small fighting ship's captain's quarters. An impeccably organized desk is against one wall, while a typically spotless bed sits beneath a portrait of this very ship. There is a data terminal on the desk. Against a third wall is the captain's one indulgence: a set of free weights neatly put away in racks. You can exit to fore.

You can see a 9kg weight, a 15kg weight, a 29kg weight, a 32kg weight, and a 50kg weight here.

⇒ You may talk to the ship computer through the data terminal. You might try "computer, help" to get help on talking to the computer.

>ask computer about operation dalmatian
"Information on Operation Dalmatian is restricted."

>gonear communications
Operations
This is where all of the support activity for the bridge occurs. There are large consoles for environmental controls, communications, and power systems here. The bridge continues forward from here, and engineering is aft. There is a door set in the floor with a ladder leading through it. Set in the frame of the door is a blue button.

A large equipment trunk lies on the Fore/Aft door, blocking it.

>ask arvax about reboot
"Before rebooting, make sure your vac suit is full and on. Life support can go out during a reboot."

>ask arvax about code
"It's 2."

>ask mulgrew about code
"If you need to know, I'll tell you."

>ask mulgrew about emergency
"I'm afraid I don't know anything about that."

>ask mulgrew about emergency protocols
"I'm afraid I don't know anything about that."

>ask mulgrew about reboot
"Don't be too hasty to reboot the computer. Once that's done, Arvax can get control of the ship and we won't be able to get it back. We need to activate the ship's emergency protocols. The computer will reboot itself if necessary."

>ask mulgrew about emergency protocols
"To prevent Arvax from seizing control of the ship remotely, we need to put the ship in a mode where it ignores all data communications. Voice radio will still be able to get through, but communications with the computer from outside will cease."

>ask mulgrew about data terminal
"Ah yes, I suppose you'll need access to that. It's in my quarters. Just say: 'Computer, access code 3'."

>ask mulgrew about code
"It's 3."

>ask mulgrew about reboot
"Don't be too hasty to reboot the computer. Once that's done, Arvax can get control of the ship and we won't be able to get it back. We need to activate the ship's emergency protocols. The computer will reboot itself if necessary."

>ask mulgrew about vac suit
"I'm afraid I don't know anything about that."

>ask arvax about vac suit
"I'm afraid I don't know anything about that."

* * *

>ask arvax about vac suit
"There's a refill station in the Engineering deck. Should be simple enough to operate. There's a chance of a short outage in the environmental system during a system reboot. Better get that suit refilled first.

>ask mulgrew about vac suit
"Shouldn't need it."

* * *

>hello
(addressing the caller)
You call out "Yes! I'm here! I'm here! What's going on?"

The caller responds, "Ahoy there, SS Usagi, good to hear from you. Seems like you're a bit out of sorts, and we'd like to help you out. But before we get into that, who am I speaking to? Tell me about yourself."

>z
Time passes.

>z
Time passes.

"You still there?"

>z
Time passes.

>z
Time passes.

"You still there?"
⇒ the caller is waiting for you to tell him something about yourself.

>arvax, repeat all
the caller said: The caller responds, "Ahoy there, SS Usagi, good to hear from you. Seems like you're a bit out of sorts, and we'd like to help you out. But before we get into that, who am I speaking to? Tell me about yourself."

the caller said: "You still there?"

the caller said: "You still there?"

>tell caller about me
You tell the caller that you're a ship cleaner of the 95th Sanitation Division.

"Alright then, Captain Clean, I'll fill you in. Space Station Omicron-5 was bombed by separatists from Deneb IV. By some miracle the Usagi was spared the worst of the blast; you were thrown clear of the station. Only problem is now you're hurtling towards New Da Nang, a heavily-populated moon of Deneb II. An impact there would kill not only you but potentially thousands of people more.

 "So we've got some work to do. I'm Master Sergeant R. Mu Arvax. I'm going to try and help you get this ship under control again. First we have to establish, though, what the ship is currently doing. Normally, I'd be able to tap into the ship diagnostics and controls from here on Deneb III, but something seems to have gone wrong. So I'm going to need your help. Are you up to the task?"

[Captain Clean, guy thinks he's funny.]

>arvax, repeat all
Master Sergeant R. Mu Arvax said: The caller responds, "Ahoy there, SS Usagi, good to hear from you. Seems like you're a bit out of sorts, and we'd like to help you out. But before we get into that, who am I speaking to? Tell me about yourself."

Master Sergeant R. Mu Arvax said: "You still there?"

Master Sergeant R. Mu Arvax said: "You still there?"

Master Sergeant R. Mu Arvax said: "Alright then, Captain Clean, I'll fill you in. Space Station Omicron-5 was bombed by separatists from Deneb IV. By some miracle the Usagi was spared the worst of the blast; you were thrown clear of the station. Only problem is now you're hurtling towards New Da Nang, a heavily-populated moon of Deneb II. An impact there would kill not only you but potentially thousands of people more.

 "So we've got some work to do. I'm Master Sergeant R. Mu Arvax. I'm going to try and help you get this ship under control again. First we have to establish, though, what the ship is currently doing. Normally, I'd be able to tap into the ship diagnostics and controls from here on Deneb III, but something seems to have gone wrong. So I'm going to need your help. Are you up to the task?"

* * *

>gonear communications
Operations
This is where all of the support activity for the bridge occurs. There are large consoles for environmental controls, communications, and power systems here. The bridge continues forward from here, and engineering is aft. There is a door set in the floor with a ladder leading through it. Set in the frame of the door is a blue button.

A large equipment trunk lies on the Fore/Aft door, blocking it.

>z
Time passes.

>z
Time passes.

A man's voice comes over comms: "SS Usagi, come in! Is anyone there?"

[Finally, another person! I'm saved!]

⇒ By the way... you can get help about speaking to other characters by typing "help speech".

>hello
(addressing the caller)
You call out "Yes! I'm here! I'm here! What's going on?"

The caller responds, "Ahoy there, SS Usagi, good to hear from you. Seems like you're a bit out of sorts, and we'd like to help you out. But before we get into that, who am I speaking to? Tell me about yourself."

* * *

>yes
"Great, great. Now let's get to work.

 "The first thing I need you to do is reboot the system, using the captain's data terminal. Once you do that, hopefully I'll be able to access ship controls. You'll have to use my security code: say 'computer, access code 2' and then..."

Master Sergeant R. Mu Arvax's voice breaks up and another voice comes over comms. "SS Usagi, this is Captain Jane Mulgrew, please come in. Repeat, this is Captain Mulgrew of the SS Usagi, Usagi come in."

[Somebody else?]

>hello
(addressing Captain Jane Mulgrew)
Captain Mulgrew responds, "Hello there, Usagi. That's my ship you've got there. Be careful with her.

"We've been listening in and we've heard your communications with Arvax. He had us jammed for a while, but we managed to break through and here we are. Now it's very important that you understand this: Arvax is not your friend. His allegiances lie with Deneb IV, not with the Space Authority. He would like nothing more than to see this ship wipe out a few neighborhoods on New Da Nang.

"So what we need you to do is deny Arvax by shutting down any access to the ship's controls from the outside by invoking the emergency protocols. That will put the ship in a state where we can board and take control of the ship. What do you say? Do you have any questions?"

Master Sergeant R. Mu Arvax's voice comes back over the radio: "You there still, Usagi? I think I lost you for a second."
[Oh no, how am I going to tell whom to trust?]

* * *

>gonear computer
Room of Stuff
This is where we keep all our stuff.

You can see Fuel injection specification, a helm, security code, mulgrew's-code, Emergency protocols, Location of the ship, Explosion, Pollux, a Space Force, Space Authority, Deneb III planet, Orion Marine Academy, Delphi Engine Controls LLC, Substance Injection, Element Copernicium, Luna Spacewerks Parsec VI, Delphi Engine Controls Aleph-Null, Operation Dalmatian, a 95th Sanitation Division, a Space Marines, Deneb sector, Deneb II, Deneb IV, Deneb System, Access key, Incommunicado Mode, rebooting the computer, New Da Nang, a separatists, a SS Usagi, a Space Station Omicron-5, Motives, and a ship computer here.

>gonear desk
(the desk drawer)
Captain's Quarters
Neat and spartan, this cabin is the very model of a small fighting ship's captain's quarters. An impeccably organized desk is against one wall, while a typically spotless bed sits beneath a portrait of this very ship. There is a data terminal on the desk. Against a third wall is the captain's one indulgence: a set of free weights neatly put away in racks. You can exit to fore.

You can see a 9kg weight, a 15kg weight, a 29kg weight, a 32kg weight, and a 50kg weight here.

⇒ You may talk to the ship computer through the data terminal. You might try "computer, help" to get help on talking to the computer.

* * *

>gonear computer terminal
Captain's Quarters
Neat and spartan, this cabin is the very model of a small fighting ship's captain's quarters. An impeccably organized desk is against one wall, while a typically spotless bed sits beneath a portrait of this very ship. There is a computer terminal on the desk. Against a third wall is the captain's one indulgence: a set of free weights neatly put away in racks. You can exit to fore.

You can see a 9kg weight, a 15kg weight, a 29kg weight, a 32kg weight, and a 50kg weight here.

⇒ You may talk to the ship computer through the computer terminal. You might try "computer, help" to get help on talking to the computer.

>computer, help
(the ship computer about the ship computer)
"This is the ship computer of the SS Usagi. For a list of helpful commands and topics, please consult the terminal."

"Helpful commands: 

 - ask computer about <subject>
 - computer, emergency protocols: activates the ship's emergency protocols
 - computer, reboot
 - computer, access code <code>

>hints
Some players may find the temptation to rely on hints overwhelming, and you may prefer to remove temptation by disabling hints for the rest of this game. If you do so, however, you will not be able to access the hints unless you restart. Do you wish to disable hints? >

* * *

>no
Okay - but if you change your mind later you can use the HINTS OFF command to disable hints.

Sorry, no hints are available at this time.

>trace
[Trace on.]

>computer, help
[Parsing for the verb 'ask' (10 lines)]
[line 0 * 'about' scope=Routine(582529) -> A84_implicit_quizzing]
[line 1 * 'for' scope=Routine(582701) -> A86_implicit_requesting]
[line 2 * creature 'for' scope=Routine(582185) -> A78_requesting_it_for]
[line 3 * creature 'about' scope=Routine(582357) -> A80_quizzing_it_about]
[line 4 * noun 'about' scope=Routine(582873) -> A80_quizzing_it_about]
[Line successfully parsed]
(the ship computer about the ship computer)
"This is the ship computer of the SS Usagi. For a list of helpful commands and topics, please consult the terminal."

"Helpful commands: 

 - ask computer about <subject>
 - computer, emergency protocols: activates the ship's emergency protocols
 - computer, reboot
 - computer, access code <code>

>trace off
[Parsing for the verb 'trace' (4 lines)]
[line 0 * -> TraceOn]
[line 1 * number -> TraceLevel]
[line 2 * 'on' -> TraceOn]
[line 3 * 'off' -> TraceOff]
[Line successfully parsed]
Trace off.

>verb
That noun did not make sense in this context.

>verbs
That noun did not make sense in this context.

>showverb help
Verb 'help' 
     * -> A94_helping
     * 'speech' -> A126_helping_with_speech
     * 'test' -> A136_helping_with_test
     * 'test' 'spoilers' -> A137_helping_with_test_spoil

>showverb ask
Verb 'ask' 
     * 'about' scope=Routine(582529) -> A84_implicit_quizzing
     * 'for' scope=Routine(582701) -> A86_implicit_requesting
     * creature 'for' scope=Routine(582185) -> A78_requesting_it_for
     * creature 'about' scope=Routine(582357) -> A80_quizzing_it_about
     * noun 'about' scope=Routine(582873) -> A80_quizzing_it_about
     * Routine(372153) Routine(609735) Routine(609778) 'computer' 'for' 'help' -> MistakeAction
     * creature 'about' topic -> Ask
     * creature 'for' topic -> A79_imploring_it_for
     * 'about' topic -> A82_implicit_asking
     * 'for' topic -> A87_implicit_imploring

>trace
[Trace on.]

* * *

>ask the computer about computer
[Parsing for the verb 'ask' (10 lines)]
[line 0 * 'about' scope=Routine(582529) -> A84_implicit_quizzing]
[line 1 * 'for' scope=Routine(582701) -> A86_implicit_requesting]
[line 2 * creature 'for' scope=Routine(582185) -> A78_requesting_it_for]
[line 3 * creature 'about' scope=Routine(582357) -> A80_quizzing_it_about]
[line 4 * noun 'about' scope=Routine(582873) -> A80_quizzing_it_about]
[Line successfully parsed]
(the ship computer about the ship computer)
"This is the ship computer of the SS Usagi. For a list of helpful commands and topics, please consult the terminal."

"Helpful commands: 

 - ask computer about <subject>
 - computer, emergency protocols: activates the ship's emergency protocols
 - computer, reboot
 - computer, access code <code>

* * *

>gonear desk
(the desk drawer)
Captain's Quarters
Neat and spartan, this cabin is the very model of a small fighting ship's captain's quarters. An impeccably organized desk is against one wall, while a typically spotless bed sits beneath a portrait of this very ship. There is a data terminal on the desk. Against a third wall is the captain's one indulgence: a set of free weights neatly put away in racks. You can exit to fore.

You can see a 9kg weight, a 15kg weight, a 29kg weight, a 32kg weight, and a 50kg weight here.

⇒ You may talk to the ship computer through the data terminal. You might try "computer, help" to get help on talking to the computer.

>computer, help
"This is the ship computer of the SS Usagi. For a list of helpful commands and topics, please consult the terminal."

"Helpful commands: 

 - ask computer about <subject>
 - computer, emergency protocols: activates the ship's emergency protocols
 - computer, reboot
 - computer, access code <code>

>computer, repeat
the ship computer said: "This is the ship computer of the SS Usagi. For a list of helpful commands and topics, please consult the terminal."

>computer, repeat all
You cannot ask the ship computer to repeat all

* * *

>purloin vac suit
[Purloined.]

>suit, help
You must activate the vac suit before asking for help.

>activate suit
BOOM activated.

>suit, help
"The following commands are available: 

 - suit, activation code <code>
 - suit, mag boots on
 - suit, mag boots off
 - suit, report status"

>suit, report status
"Suit activated. Mag boots deactivated. Oxygen level at 15 units."

* * *

>suit, help
"The following commands are available: 

 - suit, activation code <code>
 - suit, mag boots on
 - suit, mag boots off
 - suit, report status"

>purloin magazine
[Purloined.]

>purloin gadget
[Purloined.]

>put magazine in gadget
You insert the copy of Stars Magazine into the strange gadget, and the screen lights up. It looks like the copy of Stars Magazine, only translated into Standard Galactic.

The cover of Stars Magazine teases an issue full of Space Authority news exclusives, celebrity gossip, and useful space safety tips. It features a picture of a Space Marine spacewalking in a vac suit.

The galactic translator boasts a left button, a right button, and a small button next to a thin slot.

* * *

>press right button
The galactic translator flips forward a page.

Page 1 of Stars Magazine is a discussion of the political status of the separatist movement on Deneb IV. Booring.

The galactic translator boasts a left button, a right button, and a small button next to a thin slot.

>g
The galactic translator flips forward a page.

Page 2 of Stars Magazine follows the career of pop star Piscea Lycana. Not what you need to know about right now.

The galactic translator boasts a left button, a right button, and a small button next to a thin slot.

>g
The galactic translator flips forward a page.

Page 3 of Stars Magazine compares several models of personal ground-to-orbit vehicles. If only they'd come down in price...

The galactic translator boasts a left button, a right button, and a small button next to a thin slot.

* * *

>g
The galactic translator flips forward a page.

Page 5 doesn't contain much of interest, just gossip and the occasional lifestyle piece.

The galactic translator boasts a left button, a right button, and a small button next to a thin slot.

>g
The galactic translator flips forward a page.

Page 6 of Stars Magazine is a tutorial in vac suit operation for the non-technical. It details all kinds of important aspects of the suit, including: 

 - "Suit, help"
 - How to take the suit on and off.
 - How to activate the suit: "Suit, activation code <code>"
 - The automatic pressurization system.
 - How to operate the mag boots: "Suit, mag boots on", "Suit, mag boots off".
 - Monitoring suit status: "Suit, report status".
 - How to look good while wearing the vac suit.

The article strongly emphasizes that a typical vac suit does not contain a propulsion system, so care must be taken not to be spun off into deep space.

Someone has scribbled 1 in the margin of the page.

The galactic translator boasts a left button, a right button, and a small button next to a thin slot.

* * *

>report status
That's a command for a vac suit, not for a person.

>purloin vac suit
[Purloined.]

* * *

>activate suit
BOOM activated.

>suit, help
[That command asks to do something outside of play, so it can only make sense from you to me. The vac suit cannot be asked to do this.]

>vac suit, help
[That command asks to do something outside of play, so it can only make sense from you to me. The vac suit cannot be asked to do this.]

* * *

>gonear galley
(The Galley)
The Galley
This narrow space is barely enough room for two Marines to prepare and eat a meal. There is a counter with two stools, a microwave oven, and a large closet here. Pots and pans hang from hooks in the ceiling. A ladder leads up through the fore/aft door, and you can leave aft.

On the starboard wall is a panel on which is a blue button. Tacked to the panel is the operator's manual for the fore/aft door.

>open closet
You open the closet, revealing ten MREs.

>eat mre
(first taking the MRE)
Although the MRE has the advantage of being self-heating, it is unfortunately thoroughly uninspired cuisine.

You eat the MRE. Not bad.

You hear someone speaking above.

* * *

>open closet
You open the closet, revealing ten MREs.

>take mre
Taken.

You hear someone speaking above.

>eat it
You eat the MRE. Not bad.

* * *

>gonear galley
(The Galley)
The Galley
This narrow space is barely enough room for two Marines to prepare and eat a meal. There is a counter with two stools, a microwave oven, and a large closet here. Pots and pans hang from hooks in the ceiling. A ladder leads up through the fore/aft door, and you can leave aft.

On the starboard wall is a panel on which is a blue button. Tacked to the panel is the operator's manual for the fore/aft door.

>open microwave
You open the microwave oven.

>x it
You're supposed to be cleaning this microwave, but here you are. It is open.

You faintly hear someone speaking above.

* * *

>gonear galley
(The Galley)
The Galley
This narrow space is barely enough room for two Marines to prepare and eat a meal. There is a counter with two stools, a microwave oven, and a large closet here. Pots and pans hang from hooks in the ceiling. A ladder leads up through the fore/aft door, and you can leave aft.

On the starboard wall is a panel on which is a blue button. Tacked to the panel is the operator's manual for the fore/aft door.

>x ceiling
You really don't need to worry about the ceiling.

>s
You can't go that way.

>a
Crew Quarters
This is a busy junction when the ship is populated. To port and starboard are the crew bunks, aft is the door to the captain's quarters, and fore is the galley. A ladder leads down to the aft airlock.

⇒ You can ask for hints at any time by typing "hints".

BOOM -- suddenly everything goes to hell. A bulkhead seems to hurtle towards you...
pain...
confusion...
blackness...
Somehow you're okay. Inertial dampers must have kicked in. Nevertheless, you feel like you were hit by a truck.
But what happened?

Crash
An Interactive Fiction by Phil Riley
Release 4 / Serial number 220621 / Inform 7 build 6M62 (I6/v6.34 lib 6/12N) SD

[Where am I?]

* * *

>z
[What? Didn't get that. My brain is spinning too much. Try again.]

[Go away.]

>z
Somewhere? (Where?) (lying on something comfortable)
Aaa cccc mmmmmmm www aaaa'a ttt ccccccc sssss in this or the opposite-side bunk room. This one ssssss ffff in ttt ssss oo bbbbb, one on the llll aaa ooo oo ttt rrrrr, aaa dddd uu wwww mmmmmmmm ppppppppp. There is a lllll eeeeeeeee ccccccc hhhh, ssssssssss aaaaaa to the ccccccc. Ii ii cccccc.

[Everything's a bit fuzzy.]

>x ceiling
You come to your senses lying on a bunk, not quite sure how you got here. You seem to have lost your equipment.

Port-Side Bunks (on the right bottom bunk)
[Okay, now things are coming into focus.]

All crew members who aren't the captain sleep in this or the opposite-side bunk room. This one sleeps four in two sets of bunks, one on the left and one on the right, all done up with military precision. There is a large locker here, stretching almost to the ceiling. It is closed. The sole exit is to starboard.

Something is affixed to the wall by the top left bunk.

A leather wallet lies discarded on the ground.

On the right top bunk is an extendable dusting device [that's mine].

You can also see a sonic decontaminator [also mine] here.

On the right bottom bunk you can see a hand-held micro-compressing vacuum cleaner [mine again. I really took a tumble.].

[Ohh my head hurts. What the heck happened? Better get back to the station pronto.]

>x ceiling
You really don't need to worry about the ceiling hook.

>actions
Actions listing on.

>x ceiling
[examining the ceiling hook]
You really don't need to worry about the ceiling hook.
[examining the ceiling hook - failed]

>x the ceiling
[examining the ceiling hook]
You really don't need to worry about the ceiling hook.
[examining the ceiling hook - failed]

* * *

>x ceiling
You really don't need to worry about the ceiling.

>take pot
Taken.

Apparently one of the hooks is loose. You jostle it while taking the skillet, and it falls out of the ceiling to the floor.

You faintly hear someone speaking above.

>x ceiling
(the ceiling hook)
The ceiling hook has a very long, pointy screw end.

>x ceiling galley
You really don't need to worry about the ceiling.

You faintly hear someone speaking above.

>take hook
Taken.

* * *

>gonear galley
(The Galley)
The Galley
This narrow space is barely enough room for two Marines to prepare and eat a meal. There is a counter with two stools, a microwave oven, and a large closet here. Pots and pans hang from hooks in the ceiling. A ladder leads up through the fore/aft door, and you can leave aft.

On the starboard wall is a panel on which is a blue button. Tacked to the panel is the operator's manual for the fore/aft door.

>z
Time passes.

>z
Time passes.

You faintly hear someone speaking above.

>u
(first opening the Fore/Aft Door)
You can't open that with your bare hands.

>gonear operations
(the door operations manual)
The Galley
This narrow space is barely enough room for two Marines to prepare and eat a meal. There is a counter with two stools, a microwave oven, and a large closet here. Pots and pans hang from hooks in the ceiling. A ladder leads up through the fore/aft door, and you can leave aft.

On the starboard wall is a panel on which is a blue button. Tacked to the panel is the operator's manual for the fore/aft door.

You faintly hear someone speaking above.

>gonear communications
Operations
This is where all of the support activity for the bridge occurs. There are large consoles for environmental controls, communications, and power systems here. The bridge continues forward from here, and engineering is aft. There is a door set in the floor with a ladder leading through it. Set in the frame of the door is a blue button.

A large equipment trunk lies on the Fore/Aft door, blocking it.

>z
Time passes.

A man's voice comes over comms: "Usagi, are you there?"

[Finally, another person! I'm saved!]

⇒ By the way... you can get help about speaking to other characters by typing "help speech".

>help speech
There are a few commands that allow you to talk to other characters you meet. These are: 

 - hello: to start talking to someone.
 - ask <someone> about <something>: ask the character to tell you what it knows about a thing.
 - goodbye: to stop talking to someone.
 - tell <someone> about <something>: tell the character what you know about a thing.
 - yes
 - no

Note: you cannot talk or ask about a subject with which you are unfamiliar. Thus you cannot get an answer to "ask Frank about Sophie" unless you are aware of Sophie's existence.

To ask a person or thing to do something use the following pattern: "<name>, <action>", for instance, "computer, help."

One useful command is "<name>, repeat", which will cause the named person or thing to repeat the last thing they said, if anything.

>caller, hello
You call out "Yes! I'm here! I'm here! What's going on?"

The caller responds, "Ahoy there, SS Usagi, good to hear from you. Seems like you're a bit out of sorts, and we'd like to help you out. But before we get into that, who am I speaking to? Tell me about yourself."

* * *

>gonear onepass
Starboard-Side Bunks
All crew members who aren't the captain sleep in this or the opposite-side bunk room. This one sleeps four in two sets of bunks, one on the left and one on the right, all done up with military precision. There is a large locker here, stretching almost to the ceiling. It is closed. The sole exit is to port.

On the left bottom bunk is a OnePass.

A copy of Stars Magazine is just peeking from underneath the left bottom bunk.

>pronouns
At the moment, "it" means the copy of Stars Magazine, "him" is unset, "her" is unset, and "them" is unset.

>x onepass
Insert your cards in this part here, and swipe this part just like a card! 

[These things are great. You just put all your access cards in it, and then use it as a card instead.]

>take it
Taken.

>i
You are carrying:
  an OnePass
  a maintenance crew access card
  a sonic decontaminator
  a hand-held micro-compressing vacuum cleaner
  an extendable dusting device
  a military sanitation uniform (being worn)

* * *

>take it
[Not my kind of reading, actually, but what the heck.]Taken.

>x it
The cover features a picture of a Space Marine spacewalking in a vac suit. You page through the inside, but it's all in a language you don't recognize.

>take onepass
Taken.

>i
You are carrying:
  an OnePass
  a copy of Stars Magazine
  a maintenance crew access card
  a sonic decontaminator
  a hand-held micro-compressing vacuum cleaner
  an extendable dusting device
  a military sanitation uniform (being worn)

>x it
Insert your cards in this part here, and swipe this part just like a card! [These things are great. You just put all your access cards in it, and then use it as a card instead.]

* * *

>gonear onepass
Starboard-Side Bunks
All crew members who aren't the captain sleep in this or the opposite-side bunk room. This one sleeps four in two sets of bunks, one on the left and one on the right, all done up with military precision. There is a large locker here, stretching almost to the ceiling. It is closed. The sole exit is to port.

On the left bottom bunk is a OnePass.

A copy of Stars Magazine is just peeking from underneath the left bottom bunk.

>take onepass
Taken.

>i
You are carrying:
  a OnePass
  a maintenance crew access card
  a sonic decontaminator
  a hand-held micro-compressing vacuum cleaner
  an extendable dusting device
  a military sanitation uniform (being worn)

* * *

>slide onepass in slot
You can't see any such thing.

>trace 2
[Parser tracing set to level 2.]

>slide onepass in slot
[ "slide" slide / "onepass" onepass / "in" in / "slot" slot ]
[Parsing for the verb 'slide' (3 lines)]

[line 0 * noun=Routine(603816) 'through' / 'in' noun=Routine(603863) -> A111_sliding_it_through]
 [line 0 token 1 word 2 : noun=Routine(603816)]

[line 1 * noun=Routine(603900) 'through' / 'in' noun=Routine(603947) -> A111_sliding_it_through]
 [line 1 token 1 word 2 : noun=Routine(603900)]

[line 2 * noun=Routine(603742) 'through' / 'in' noun=Routine(603779) -> A111_sliding_it_through]
 [line 2 token 1 word 2 : noun=Routine(603742)]
You can't see any such thing.

>slide 3
[ "slide" slide / "3" 3 ]
[Parsing for the verb 'slide' (3 lines)]

[line 0 * noun=Routine(603816) 'through' / 'in' noun=Routine(603863) -> A111_sliding_it_through]
 [line 0 token 1 word 2 : noun=Routine(603816)]

[line 1 * noun=Routine(603900) 'through' / 'in' noun=Routine(603947) -> A111_sliding_it_through]
 [line 1 token 1 word 2 : noun=Routine(603900)]

[line 2 * noun=Routine(603742) 'through' / 'in' noun=Routine(603779) -> A111_sliding_it_through]
 [line 2 token 1 word 2 : noun=Routine(603742)]
You can't see any such thing.

>slide onepass in slot
[ "slide" slide / "onepass" onepass / "in" in / "slot" slot ]
[Parsing for the verb 'slide' (3 lines)]

[line 0 * noun=Routine(603816) 'through' / 'in' noun=Routine(603863) -> A111_sliding_it_through]
 [line 0 token 1 word 2 : noun=Routine(603816)]

[line 1 * noun=Routine(603900) 'through' / 'in' noun=Routine(603947) -> A111_sliding_it_through]
 [line 1 token 1 word 2 : noun=Routine(603900)]

[line 2 * noun=Routine(603742) 'through' / 'in' noun=Routine(603779) -> A111_sliding_it_through]
 [line 2 token 1 word 2 : noun=Routine(603742)]
You can't see any such thing.

>trace 4
[ "trace" trace / "4" 4 ]
[Parsing for the verb 'trace' (4 lines)]

[line 0 * -> TraceOn]
 [line 0 token 1 word 2 : END]

[line 1 * number -> TraceLevel]
 [line 1 token 1 word 2 : number]
 [line 1 token 2 word 3 : END]
[Line successfully parsed]
[Parser tracing set to level 4.]

>slide onepass in slot
[ "slide" slide / "onepass" onepass / "in" in / "slot" slot ]
[Parsing for the verb 'slide' (3 lines)]

[line 0 * noun=Routine(603816) 'through' / 'in' noun=Routine(603863) -> A111_sliding_it_through]
 [line 0 token 1 word 2 : noun=Routine(603816)]
  [Object list from word 2]
  [Calling NounDomain on location and actor]
   [NounDomain called at word 2
   seeking definite object
   [ND made 0 matches]
  [token resulted in failure with error type 5]

[line 1 * noun=Routine(603900) 'through' / 'in' noun=Routine(603947) -> A111_sliding_it_through]
 [line 1 token 1 word 2 : noun=Routine(603900)]
  [Object list from word 2]
  [Calling NounDomain on location and actor]
   [NounDomain called at word 2
   seeking definite object
   [ND made 0 matches]
  [token resulted in failure with error type 5]

[line 2 * noun=Routine(603742) 'through' / 'in' noun=Routine(603779) -> A111_sliding_it_through]
 [line 2 token 1 word 2 : noun=Routine(603742)]
  [Object list from word 2]
  [Calling NounDomain on location and actor]
   [NounDomain called at word 2
   seeking definite object
   [ND made 0 matches]
  [token resulted in failure with error type 5]
You can't see any such thing.

>x slot
[ "x" x / "slot" slot ]
[Parsing for the verb 'x' (1 lines)]

[line 0 * noun -> Examine]
 [line 0 token 1 word 2 : noun]
  [Object list from word 2]
  [Calling NounDomain on location and actor]
   [NounDomain called at word 2
   seeking definite object
Parse_name called
Pass 1: 0 Pass 2: 0 Pass 3: 0
Parse_name called
Pass 1: 0 Pass 2: 0 Pass 3: 0
Parse_name called
Pass 1: 0 Pass 2: 0 Pass 3: 0
Parse_name called
Pass 1: 0 Pass 2: 0 Pass 3: 0
Parse_name called
Pass 1: 0 Pass 2: 0 Pass 3: 0
Parse_name called
Pass 1: 0 Pass 2: 0 Pass 3: 0
Parse_name called
Pass 1: 0 Pass 2: 0 Pass 3: 0
Parse_name called
Pass 1: 0 Pass 2: 0 Pass 3: 0
Parse_name called
Pass 1: 0 Pass 2: 0 Pass 3: 0
Parse_name called
Pass 1: 0 Pass 2: 0 Pass 3: 0
Parse_name called
Pass 1: 0 Pass 2: 0 Pass 3: 0
Parse_name called
Pass 1: 0 Pass 2: 0 Pass 3: 0
Parse_name called
Pass 1: 0 Pass 2: 0 Pass 3: 0
Parse_name called
Pass 1: 0 Pass 2: 0 Pass 3: 0
Parse_name called
Pass 1: 0 Pass 2: 0 Pass 3: 0
Parse_name called
Pass 1: 0 Pass 2: 0 Pass 3: 0
Parse_name called
Pass 1: 0 Pass 2: 0 Pass 3: 0
Parse_name called
Pass 1: 0 Pass 2: 0 Pass 3: 0
Parse_name called
Pass 1: 0 Pass 2: 0 Pass 3: 0
Parse_name called
Pass 1: 0 Pass 2: 0 Pass 3: 0
Parse_name called
Pass 1: 0 Pass 2: 0 Pass 3: 0
Parse_name called
Pass 1: 0 Pass 2: 0 Pass 3: 0
   [ND made 1 matches]
  [ND returned the starboard-side equipment locker's slot]
  [token resulted in success]
 [line 0 token 2 word 3 : END]
[Line successfully parsed]

It is a typical card slot, as you might find on a starship door.

>trace off
[ "trace" trace / "off" off ]
[Parsing for the verb 'trace' (4 lines)]

[line 0 * -> TraceOn]
 [line 0 token 1 word 2 : END]

[line 1 * number -> TraceLevel]
 [line 1 token 1 word 2 : number]
  [token resulted in failure with error type 3]

[line 2 * 'on' -> TraceOn]
[line rejected for not ending with correct preposition]

[line 3 * 'off' -> TraceOff]
 [line 3 token 1 word 2 : 'off']
  [token resulted in success]
 [line 3 token 2 word 3 : END]
[Line successfully parsed]
Trace off.

I beg your pardon?

>x onepass
Insert your cards in this part here, and swipe this part just like a card! 

[These things are great. You just put all your access cards in it, and then use it as a card instead.]

A little readout on the side of the OnePass lists the cards stored: the military ID card.

>slide onepass in slot
You can't see any such thing.

>put onepass in slot
That can't contain things.

* * *

>gonear onepass
Starboard-Side Bunks
All crew members who aren't the captain sleep in this or the opposite-side bunk room. This one sleeps four in two sets of bunks, one on the left and one on the right, all done up with military precision. There is a large locker here, stretching almost to the ceiling. It is closed. The sole exit is to port.

On the left bottom bunk is a OnePass.

A copy of Stars Magazine is just peeking from underneath the left bottom bunk.

>test onepass
(Testing.)

>[1] gonear onepass
Starboard-Side Bunks
All crew members who aren't the captain sleep in this or the opposite-side bunk room. This one sleeps four in two sets of bunks, one on the left and one on the right, all done up with military precision. There is a large locker here, stretching almost to the ceiling. It is closed. The sole exit is to port.

On the left bottom bunk is a OnePass.

A copy of Stars Magazine is just peeking from underneath the left bottom bunk.

>[2] take onepass
Taken.

>[3] slide onepass in slot
A light on the locker flashes red.

>[4] purloin id
(the military ID card)
[Purloined.]

>[5] put id in onepass
>[6] slide onepass in slot

* * *

>gonear port-side bunks
Port-Side Bunks
All crew members who aren't the captain sleep in this or the opposite-side bunk room. This one sleeps four in two sets of bunks, one on the left and one on the right, all done up with military precision. There is a large locker here, stretching almost to the ceiling. It is closed. The sole exit is to starboard.

Something is affixed to the wall by the top left bunk.

A leather wallet lies on the left bottom bunk.

[Okay now, back to the station -- let's see, I'm in Port-Side Bunks, so I need to go starboard and then down...]

>x ceiling
You really don't need to worry about the room ceiling.

>take it
You really don't need to worry about the ceiling.

>s
Crew Quarters
This is a busy junction when the ship is populated. To port and starboard are the crew bunks, aft is the door to the captain's quarters, and fore is the galley. A ladder leads down to the aft airlock.

⇒ You can ask for hints at any time by typing "hints".

BOOM -- suddenly everything goes to hell. A bulkhead seems to hurtle towards you...
pain...
confusion...
blackness...
Somehow you're okay. Inertial dampers must have kicked in. Nevertheless, you feel like you were hit by a truck.
But what happened?

Crash
An Interactive Fiction by Phil Riley
Release 4 / Serial number 220620 / Inform 7 build 6M62 (I6/v6.34 lib 6/12N) SD

[Where am I?]

>z
[What? Didn't get that. My brain is spinning too much. Try again.]

* * *

>get up
You get off the right bottom bunk.

Port-Side Bunks
All crew members who aren't the captain sleep in this or the opposite-side bunk room. This one sleeps four in two sets of bunks, one on the left and one on the right, all done up with military precision. There is a large locker here, stretching almost to the ceiling. It is closed. The sole exit is to starboard.

Something is affixed to the wall by the top left bunk.

A leather wallet lies discarded on the ground.

On the right bottom bunk is a hand-held micro-compressing vacuum cleaner.

On the right top bunk is an extendable dusting device.

You can also see a sonic decontaminator here.

[Standing up makes me a little dizzy, oh my.]

>s
Crew Quarters
This is a busy junction when the ship is populated. To port and starboard are the crew bunks, aft is the door to the captain's quarters, and fore is the galley. A ladder leads down to the aft airlock.

* * *

>gonear starboard-side
Which do you mean, starboard, Starboard Engine Chamber, the main starboard engine, Starboard-Side Bunks, the left bottom bunk, the left top bunk, the right bottom bunk, the right top bunk, the starboard-side equipment locker, the starboard-side equipment locker's slot, or the starboard-side equipment locker's keyhole?

>bunks
Starboard-Side Bunks
All crew members who aren't the captain sleep in this or the opposite-side bunk room. This one sleeps four in two sets of bunks, one on the left and one on the right, all done up with military precision. There is a large locker here, stretching almost to the ceiling. It is closed. The sole exit is to port.

On the left bottom bunk is a OnePass.

A copy of Stars Magazine is just peeking from underneath the left bottom bunk.

>take onepass
Taken.

* * *

>x onepass
Insert your cards in this part here, and swipe this part just like a card! 

[These things are great. You just put all your access cards in it, and then use it as a card instead.]

A little readout on the side of the OnePass lists the cards stored: the maintenance crew access card.

>undo
Starboard-Side Bunks
[Previous turn undone.]

>undo
Starboard-Side Bunks
[Previous turn undone.]

>x onepass
Insert your cards in this part here, and swipe this part just like a card! 

[These things are great. You just put all your access cards in it, and then use it as a card instead.]

A little readout on the side of the OnePass says "No cards stored."

* * *

>purloin id
(the military ID card)
[Purloined.]

* * *

>x onepass
Insert your cards in this part here, and swipe this part just like a card! 

[These things are great. You just put all your access cards in it, and then use it as a card instead.]

A little readout on the side of the OnePass lists the cards stored: the maintenance crew access card and the military ID card.

>[
That noun did not make sense in this context.

>p
Crew Quarters
This is a busy junction when the ship is populated. To port and starboard are the crew bunks, aft is the door to the captain's quarters, and fore is the galley. A ladder leads down to the aft airlock.

⇒ You can ask for hints at any time by typing "hints".

BOOM -- suddenly everything goes to hell. A bulkhead seems to hurtle towards you...
pain...
confusion...
blackness...
Somehow you're okay. Inertial dampers must have kicked in. Nevertheless, you feel like you were hit by a truck.
But what happened?

Crash
An Interactive Fiction by Phil Riley
Release 4 / Serial number 220621 / Inform 7 build 6M62 (I6/v6.34 lib 6/12N) SD

[Where am I?]

>p
[What? Didn't get that. My brain is spinning too much. Try again.]

>z
Somewhere? (Where?) (lying on something comfortable)
Aaa cccc mmmmmmm www aaaa'a ttt ccccccc sssss in this or the opposite-side bunk room. This one ssssss ffff in ttt ssss oo bbbbb, one on the llll aaa ooo oo ttt rrrrr, aaa dddd uu wwww mmmmmmmm ppppppppp. There is a lllll eeeeeeeee ccccccc hhhh, ssssssssss aaaaaa to the ccccccc. Ii ii cccccc.

[Everything's a bit fuzzy.]

* * *

>z
Time passes.

>get up
You get off the right bottom bunk.

Port-Side Bunks
All crew members who aren't the captain sleep in this or the opposite-side bunk room. This one sleeps four in two sets of bunks, one on the left and one on the right, all done up with military precision. There is a large locker here, stretching almost to the ceiling. It is closed. The sole exit is to starboard.

Something is affixed to the wall by the top left bunk.

A leather wallet lies discarded on the ground.

On the right bottom bunk is a hand-held micro-compressing vacuum cleaner.

On the right top bunk is an extendable dusting device.

You can also see a sonic decontaminator here.

[Standing up makes me a little dizzy, oh my.]

[Okay now, back to the station -- let's see, I'm in Port-Side Bunks, so I need to go starboard and then down...]

>slide onepass through slot
A light on the locker flashes red.

* * *

>bunks
Starboard-Side Bunks
All crew members who aren't the captain sleep in this or the opposite-side bunk room. This one sleeps four in two sets of bunks, one on the left and one on the right, all done up with military precision. There is a large locker here, stretching almost to the ceiling. It is closed. The sole exit is to port.

On the left bottom bunk is a OnePass.

A copy of Stars Magazine is just peeking from underneath the left bottom bunk.

>x ceiling
You really don't need to worry about the ceiling.

>p
Crew Quarters
This is a busy junction when the ship is populated. To port and starboard are the crew bunks, aft is the door to the captain's quarters, and fore is the galley. A ladder leads down to the aft airlock.

⇒ You can ask for hints at any time by typing "hints".

BOOM -- suddenly everything goes to hell. A bulkhead seems to hurtle towards you...
pain...
confusion...
blackness...
Somehow you're okay. Inertial dampers must have kicked in. Nevertheless, you feel like you were hit by a truck.
But what happened?

Crash
An Interactive Fiction by Phil Riley
Release 4 / Serial number 220620 / Inform 7 build 6M62 (I6/v6.34 lib 6/12N) SD

[Where am I?]

>z
[What? Didn't get that. My brain is spinning too much. Try again.]

* * *

>gonear terminal
Captain's Quarters
Neat and spartan, this cabin is the very model of a small fighting ship's captain's quarters. An impeccably organized desk is against one wall, while a typically spotless bed sits beneath a portrait of this very ship. There is a data terminal on the desk. Against a third wall is the captain's one indulgence: a set of free weights neatly put away in racks. You can exit to fore.

You can see a 9kg weight, a 15kg weight, a 29kg weight, a 32kg weight, and a 50kg weight here.

⇒ You may talk to the ship computer through the data terminal. You might try "computer, help" to get help on talking to the computer.

>ask computer about food
"I'm unable to give you any information about food."

>ask computer about card
(the ship computer about the maintenance crew access card)
"I'm unable to give you any information about the maintenance crew access card."

* * *

>ask computer about food
"I'm unable to give you any information about food."

>ask terminal about card
Ask the computer instead.

* * *

>ask computer about food
"I'm unable to give you any information about food."

>rules
Rules tracing now switched on. Type "rules off" to switch it off again, or "rules all" to include even rules which do not apply.

>ask computer about food
[Rule "redirect to GEP line input rule" applies.]
[Rule "After reading a command" applies.]
[Rule "After deciding the scope of the player when the location is the captain's quarters" applies.]
[Rule "After deciding the scope of the player when the location is the captain's quarters" applies.]
[Rule "After deciding the scope of the player when the location is the captain's quarters" applies.]
[Rule "After deciding the scope of the player when the location is the captain's quarters" applies.]
(the ship computer about that)
[Rule "declare everything initially unmentioned rule" applies.]
[Rule "announce items from multiple object lists rule" applies.]
[Rule "set pronouns from items from multiple object lists rule" applies.]
[Rule "before stage rule" applies.]
[Rule "Before doing something to the ship computer" applies.]
[Rule "reaching inside the room of stuff rule" applies.]
[Rule "instead stage rule" applies.]
[Rule "investigate player's awareness before action rule" applies.]
[Rule "player aware of his own actions rule" applies.]
[Rule "check stage rule" applies.]
[Rule "carry out stage rule" applies.]
[Rule "after stage rule" applies.]
[Rule "After asking ship computer about a topic when location is captain's quarters" applies.]
"I'm unable to give you any information about food."

[Rule "A first turn sequence rule" applies.]
[Rule "every turn stage rule" applies.]
[Rule "Every turn when not talking about asking mulgrew questions" applies.]
[Rule "For asking for attention by Arvax while current conversation state is making contact" applies.]
[Rule "reset protocol rule" applies.]
[Rule "close open doors rule" applies.]
[Rule "deactivate equipment cabinets rule" applies.]
[Rule "A last turn sequence rule" applies.]
[Rule "notify score changes rule" applies.]

>touch usagi
[Rule "redirect to GEP line input rule" applies.]
[Rule "After reading a command" applies.]
[Rule "After deciding the scope of the player when the location is the captain's quarters" applies.]
You can't see any such thing.

>rules off
[Rule "redirect to GEP line input rule" applies.]
[Rule "After reading a command" applies.]
[Rule "declare everything initially unmentioned rule" applies.]
Rules tracing now switched off. Type "rules" to switch it on again.

* * *

>ask computer about ship
(the SS Usagi)
"Displaying available information on the SS Usagi."

The data terminal displays a screen of text:

"The SS Usagi is a light frigate in the Deneb system, with a crew of nine including the captain. It is currently helmed by Captain Jane Mulgrew. The ship's main drive is a Luna Spacewerks Parsec VI."

>ask computer about portrait
"I'm unable to give you any information about the portrait of the ship."

>ask computer about mulgrew
"Displaying available information on Captain Jane Mulgrew."

The data terminal displays a screen of text:

"Captain Mulgrew is one of the most decorated captains in the Deneb sector. She was the second-youngest graduate of the Orion Marine Academy. She received command of the SS Usagi after successfully leading the retaking of the capital of Pollux VI from Irion invaders from the moon of Pollux III."

* * *

>ask computer about ship
(the SS Usagi)
"Displaying available information on the SS Usagi."

The data terminal displays a screen of text:

"The SS Usagi is a light frigate in the Deneb system, with a crew of nine including the captain. It is currently helmed by Captain Jane Mulgrew. The ship's main drive is a Luna Spacewerks Parsec VI."

>ask computer about ss usagi
"Displaying available information on the SS Usagi."

The data terminal displays a screen of text:

"The SS Usagi is a light frigate in the Deneb system, with a crew of nine including the captain. It is currently helmed by Captain Jane Mulgrew. The ship's main drive is a Luna Spacewerks Parsec VI."

>ask computer about ship
(the portrait of the ship)
"I'm unable to give you any information about the portrait of the ship."

* * *

>ask computer about soup
(the ship computer about that)
"I'm unable to give you any information about soup."

>ask computer about card
(the ship computer about the maintenance crew access card)
"I'm unable to give you any information about the maintenance crew access card."

>ask ship about coup
(the ship computer about that)
"I'm unable to give you any information about coup."

>ask ship computer about soup
"I'm unable to give you any information about soup."

>ask ship computer about card
"I'm unable to give you any information about the maintenance crew access card."

* * *

>ask terminal about card
Talking to the computer terminal is unlikely to prove rewarding.

* * *

>ask terminal about food
Ask the ship computer instead

* * *

>ask terminal about soup
That noun did not make sense in this context.

>ask computer about soup
(the ship computer about that)
"I'm unable to give you any information about soup."

* * *

>ask terminal about soup
That noun did not make sense in this context.

>ask terminal about card
Ask the computer instead.

>ask computer about card
"I'm unable to give you any information about the maintenance crew access card."

>rules
Rules tracing now switched on. Type "rules off" to switch it off again, or "rules all" to include even rules which do not apply.

>ask terminal about soup
[Rule "redirect to GEP line input rule" applies.]
[Rule "After reading a command" applies.]
[Rule "After deciding the scope of the player when the location is the captain's quarters" applies.]
[Rule "After deciding the scope of the player when the location is the captain's quarters" applies.]
[Rule "After deciding the scope of the player when the location is the captain's quarters" applies.]
[Rule "After deciding the scope of the player when the location is the captain's quarters" applies.]
[Rule "After deciding the scope of the player when the location is the captain's quarters" applies.]
That noun did not make sense in this context.

>actions
[Rule "redirect to GEP line input rule" applies.]
[Rule "After reading a command" applies.]
[Rule "declare everything initially unmentioned rule" applies.]
Actions listing on.

>ask terminal about soup
[Rule "redirect to GEP line input rule" applies.]
[Rule "After reading a command" applies.]
[Rule "After deciding the scope of the player when the location is the captain's quarters" applies.]
[Rule "After deciding the scope of the player when the location is the captain's quarters" applies.]
[Rule "After deciding the scope of the player when the location is the captain's quarters" applies.]
[Rule "After deciding the scope of the player when the location is the captain's quarters" applies.]
[Rule "After deciding the scope of the player when the location is the captain's quarters" applies.]
That noun did not make sense in this context.

>ask terminal
[Rule "redirect to GEP line input rule" applies.]
[Rule "After reading a command" applies.]
[Rule "declare everything initially unmentioned rule" applies.]
ask the ship computer instead

* * *

>computer, help
"This is the ship computer of the SS Usagi. For a list of helpful commands and topics, please consult the terminal."

"Helpful commands: 

 - ask computer about <subject>
 - computer, emergency protocols: activates the ship's emergency protocols
 - computer, reboot
 - computer, access code <code>

>computer, help
"This is the ship computer of the SS Usagi. For a list of helpful commands and topics, please consult the terminal."

"Helpful commands: 

 - ask computer about <subject>
 - computer, emergency protocols: activates the ship's emergency protocols
 - computer, reboot
 - computer, access code <code>

* * *

>computer, repeat
the ship computer said: "This is the ship computer of the SS Usagi. For a list of helpful commands and topics, please consult the terminal."

>computer, repeat all
*** Run-time problem P10: Since the ship computer is not allowed the property "speech transcript", it is against the rules to try to use it.

The ship computer has nothing to repeat.

* * *

>help
Welcome to Crash by Phil Riley. There are a few things about this game you may want to be aware of.

Text adventures (also known as interactive fiction) have a number of conventions and common commands. Some are:

Move by entering the direction you want to travel. You can use abbreviations, such as "n" for "north" and "u" for "up". 

 - look (or l): prints a description of your surroundings.
 - take <something>: moves something from your surroundings to your person.
 - drop <something>: opposite of take.
 - sit on <something>, get up: what they sound like.
 - examine <something> (or x): get a more detailed description (sometimes) of something.
 - unlock <something> with <something>, open <something>
 - press <a button>
 - inventory (or i): list what the player is carrying.
 - wait (or z): pass one turn doing nothing.

If there's something else you'd like to try, type it in and see what happens!

You can ask for hints at any time by typing "hints". Note that the available hints will vary from time to time, and there may not be any hints available when you ask.

There are a few ways in which this game differs from many text adventures:

First, we use nautical directions: fore, aft, port, starboard, up, down, in, and out. ("f", "a", "p", "s", "u", "d", "in", and "out")

Fore is the direction towards the front of the ship, that is, the usual direction of travel. Aft is the opposite of fore. Port is the direction to your left when you're facing fore. Starboard is the opposite of port. You can remember port from starboard by remembering that "port" and "left" have the same number of letters.

Up and down are relative to the shipboard artificial gravity. This gravity doesn't extend beyond the hull. Instead, outside we have the radial directions in (toward the center of mass of the ship) and out (away from the center of mass).

Second, two new commands: 

 - clean <something> or dust <something>: you're a cleaner, you need to be able to clean.
 - slide <something> through <a card slot>: some of the doors in the game require access cards.

To turn on accessibility features, use "accessible on". To turn them off again, use "accessible off".

You can also get help talking to other characters with "help speech".
 
And finally, [text that looks like this] is the main character's, i.e., your, thoughts.

>accessible on
Accessibility on.

>accessible on
Accessibility on.

>accessible off
Accessibility off.

>accessible off
Accessibility off.

* * *

>accessible on
Accessibility on.

>help
Welcome to Crash by Phil Riley. There are a few things about this game you may want to be aware of.

Text adventures (also known as interactive fiction) have a number of conventions and common commands. Some are:

Move by entering the direction you want to travel. You can use abbreviations, such as "n" for "north" and "u" for "up". 

 - look (or l): prints a description of your surroundings.
 - take <something>: moves something from your surroundings to your person.
 - drop <something>: opposite of take.
 - sit on <something>, get up: what they sound like.
 - examine <something> (or x): get a more detailed description (sometimes) of something.
 - unlock <something> with <something>, open <something>
 - press <a button>
 - inventory (or i): list what the player is carrying.
 - wait (or z): pass one turn doing nothing.

If there's something else you'd like to try, type it in and see what happens!

You can ask for hints at any time by typing "hints". Note that the available hints will vary from time to time, and there may not be any hints available when you ask.

There are a few ways in which this game differs from many text adventures:

First, we use nautical directions: fore, aft, port, starboard, up, down, in, and out. ("f", "a", "p", "s", "u", "d", "in", and "out")

Fore is the direction towards the front of the ship, that is, the usual direction of travel. Aft is the opposite of fore. Port is the direction to your left when you're facing fore. Starboard is the opposite of port. You can remember port from starboard by remembering that "port" and "left" have the same number of letters.

Up and down are relative to the shipboard artificial gravity. This gravity doesn't extend beyond the hull. Instead, outside we have the radial directions in (toward the center of mass of the ship) and out (away from the center of mass).

Second, two new commands: 

 - clean <something> or dust <something>: you're a cleaner, you need to be able to clean.
 - slide <something> through <a card slot>: some of the doors in the game require access cards.

To turn on accessibility features, use "accessible on". To turn them off again, use "accessible off".

You can also get help talking to other characters with "help speech".

>help speech
There are a few commands that allow you to talk to other characters you meet. These are: 

 - hello: to start talking to someone.
 - ask <someone> about <something>: ask the character to tell you what it knows about a thing.
 - goodbye: to stop talking to someone.
 - tell <someone> about <something>: tell the character what you know about a thing.
 - yes
 - no

Note: you cannot talk or ask about a subject with which you are unfamiliar. Thus you cannot get an answer to "ask Frank about Sophie" unless you are aware of Sophie's existence.

To ask a person or thing to do something use the following pattern: "<name>, <action>", for instance, "computer, help."

One useful command is "<name>, repeat", which will cause the named person or thing to repeat the last thing they said, if anything.

* * *

>rebooted
Captain's Quarters
Neat and spartan, this cabin is the very model of a small fighting ship's captain's quarters. An impeccably organized desk is against one wall, while a typically spotless bed sits beneath a portrait of this very ship. There is a data terminal on the desk. Against a third wall is the captain's one indulgence: a set of free weights neatly put away in racks. You can exit to fore.

You can see a 9kg weight, a 15kg weight, a 29kg weight, a 32kg weight, and a 50kg weight here.

⇒ You may talk to the ship computer through the data terminal. You might try "computer, help" to get help on talking to the computer.

>f
The Captain's door opens as you approach, and closes silently behind you.

Crew Quarters
This is a busy junction when the ship is populated. To port and starboard are the crew bunks, aft is the door to the captain's quarters, and fore is the galley. A ladder leads down to the aft airlock.

⇒ You can ask for hints at any time by typing "hints".

>f
The Galley
This narrow space is barely enough room for two Marines to prepare and eat a meal. There is a counter with two stools, a microwave oven, and a large closet here. Pots and pans hang from hooks in the ceiling. A ladder leads up through the fore/aft door, and you can leave aft.

On the starboard wall is a panel on which is a blue button. Tacked to the panel is the operator's manual for the fore/aft door.

You hear someone speaking above.

>u
Operations
This is where all of the support activity for the bridge occurs. There are large consoles for environmental controls, communications, and power systems here. The bridge continues forward from here, and engineering is aft. There is a door set in the floor with a ladder leading through it. Set in the frame of the door is a blue button.

A large equipment trunk lies on the Fore/Aft door, blocking it.

You can also see an extendable dusting device, a hand-held micro-compressing vacuum cleaner, a sonic decontaminator, and a maintenance crew access card here.

>a
Engineering Deck
The engineering crew is responsible for keeping the physical ship operating. They are in charge of every physical aspect of the ship, from the engines to hull integrity to the life support system.

The engineering deck consists of a large console giving a comprehensive view of the physical status of the ship. There is an airlock to starboard. The operations deck continues forward from here, and there are other exits to aft and port.

Near the console is a large cabinet with a card slot. It is closed.

On your right is a control panel for the airlock. It consists of a green button to pressurize the airlock chamber, a yellow button to depressurize it, a red button to open and close the inner airlock door, and a blue button to open and close the outer airlock door.

The engineering airlock inner door is closed.

A device labeled "Suit Recharging Station" is here. It is shaped like a chair with nozzles protruding from either arm.

You hear someone speaking forward of here.

>a
Engine Room
Though no engines are actually in this room, it is where the combustion process is controlled. Monitoring electronics and controls cover the walls. A wide doorway opens forward to the Engineering Deck, and small portals to port and starboard provide access to the two engine chambers. The main engine, which drives the two side engines, is beyond the aft wall.

There is a large diagram of the fuel injection process on the aft wall. There is a large button below the diagram labeled "Test".

>a
You can't go that way.

>s
Starboard Engine Chamber
This is where the the combustion of the main engine is converted into forward thrust. The engine, ten feet in diameter, is quiet now, and you'd prefer not to be here when it is on.

The engine is tilting to the left, just a fraction of an inch.
⇒ You can say "put 9kg on right" or "put 15kg on left".

>purloin weights
[Purloined.]
[Purloined.]
[Purloined.]
[Purloined.]
[Purloined.]

>put 50kg on right
You put the 50kg weight on the right mount.

The left mount of the engine holds: nothing, for a mass of 0.0kg.
The right mount of the engine holds: the 50kg weight, for a mass of 50.0kg.
The engine is tilting to the right.

>put take 50kg
You can't see any such thing.

>take 50kg
You can't carry that much weight.

>set gravity to 1
You got it. Physics has been changed at your whim.

>take 50kg
Taken.

>put 50kg on left
You put the 50kg weight on the left mount.

The left mount of the engine holds: the 50kg weight, for a mass of 50.0kg.
The right mount of the engine holds: nothing, for a mass of 0.0kg.
The engine is tilting to the left.

>put 15kg on left
You put the 15kg weight on the left mount.

The left mount of the engine holds: the 15kg weight and the 50kg weight, for a mass of 65.0kg.
The right mount of the engine holds: nothing, for a mass of 0.0kg.
The engine is tilting to the left.

>put 29kg on right
You put the 29kg weight on the right mount.

The left mount of the engine holds: the 15kg weight and the 50kg weight, for a mass of 65.0kg.
The right mount of the engine holds: the 29kg weight, for a mass of 29.0kg.
The engine is tilting to the left.

>put 32kg on right
You put the 32kg weight on the right mount.

The left mount of the engine holds: the 15kg weight and the 50kg weight, for a mass of 65.0kg.
The right mount of the engine holds: the 32kg weight and the 29kg weight, for a mass of 61.0kg.
The engine is balanced!

>take all
15kg weight: Taken.
50kg weight: Taken.
32kg weight: Taken.
29kg weight: Taken.

>l
Starboard Engine Chamber
This is where the the combustion of the main engine is converted into forward thrust. The engine, ten feet in diameter, is quiet now, and you'd prefer not to be here when it is on.

The engine is tilting to the left, just a fraction of an inch.
⇒ You can say "put 9kg on right" or "put 15kg on left".

>put 5kg on right
You can't see any such thing.

>o
Think nothing of it.

>i
You are carrying:
  a 29kg weight
  a 32kg weight
  a 50kg weight
  a 15kg weight
  a 9kg weight
  a vac suit (being worn)
  a military sanitation uniform (being worn)

>rules
Rules tracing now switched on. Type "rules off" to switch it off again, or "rules all" to include even rules which do not apply.

>i
[Rule "redirect to GEP line input rule" applies.]
[Rule "After reading a command" applies.]
[Rule "declare everything initially unmentioned rule" applies.]
[Rule "announce items from multiple object lists rule" applies.]
[Rule "set pronouns from items from multiple object lists rule" applies.]
[Rule "before stage rule" applies.]
[Rule "instead stage rule" applies.]
[Rule "investigate player's awareness before action rule" applies.]
[Rule "player aware of his own actions rule" applies.]
[Rule "check stage rule" applies.]
[Rule "carry out stage rule" applies.]
[Rule "print empty inventory rule" applies.]
[Rule "print standard inventory rule" applies.]
You are carrying:
  a 29kg weight
  a 32kg weight
  a 50kg weight
  a 15kg weight
  a 9kg weight
  a vac suit (being worn)
  a military sanitation uniform (being worn)
[Rule "after stage rule" applies.]

[Rule "investigate player's awareness after action rule" applies.]
[Rule "report stage rule" applies.]
[Rule "report other people taking inventory rule" applies.]
[Rule "last specific action-processing rule" applies.]
[Rule "A first turn sequence rule" applies.]
[Rule "every turn stage rule" applies.]
[Rule "Every turn when not talking about asking mulgrew questions" applies.]
[Rule "Every turn during end game" applies.]
[Rule "reset protocol rule" applies.]
[Rule "close open doors rule" applies.]
[Rule "deactivate equipment cabinets rule" applies.]
[Rule "A last turn sequence rule" applies.]
[Rule "notify score changes rule" applies.]

>o
[Rule "redirect to GEP line input rule" applies.]
Sorry, that can't be corrected.

>rules off
[Rule "redirect to GEP line input rule" applies.]
[Rule "After reading a command" applies.]
[Rule "declare everything initially unmentioned rule" applies.]
Rules tracing now switched off. Type "rules" to switch it on again.

>l
Starboard Engine Chamber
This is where the the combustion of the main engine is converted into forward thrust. The engine, ten feet in diameter, is quiet now, and you'd prefer not to be here when it is on.

The engine is tilting to the left, just a fraction of an inch.
⇒ You can say "put 9kg on right" or "put 15kg on left".

>i
You are carrying:
  a 29kg weight
  a 32kg weight
  a 50kg weight
  a 15kg weight
  a 9kg weight
  a vac suit (being worn)
  a military sanitation uniform (being worn)

>put 9kg on left
You put the 9kg weight on the left mount.

The left mount of the engine holds: the 9kg weight, for a mass of 9.0kg.
The right mount of the engine holds: nothing, for a mass of 0.0kg.
The engine is tilting to the left.

>put 15kg on right
You put the 15kg weight on the right mount.

The left mount of the engine holds: the 9kg weight, for a mass of 9.0kg.
The right mount of the engine holds: the 15kg weight, for a mass of 15.0kg.
The engine is tilting to the right.

>take all
9kg weight: Taken.
15kg weight: Taken.

* * *

>s
The only obvious exit is fore.

>go s
You can't go that way.

>say ggg
(to yourself)
I'm not sure what you're trying to say. I might just not recognize the words you're using.

>s
You can't go that way.

>go s
You can't go that way.

>walk s
You can't go that way.

>walk n
You must use nautical directions: fore, aft, port, starboard, up, down, inside, or outside.

>walk in
You pass through the aft airlock and into the ship, closing the airlock doors behind you.

Aft Entry
You are forward from the aft airlock, inside the ship. Beyond the airlock is the station gangway.

On your right is a control panel for the airlock. It consists of a green button to pressurize the airlock chamber, a yellow button to depressurize it, a red button to open and close the inner airlock door, and a blue button to open and close the outer airlock door.

The airlock is aft of here, and a ladder leads up to the ship proper.

The aft airlock inner door is closed.

>gonear left mount
Starboard Engine Chamber
This is where the the combustion of the main engine is converted into forward thrust. The engine, ten feet in diameter, is quiet now, and you'd prefer not to be here when it is on.

The engine is tilting to the right, just a few millimeters.
⇒ You can say "put 9kg on right" or "put 15kg on left".

>purloin weights
[Purloined.]
[Purloined.]
[Purloined.]
[Purloined.]
[Purloined.]

>put all weights on left mount
50kg weight: You put the 50kg weight on the left mount.

The left mount of the engine holds: the 50kg weight, for a mass of 50.0kg.
The right mount of the engine holds: nothing, for a mass of 0.0kg.
The engine is tilting to the left.
32kg weight: You put the 32kg weight on the left mount.

The left mount of the engine holds: the 32kg weight and the 50kg weight, for a mass of 82.0kg.
The right mount of the engine holds: nothing, for a mass of 0.0kg.
The engine is tilting to the left.
29kg weight: You put the 29kg weight on the left mount.

The left mount of the engine holds: the 29kg weight, the 32kg weight, and the 50kg weight, for a mass of 111.0kg.
The right mount of the engine holds: nothing, for a mass of 0.0kg.
The engine is tilting to the left.
15kg weight: You put the 15kg weight on the left mount.

The left mount of the engine holds: the 15kg weight, the 29kg weight, the 32kg weight, and the 50kg weight, for a mass of 126.0kg.
The right mount of the engine holds: nothing, for a mass of 0.0kg.
The engine is tilting to the left.
9kg weight: You put the 9kg weight on the left mount.

The left mount of the engine holds: the 9kg weight, the 15kg weight, the 29kg weight, the 32kg weight, and the 50kg weight, for a mass of 135.0kg.
The right mount of the engine holds: nothing, for a mass of 0.0kg.
The engine is tilting to the left.

>take 9kg then put it on right
Taken.

You put the 9kg weight on the right mount.

The left mount of the engine holds: the 15kg weight, the 29kg weight, the 32kg weight, and the 50kg weight, for a mass of 126.0kg.
The right mount of the engine holds: the 9kg weight, for a mass of 9.0kg.
The engine is tilting to the left.

>take 15kg then put it on right
Taken.

You put the 15kg weight on the right mount.

The left mount of the engine holds: the 29kg weight, the 32kg weight, and the 50kg weight, for a mass of 111.0kg.
The right mount of the engine holds: the 15kg weight and the 9kg weight, for a mass of 24.0kg.
The engine is tilting to the left.

>take 29kg then put it on right
Taken.

You put the 29kg weight on the right mount.

The left mount of the engine holds: the 32kg weight and the 50kg weight, for a mass of 82.0kg.
The right mount of the engine holds: the 29kg weight, the 15kg weight, and the 9kg weight, for a mass of 53.0kg.
The engine is tilting to the left.

>take 32kg then put it on right
Taken.

You put the 32kg weight on the right mount.

The left mount of the engine holds: the 50kg weight, for a mass of 50.0kg.
The right mount of the engine holds: the 32kg weight, the 29kg weight, the 15kg weight, and the 9kg weight, for a mass of 85.0kg.
The engine is tilting to the right.

>take 9kg then put it on left
Taken.

You put the 9kg weight on the left mount.

The left mount of the engine holds: the 9kg weight and the 50kg weight, for a mass of 59.0kg.
The right mount of the engine holds: the 32kg weight, the 29kg weight, and the 15kg weight, for a mass of 76.0kg.
The engine is tilting to the right.

>take 15kg the put it on left
I only understood you as far as wanting to take the 15kg weight.

>take 15kg then put it on left
Taken.

You put the 15kg weight on the left mount.

The left mount of the engine holds: the 15kg weight, the 9kg weight, and the 50kg weight, for a mass of 74.0kg.
The right mount of the engine holds: the 32kg weight and the 29kg weight, for a mass of 61.0kg.
The engine is tilting to the left.

>take 15kg
Taken.

>l
Starboard Engine Chamber
This is where the the combustion of the main engine is converted into forward thrust. The engine, ten feet in diameter, is quiet now, and you'd prefer not to be here when it is on.

The left mount of the engine holds: the 9kg weight and the 50kg weight, for a mass of 59.0kg.
The right mount of the engine holds: the 32kg weight and the 29kg weight, for a mass of 61.0kg.
The engine is tilting to the right.

>take 9kg then put 15kg on left
Taken.

You put the 15kg weight on the left mount.

The left mount of the engine holds: the 15kg weight and the 50kg weight, for a mass of 65.0kg.
The right mount of the engine holds: the 32kg weight and the 29kg weight, for a mass of 61.0kg.
The engine is balanced!

>x ceiling
You can't see any such thing.

* * *

>s
The only obvious exit is fore.

>say asdf
(to yourself)
I'm not sure what you're trying to say. I might just not recognize the words you're using.

>s
You can't go that way.

>go s
(starboard)
You can't go that way.

>walk s
(starboard)
You can't go that way.

>move s
Which do you mean, the south or starboard?

* * *

>s
The only obvious exit is fore.

>say foo
(to yourself)
I'm not sure what you're trying to say. I might just not recognize the words you're using.

>s
The only obvious exit is fore.

>f
You pass through the aft airlock and into the ship, closing the airlock doors behind you.

Aft Entry
You are forward from the aft airlock, inside the ship. Beyond the airlock is the station gangway.

On your right is a control panel for the airlock. It consists of a green button to pressurize the airlock chamber, a yellow button to depressurize it, a red button to open and close the inner airlock door, and a blue button to open and close the outer airlock door.

The airlock is aft of here, and a ladder leads up to the ship proper.

The aft airlock inner door is closed.

>u
Crew Quarters
This is a busy junction when the ship is populated. To port and starboard are the crew bunks, aft is the door to the captain's quarters, and fore is the galley. A ladder leads down to the aft airlock.

⇒ You can ask for hints at any time by typing "hints".

BOOM -- suddenly everything goes to hell. A bulkhead seems to hurtle towards you...
pain...
confusion...
blackness...
Somehow you're okay. Inertial dampers must have kicked in. Nevertheless, you feel like you were hit by a truck.
But what happened?

Crash
An Interactive Fiction by Phil Riley
Release 4 / Serial number 220621 / Inform 7 build 6M62 (I6/v6.34 lib 6/12N) SD

[Where am I?]

>z
[What? Didn't get that. My brain is spinning too much. Try again.]

* * *

>s
(first getting off the right bottom bunk)
[Standing up makes me a little dizzy, oh my.]

Crew Quarters
This is a busy junction when the ship is populated. To port and starboard are the crew bunks, aft is the door to the captain's quarters, and fore is the galley. A ladder leads down to the aft airlock.

>restart
Are you sure you want to restart?

* * *

>y
Would you like to use accessibility features like no ASCII art? (enter "y" for yes)

>n
Space Station Gangway
This is the pressurized bridge from Space Station Omicron-5 to the SS Usagi. Behind you the safety of home, before you the promise of adventure... cleaning up after space marines. Such is the lot of the 95th Sanitation Division. Not what you dreamed of when you enlisted.

As is usual, the crew is all off the ship while you board to clean it. You usually have a partner, but today Private "Chubby" Franks has the flu, so it's your job alone.

To the fore is the aft airlock of the Usagi, beckoning you in.

[Better get a move on, I guess], you think.

⇒ For help with testing, enter "help test".

⇒ Tip: Type "help" to learn about this game, and interactive fiction in general.

* * *

>i
You are carrying:
  a military ID card
  a wallet (open but empty)
  a vac suit (being worn)

Your vac suit pings gently to indicate you have expended a unit of air.

>u
The obvious exits are aft (to outside the aft airlock (vacuum)) and starboard.

Your vac suit pings gently to indicate you have expended a unit of air.

>s
You attempt to climb over the debris. Just when you think you're over, your foot catches, and you lose your hold. The result: you're floating about a foot from the hull, unable to make contact with your mag boots to pull yourself down. You're barely moving relative to the hull, but you're stuck here. The bright side? You broke down the debris enough that it's no longer a barrier.

[Okay, stay calm. Don't freak out.]

Hull of the Usagi (vacuum, floating)
Here the path runs aft to the aft airlock and starboard to the engineering airlock. Where there used to be a large embedded chunk of debris blocking the path, now there is a scattering of rubble.

It looks like you could break off a small piece of debris.

Your vac suit pings gently to indicate you have expended a unit of air.

>take debris
You break off a piece of the debris.

Your vac suit pings gently to indicate you have expended a unit of air.

>throw it
You throw the small piece of debris away from the ship. It propels you just a tiny amount toward the hull, but it's enough. One agonizing minute later, you're attached to the hull again.

[Oh thank god! I thought I was a goner.]

Hull of the Usagi (vacuum)
Here the path runs aft to the aft airlock and starboard to the engineering airlock. Where there used to be a large embedded chunk of debris blocking the path, now there is a scattering of rubble.

A stern voice in your helmet intones "Air levels critical. Seek a pressurized location immediately."

* * *

>test   onepass
(Testing.)

>[1] gonear onepass
Starboard-Side Bunks
All crew members who aren't the captain sleep in this or the opposite-side bunk room. This one sleeps four in two sets of bunks, one on the left and one on the right, all done up with military precision. There is a large locker here, stretching almost to the ceiling. It is closed. The sole exit is to port.

On the left bottom bunk is a OnePass.

A copy of Stars Magazine is just peeking from underneath the left bottom bunk.

>[2] take onepass
Taken.

>[3] x it
Insert your cards in this part here, and swipe this part just like a card! 

[These things are great. You just put all your access cards in it, and then use it as a card instead.]

A little readout on the side of the OnePass says "No cards stored."

>put card in onepass
foo

>i
You are carrying:
  a OnePass
  a maintenance crew access card
  a sonic decontaminator
  a hand-held micro-compressing vacuum cleaner
  an extendable dusting device
  a military sanitation uniform (being worn)

>put onepass in onepass
You can't put something inside itself.

>put device in onepass
That can't contain things.

* * *

>test locks
>--> The following tests are available:
'test spacewalk'

>slide door through id card
It's not clear how to do that with the the Captain's door.

>slide id card through vacuum
It's not clear how to do that with the the hand-held micro-compressing vacuum cleaner.

>open vacuum with id card
That doesn't seem to be something you can unlock.

* * *

>test locks
>--> The following tests are available:
'test spacewalk'

>slide duster in vacuum
You can't see any such thing.

* * *

>test locks
>--> The following tests are available:
'test spacewalk'

>slide duster through slot
You can't see any such thing.

>trace 4
[Parser tracing set to level 4.]

>slide duster through slot
[ "slide" slide / "duster" duster / "through" through / "slot" slot ]
[Parsing for the verb 'slide' (2 lines)]

[line 0 * noun=Routine(605104) 'through' / 'in' noun=Routine(605151) -> A111_sliding_it_through]
 [line 0 token 1 word 2 : noun=Routine(605104)]
  [Object list from word 2]
  [Calling NounDomain on location and actor]
   [NounDomain called at word 2
   seeking definite object
   [ND made 0 matches]
  [token resulted in failure with error type 5]

[line 1 * noun=Routine(605030) 'through' / 'in' noun=Routine(605067) -> A111_sliding_it_through]
 [line 1 token 1 word 2 : noun=Routine(605030)]
  [Object list from word 2]
  [Calling NounDomain on location and actor]
   [NounDomain called at word 2
   seeking definite object
Parse_name called
Pass 1: 0 Pass 2: 0 Pass 3: 0
   [ND made 0 matches]
  [token resulted in failure with error type 5]
You can't see any such thing.

>i
[ "i" i ]
[Parsing for the verb 'i' (2 lines)]

[line 0 * -> Inv]
 [line 0 token 1 word 2 : END]
[Line successfully parsed]
You are carrying:
  an Engineering Access Card
  a OnePass
  a military ID card
  a maintenance crew access card
  a military sanitation uniform (being worn)

* * *

>test locks
>--> The following tests are available:
'test spacewalk'

>slide duster through vacuum
That won't work for the extendable dusting device.

>i
You are carrying:
  an Engineering Access Card
  a OnePass
  a military ID card
  an extendable dusting device
  a hand-held micro-compressing vacuum cleaner
  a wallet (closed)
  a sonic decontaminator
  a maintenance crew access card
  a military sanitation uniform (being worn)

>slide duster through slot
You can't see any such thing.

* * *

>test locks
>--> The following tests are available:
'test spacewalk'

>slide onepass through door
You slide the OnePass through the slot. It is rejected with an unpleasant buzz.

>put onepass in door
You slide the OnePass through the slot. It is rejected with an unpleasant buzz.

* * *

>test locks
>--> The following tests are available:
'test spacewalk'

>vacuum slot
You vacuum the slot for a few seconds. That should do it.

>put id in door
You slide the military ID card through the slot. It is rejected with an unpleasant buzz.

>slide engineering card through door
You slide the Engineering Access Card through the slot. It is rejected with an unpleasant buzz.

>slide maintenance card in slot
You slide the maintenance crew access card through the slot. The Captain's door slides smoothly open. A pleasant ping indicates it now recognizes you as authorized.

>a
The Captain's door closes silently behind you.

Captain's Quarters
Neat and spartan, this cabin is the very model of a small fighting ship's captain's quarters. An impeccably organized desk is against one wall, while a typically spotless bed sits beneath a portrait of this very ship. There is a data terminal on the desk. Against a third wall is the captain's one indulgence: a set of free weights neatly put away in racks. You can exit to fore.

You can see a 9kg weight, a 15kg weight, a 29kg weight, a 32kg weight, and a 50kg weight here.

⇒ You may talk to the ship computer through the data terminal. You might try "computer, help" to get help on talking to the computer.

* * *

>test locks
>--> The following tests are available:
'test spacewalk'

>z
Time passes.

>z
Time passes.

The port-side equipment locker stops flashing green.

* * *

>test onepass
(Testing.)

>[1] gonear onepass
Starboard-Side Bunks
All crew members who aren't the captain sleep in this or the opposite-side bunk room. This one sleeps four in two sets of bunks, one on the left and one on the right, all done up with military precision. There is a large locker here, stretching almost to the ceiling. It is closed. The sole exit is to port.

On the left bottom bunk is a OnePass.

A copy of Stars Magazine is just peeking from underneath the left bottom bunk.

>[2] take onepass
Taken.

>[3] slide onepass in slot
You can't see any such thing.

>[4] purloin id
(the military ID card)
[Purloined.]

>[5] put id in onepass
The OnePass swallows up the military ID card. It is now available when using the OnePass.

>[6] purloin steel key
[Purloined.]

>[7] slide onepass in slot
You can't see any such thing.

>[8] unlock locker with key
You are unable to turn the key.

>i
You are carrying:
  a OnePass
  a sonic decontaminator
  a hand-held micro-compressing vacuum cleaner
  an extendable dusting device
  a military sanitation uniform (being worn)

* * *

>p
Crew Quarters
This is a busy junction when the ship is populated. To port and starboard are the crew bunks, aft is the door to the captain's quarters, and fore is the galley. A ladder leads down to the aft airlock.

⇒ You can ask for hints at any time by typing "hints".

BOOM -- suddenly everything goes to hell. A bulkhead seems to hurtle towards you...
pain...
confusion...
blackness...
Somehow you're okay. Inertial dampers must have kicked in. Nevertheless, you feel like you were hit by a truck.
But what happened?

Crash
An Interactive Fiction by Phil Riley
Release 4 / Serial number 220621 / Inform 7 build 6M62 (I6/v6.34 lib 6/12N) SD

[Where am I?]

>z
[What? Didn't get that. My brain is spinning too much. Try again.]

* * *

>s
(first getting off the right bottom bunk)
[Standing up makes me a little dizzy, oh my.]

Crew Quarters
This is a busy junction when the ship is populated. To port and starboard are the crew bunks, aft is the door to the captain's quarters, and fore is the galley. A ladder leads down to the aft airlock.

>open door with onepass
You slide the OnePass through the slot. The door buzzes three times, indicating the card is unreadable.

>s
Which do you mean, the south or starboard?

>s
Which do you mean, the south or starboard?

>restart
Are you sure you want to restart?

* * *

>y
Would you like to use accessibility features like no ASCII art? (enter "y" for yes)

>say xyzzy
Space Station Gangway
This is the pressurized bridge from Space Station Omicron-5 to the SS Usagi. Behind you the safety of home, before you the promise of adventure... cleaning up after space marines. Such is the lot of the 95th Sanitation Division. Not what you dreamed of when you enlisted.

As is usual, the crew is all off the ship while you board to clean it. You usually have a partner, but today Private "Chubby" Franks has the flu, so it's your job alone.

To the fore is the aft airlock of the Usagi, beckoning you in.

[Better get a move on, I guess], you think.

⇒ For help with testing, enter "help test".

⇒ Tip: Type "help" to learn about this game, and interactive fiction in general.

>say xyzzy
(to yourself)
I'm not sure what you're trying to say. I might just not recognize the words you're using.

>s
Which do you mean, the south or starboard?

* * *

>s
You can't go that way.

>say xyzzy
(to yourself)
I'm not sure what you're trying to say. I might just not recognize the words you're using.

* * *

>s
Which do you mean, the south or starboard?

>go s
(starboard)
You can't go that way.

>go s
(starboard)
You can't go that way.

>move s
Which do you mean, the south or starboard?

>s
Which do you mean, the south or starboard?

>walk s
(starboard)
You can't go that way.

* * *

>z
Time passes.

>s
(first getting off the right bottom bunk)
[Standing up makes me a little dizzy, oh my.]

Crew Quarters
This is a busy junction when the ship is populated. To port and starboard are the crew bunks, aft is the door to the captain's quarters, and fore is the galley. A ladder leads down to the aft airlock.

>put card in onepass
The OnePass swallows up the maintenance crew access card. It is now available when using the OnePass.

>slide onepass in door
You can't see any such thing.

* * *

>purloin key
Which do you mean, Access key or the steel key?

>steel
[Purloined.]

>unlock locker with key
You unlock the starboard-side equipment locker.

You open the starboard-side equipment locker, revealing a beacon.

>slide onepass in slot
The door is already unlocked.

* * *

>put card in onepass
The OnePass swallows up the maintenance crew access card. It is now available when using the OnePass.

>insert card in onepass
foo

* * *

>put card in onepass
The OnePass swallows up the maintenance crew access card. It is now available when using the OnePass.

>p
Crew Quarters
This is a busy junction when the ship is populated. To port and starboard are the crew bunks, aft is the door to the captain's quarters, and fore is the galley. A ladder leads down to the aft airlock.

⇒ You can ask for hints at any time by typing "hints".

BOOM -- suddenly everything goes to hell. A bulkhead seems to hurtle towards you...
pain...
confusion...
blackness...
Somehow you're okay. Inertial dampers must have kicked in. Nevertheless, you feel like you were hit by a truck.
But what happened?

Crash
An Interactive Fiction by Phil Riley
Release 4 / Serial number 220621 / Inform 7 build 6M62 (I6/v6.34 lib 6/12N) SD

[Where am I?]

* * *

>p
The only obvious exit is starboard (to crew quarters).

>s
(first getting off the right bottom bunk)
[Standing up makes me a little dizzy, oh my.]

Crew Quarters
This is a busy junction when the ship is populated. To port and starboard are the crew bunks, aft is the door to the captain's quarters, and fore is the galley. A ladder leads down to the aft airlock.

>open door with onepass
That doesn't seem to be something you can unlock.

>put door with onepass
You can't see any such thing.

* * *

>x it
A little readout on the side of the OnePass says "No cards stored."

* * *

>break debris
(the small piece of debris)
You break off a piece of the debris.

Your vac suit pings gently to indicate you have expended a unit of air.

>break off debris
You can't see any such thing.

* * *

>break off debris
You break off a piece of the debris
Your vac suit pings gently to indicate you have expended a unit of air.

>break off debris
There are no more easy pieces to break off.

Your vac suit pings gently to indicate you have expended a unit of air.

>drop debris
(the small piece of debris)
Dropped.

Your vac suit pings gently to indicate you have expended a unit of air.

>l
Hull of the Usagi (vacuum)
Here the path runs aft to the aft airlock and starboard to the engineering airlock. Your path to starboard is blocked by a piece of debris lodged in the hull.  It's going to be tough to get over; it doesn't look magnetic, so you'll have to do it without the help of your mag boots.

You can see a small piece of debris here.

Your vac suit pings gently to indicate you have expended a unit of air.

>break off debris
There are no more easy pieces to break off.

A stern voice in your helmet intones "Air levels critical. Seek a pressurized location immediately."

>take debris
(the small piece of debris)
Taken.

A stern voice in your helmet intones "Air levels critical. Seek a pressurized location immediately."

>gonear desk
(the desk drawer)
Captain's Quarters
Neat and spartan, this cabin is the very model of a small fighting ship's captain's quarters. An impeccably organized desk is against one wall, while a typically spotless bed sits beneath a portrait of this very ship. There is a data terminal on the desk. Against a third wall is the captain's one indulgence: a set of free weights neatly put away in racks. You can exit to fore.

You can see a 9kg weight, a 15kg weight, a 29kg weight, a 32kg weight, and a 50kg weight here.

The desk drawer is open and empty.

>drop debris
Dropped.

>break debris
Violence isn't the answer to this one.

>break off debris
There is nothing here to break off.

>break off desk
You can't see any such thing.

>restart
Are you sure you want to restart?

* * *

>rules
Rules tracing now switched on. Type "rules off" to switch it off again, or "rules all" to include even rules which do not apply.

>drop all
[Rule "redirect to GEP line input rule" applies.]
[Rule "After reading a command" applies.]
[Rule "After reading a command" applies.]
[Rule "exclude people from drop all rule" applies.]
[Rule "declare everything initially unmentioned rule" applies.]
[Rule "announce items from multiple object lists rule" applies.]
military ID card: [Rule "set pronouns from items from multiple object lists rule" applies.]
[Rule "before stage rule" applies.]
[Rule "instead stage rule" applies.]
[Rule "investigate player's awareness before action rule" applies.]
[Rule "player aware of his own actions rule" applies.]
[Rule "check stage rule" applies.]
[Rule "can't drop yourself rule" applies.]
[Rule "can't drop what's already dropped rule" applies.]
[Rule "can't drop what's not held rule" applies.]
[Rule "can't drop clothes being worn rule" applies.]
[Rule "can't drop if this exceeds carrying capacity rule" applies.]
[Rule "carry out stage rule" applies.]
[Rule "standard dropping rule" applies.]
[Rule "after stage rule" applies.]
[Rule "investigate player's awareness after action rule" applies.]
[Rule "report stage rule" applies.]
[Rule "standard report dropping rule" applies.]
Dropped.
[Rule "last specific action-processing rule" applies.]
[Rule "announce items from multiple object lists rule" applies.]
wallet: [Rule "set pronouns from items from multiple object lists rule" applies.]
[Rule "before stage rule" applies.]
[Rule "instead stage rule" applies.]
[Rule "investigate player's awareness before action rule" applies.]
[Rule "player aware of his own actions rule" applies.]
[Rule "check stage rule" applies.]
[Rule "can't drop yourself rule" applies.]
[Rule "can't drop what's already dropped rule" applies.]
[Rule "can't drop what's not held rule" applies.]
[Rule "can't drop clothes being worn rule" applies.]
[Rule "can't drop if this exceeds carrying capacity rule" applies.]
[Rule "carry out stage rule" applies.]
[Rule "standard dropping rule" applies.]
[Rule "after stage rule" applies.]
[Rule "investigate player's awareness after action rule" applies.]
[Rule "report stage rule" applies.]
[Rule "standard report dropping rule" applies.]
Dropped.
[Rule "last specific action-processing rule" applies.]

[Rule "A first turn sequence rule" applies.]
[Rule "every turn stage rule" applies.]
[Rule "Every turn when not talking about asking mulgrew questions" applies.]
[Rule "For asking for attention by Arvax while current conversation state is making contact" applies.]
[Rule "reset protocol rule" applies.]
[Rule "close open doors rule" applies.]
[Rule "deactivate equipment cabinets rule" applies.]
[Rule "first check vacuum rule" applies.]
Your vac suit pings gently to indicate you have expended a unit of air.

[Rule "A last turn sequence rule" applies.]
[Rule "notify score changes rule" applies.]

* * *

>break off debris
You break off a piece of the debris
Your vac suit pings gently to indicate you have expended a unit of air.

>gonear engineering deck
Engineering Deck
The engineering crew is responsible for keeping the physical ship operating. They are in charge of every physical aspect of the ship, from the engines to hull integrity to the life support system.

The engineering deck consists of a large console giving a comprehensive view of the physical status of the ship. There is an airlock to starboard. The operations deck continues forward from here, and there are other exits to aft and port.

Near the console is a large cabinet with a card slot. It is closed.

On your right is a control panel for the airlock. It consists of a green button to pressurize the airlock chamber, a yellow button to depressurize it, a red button to open and close the inner airlock door, and a blue button to open and close the outer airlock door.

The engineering airlock inner door is closed.

A device labeled "Suit Recharging Station" is here. It is shaped like a chair with nozzles protruding from either arm.

[My god, so glad to be back inside. I'm never going spacewalking again!]

>break off debris
You can't see any such thing.

>drop debris
Dropped.

You hear someone speaking forward of here.

>break off debris
You can't see any such thing.

>take debris
Taken.

>kill it
Violence isn't the answer to this one.

You hear someone speaking forward of here.

* * *

>break off debris
You break off a piece of the debris
Your vac suit pings gently to indicate you have expended a unit of air.

>i
You are carrying:
  a small piece of debris
  a military ID card
  a wallet (open but empty)
  a vac suit (being worn)

Your vac suit pings gently to indicate you have expended a unit of air.

>break off debris
You can't see any such thing.

* * *

>i
You are carrying:
  a small piece of debris
  a military ID card
  a wallet (open but empty)
  a vac suit (being worn)

Your vac suit pings gently to indicate you have expended a unit of air.

>gonear engineering deck
Engineering Deck
The engineering crew is responsible for keeping the physical ship operating. They are in charge of every physical aspect of the ship, from the engines to hull integrity to the life support system.

The engineering deck consists of a large console giving a comprehensive view of the physical status of the ship. There is an airlock to starboard. The operations deck continues forward from here, and there are other exits to aft and port.

Near the console is a large cabinet with a card slot. It is closed.

On your right is a control panel for the airlock. It consists of a green button to pressurize the airlock chamber, a yellow button to depressurize it, a red button to open and close the inner airlock door, and a blue button to open and close the outer airlock door.

The engineering airlock inner door is closed.

A device labeled "Suit Recharging Station" is here. It is shaped like a chair with nozzles protruding from either arm.

[My god, so glad to be back inside. I'm never going spacewalking again!]

You hear someone speaking forward of here.

>break off debris
You break off a piece of the debris.

>i
You are carrying:
  a small piece of debris
  a military ID card
  a wallet (open but empty)
  a vac suit (being worn)

You hear someone speaking forward of here.

>rules
Rules tracing now switched on. Type "rules off" to switch it off again, or "rules all" to include even rules which do not apply.

>break off debris
[Rule "redirect to GEP line input rule" applies.]
[Rule "After reading a command" applies.]
[Rule "After reading a command" applies.]
[Rule "declare everything initially unmentioned rule" applies.]
[Rule "announce items from multiple object lists rule" applies.]
[Rule "set pronouns from items from multiple object lists rule" applies.]
[Rule "before stage rule" applies.]
[Rule "instead stage rule" applies.]
[Rule "Instead of attacking or taking the small piece of debris" applies.]
You break off a piece of the debris.

[Rule "A first turn sequence rule" applies.]
[Rule "every turn stage rule" applies.]
[Rule "Every turn when not talking about asking mulgrew questions" applies.]
[Rule "reset protocol rule" applies.]
[Rule "close open doors rule" applies.]
[Rule "deactivate equipment cabinets rule" applies.]
[Rule "A last turn sequence rule" applies.]
[Rule "notify score changes rule" applies.]

* * *

>d
The obvious exits are aft (to outside the aft airlock (vacuum)) and starboard.

Your vac suit pings gently to indicate you have expended a unit of air.

>s
You attempt to climb over the debris. Just when you think you're over, your foot catches, and you lose your hold. The result: you're floating about a foot from the hull, unable to make contact with your mag boots to pull yourself down. You're barely moving relative to the hull, but you're stuck here. The bright side? You broke down the debris enough that it's no longer a barrier.

[Okay, stay calm. Don't freak out.]

Hull of the Usagi (vacuum, floating)
Here the path runs aft to the aft airlock and starboard to the engineering airlock. Where there used to be a large embedded chunk of debris blocking the path, now there is a scattering of rubble.

It looks like you could break off a small piece of debris.

Your vac suit pings gently to indicate you have expended a unit of air.

>d
Floating as you are, you can't move in any direction.

Your vac suit pings gently to indicate you have expended a unit of air.

>i
You are carrying:
  a military ID card
  a wallet (open but empty)
  a vac suit (being worn)

Your vac suit pings gently to indicate you have expended a unit of air.

>throw wallet
You throw the wallet away from the ship. It propels you just a tiny amount toward the hull, but it's enough. One agonizing minute later, you're attached to the hull again.

[Oh thank god! I thought I was a goner.]

Hull of the Usagi (vacuum)
Here the path runs aft to the aft airlock and starboard to the engineering airlock. Where there used to be a large embedded chunk of debris blocking the path, now there is a scattering of rubble.

It looks like you could break off a small piece of debris.

A stern voice in your helmet intones "Air levels critical. Seek a pressurized location immediately."

>d
The obvious exits are aft (to outside the aft airlock (vacuum)) and starboard.

A stern voice in your helmet intones "Air levels critical. Seek a pressurized location immediately."

>s
Outside the Engineering Airlock (vacuum)
You are standing on the hull of the ship, outside the engineering airlock, secured by your vac suit's mag boots. Most of the hull is taken up by the protrusions of various machinery, antennae, radio dishes, and heat sinks. There is a clear path to port among the obstructions.

The engineering airlock outer door is closed.

There is a black button on the airlock door.

A stern voice in your helmet intones "Air levels critical. Seek a pressurized location immediately."

>d
The obvious exits are inside and port (to hull of the usagi (vacuum)).

A stern voice in your helmet intones "Air levels critical. Seek a pressurized location immediately."

>in
(first opening the engineering airlock outer door)
You cannot just open the engineering airlock outer door with your bare hands.

A stern voice in your helmet intones "Air levels critical. Seek a pressurized location immediately."

>press button
The engineering airlock door opens.

An alarm sounds and a voice says "Air expended" on repeat.

You are out of air in your vac suit. Should have paid attention to the warnings.

    *** You have died ***

Would you like to RESTART, RESTORE a saved game, QUIT, or UNDO the last command?

>restrt
Please give one of the answers above.

Would you like to RESTART, RESTORE a saved game, QUIT, or UNDO the last command?

>restart
Would you like to use accessibility features like no ASCII art? (enter "y" for yes)

>n
Space Station Gangway
This is the pressurized bridge from Space Station Omicron-5 to the SS Usagi. Behind you the safety of home, before you the promise of adventure... cleaning up after space marines. Such is the lot of the 95th Sanitation Division. Not what you dreamed of when you enlisted.

As is usual, the crew is all off the ship while you board to clean it. You usually have a partner, but today Private "Chubby" Franks has the flu, so it's your job alone.

To the fore is the aft airlock of the Usagi, beckoning you in.

[Better get a move on, I guess], you think.

⇒ For help with testing, enter "help test".

⇒ Tip: Type "help" to learn about this game, and interactive fiction in general.

* * *

>remove suit
It is recommended to not remove the vac suit until you are in a pressurized environment.

Your vac suit pings gently to indicate you have expended a unit of air.

>take debris
(the small piece of debris)
Taken.

Your vac suit pings gently to indicate you have expended a unit of air.

>i
You are carrying:
  a small piece of debris
  a military ID card
  a wallet (open but empty)
  a vac suit (being worn)

Your vac suit pings gently to indicate you have expended a unit of air.

* * *

>break off debris
You can't see any such thing.

>break debris
(the small piece of debris)
Violence isn't the answer to this one.

Your vac suit pings gently to indicate you have expended a unit of air.

>rules
Rules tracing now switched on. Type "rules off" to switch it off again, or "rules all" to include even rules which do not apply.

>break debris
[Rule "redirect to GEP line input rule" applies.]
[Rule "After reading a command" applies.]
[Rule "After reading a command" applies.]
(the small piece of debris)
[Rule "declare everything initially unmentioned rule" applies.]
[Rule "announce items from multiple object lists rule" applies.]
[Rule "set pronouns from items from multiple object lists rule" applies.]
[Rule "before stage rule" applies.]
[Rule "instead stage rule" applies.]
[Rule "investigate player's awareness before action rule" applies.]
[Rule "player aware of his own actions rule" applies.]
[Rule "check stage rule" applies.]
[Rule "block attacking rule" applies.]
Violence isn't the answer to this one.

[Rule "A first turn sequence rule" applies.]
[Rule "every turn stage rule" applies.]
[Rule "Every turn when not talking about asking mulgrew questions" applies.]
[Rule "For asking for attention by Arvax while current conversation state is making contact" applies.]
[Rule "reset protocol rule" applies.]
[Rule "close open doors rule" applies.]
[Rule "deactivate equipment cabinets rule" applies.]
[Rule "first check vacuum rule" applies.]
A stern voice in your helmet intones "Air levels critical. Seek a pressurized location immediately."

[Rule "A last turn sequence rule" applies.]
[Rule "notify score changes rule" applies.]

* * *

>remove suit
It is recommended to not remove the vac suit until you are in a pressurized environment.

Your vac suit pings gently to indicate you have expended a unit of air.

>undo
Hull of the Usagi (vacuum)
[Previous turn undone.]

>rules
Rules tracing now switched on. Type "rules off" to switch it off again, or "rules all" to include even rules which do not apply.

>remove suit
[Rule "redirect to GEP line input rule" applies.]
[Rule "After reading a command" applies.]
[Rule "After reading a command" applies.]
[Rule "declare everything initially unmentioned rule" applies.]
[Rule "announce items from multiple object lists rule" applies.]
[Rule "set pronouns from items from multiple object lists rule" applies.]
[Rule "before stage rule" applies.]
[Rule "instead stage rule" applies.]
[Rule "investigate player's awareness before action rule" applies.]
[Rule "player aware of his own actions rule" applies.]
[Rule "check stage rule" applies.]
[Rule "can't take off what's not worn rule" applies.]
[Rule "can't exceed carrying capacity when taking off rule" applies.]
[Rule "carry out stage rule" applies.]
[Rule "Carry out taking off the vac suit" applies.]
[Rule "standard taking off rule" applies.]
[Rule "after stage rule" applies.]
[Rule "investigate player's awareness after action rule" applies.]
[Rule "report stage rule" applies.]
[Rule "Report taking off the vac suit when originally activated is true" applies.]
The suit says, "Suit deactivated," when you take it off.
[Rule "last specific action-processing rule" applies.]

[Rule "A first turn sequence rule" applies.]
[Rule "every turn stage rule" applies.]
[Rule "Every turn when not talking about asking mulgrew questions" applies.]
[Rule "For asking for attention by Arvax while current conversation state is making contact" applies.]
[Rule "reset protocol rule" applies.]
[Rule "close open doors rule" applies.]
[Rule "deactivate equipment cabinets rule" applies.]
[Rule "second check vacuum rule" applies.]
You are in vacuum. We'll spare you the details, but it isn't a pretty way to go.

[Rule "when play ends stage rule" applies.]
[Rule "print player's obituary rule" applies.]

    *** You have died ***

[Rule "print the final question rule" applies.]
Would you like to RESTART, RESTORE a saved game, QUIT, or UNDO the last command?
[Rule "print the final prompt rule" applies.]

>unfo
[Rule "redirect to GEP line input rule" applies.]
[Rule "standard respond to final question rule" applies.]
Please give one of the answers above.

[Rule "print the final question rule" applies.]
Would you like to RESTART, RESTORE a saved game, QUIT, or UNDO the last command?
[Rule "print the final prompt rule" applies.]

>undo
[Rule "redirect to GEP line input rule" applies.]
[Rule "standard respond to final question rule" applies.]
Hull of the Usagi (vacuum)
[Previous turn undone.]

>rules off
[Rule "redirect to GEP line input rule" applies.]
[Rule "After reading a command" applies.]
[Rule "After reading a command" applies.]
[Rule "declare everything initially unmentioned rule" applies.]
Rules tracing now switched off. Type "rules" to switch it on again.

>actions
Actions listing on.

>remove suit
[taking off the vac suit]
The suit says, "Suit deactivated," when you take it off.
[taking off the vac suit - succeeded]

You are in vacuum. We'll spare you the details, but it isn't a pretty way to go.

    *** You have died ***

Would you like to RESTART, RESTORE a saved game, QUIT, or UNDO the last command?

>undo
Hull of the Usagi (vacuum)
[Previous turn undone.]

* * *

>s
You attempt to climb over the debris. Just when you think you're over, your foot catches, and you lose your hold. The result: you're floating about a foot from the hull, unable to make contact with your mag boots to pull yourself down. You're barely moving relative to the hull, but you're stuck here. The bright side? You broke down the debris enough that it's no longer a barrier.

[Okay, stay calm. Don't freak out.]

Hull of the Usagi (vacuum, floating)
Here the path runs aft to the aft airlock and starboard to the engineering airlock. Where there used to be a large embedded chunk of debris blocking the path, now there is a scattering of rubble.

Your vac suit pings gently to indicate you have expended a unit of air.

* * *

>take debris
(the small piece of debris)
Taken.

Your vac suit pings gently to indicate you have expended a unit of air.

>s
You attempt to climb over the debris. Just when you think you're over, your foot catches, and you lose your hold. The result: you're floating about a foot from the hull, unable to make contact with your mag boots to pull yourself down. You're barely moving relative to the hull, but you're stuck here. The bright side? You broke down the debris enough that it's no longer a barrier.

[Okay, stay calm. Don't freak out.]

Hull of the Usagi (vacuum, floating)
Here the path runs aft to the aft airlock and starboard to the engineering airlock. Where there used to be a large embedded chunk of debris blocking the path, now there is a scattering of rubble.

Your vac suit pings gently to indicate you have expended a unit of air.

>throw debris
You throw the small piece of debris away from the ship. It propels you just a tiny amount toward the hull, but it's enough. One agonizing minute later, you're attached to the hull again.

[Oh thank god! I thought I was a goner.]

Hull of the Usagi (vacuum)
Here the path runs aft to the aft airlock and starboard to the engineering airlock. Where there used to be a large embedded chunk of debris blocking the path, now there is a scattering of rubble.

Your vac suit pings gently to indicate you have expended a unit of air.

>gonear deep space
Deep Space
If you're here, you're already dead.

* * *

>throw debris
You throw the small piece of debris away from the ship. It propels you just a tiny amount toward the hull, but it's enough. One agonizing minute later, you're attached to the hull again.

[Oh thank god! I thought I was a goner.]

Hull of the Usagi (vacuum)
Here the path runs aft to the aft airlock and starboard to the engineering airlock. Where there used to be a large embedded chunk of debris blocking the path, now there is a scattering of rubble.

Your vac suit pings gently to indicate you have expended a unit of air.

>s
Outside the Engineering Airlock (vacuum)
You are standing on the hull of the ship, outside the engineering airlock, secured by your vac suit's mag boots. Most of the hull is taken up by the protrusions of various machinery, antennae, radio dishes, and heat sinks. There is a clear path to port among the obstructions.

The engineering airlock outer door is closed.

There is a black button on the airlock door.

Your vac suit pings gently to indicate you have expended a unit of air.

>press button
The engineering airlock door opens.

A stern voice in your helmet intones "Air levels critical. Seek a pressurized location immediately."

>in
Engineering Airlock Chamber (vacuum)
You are in the Engineering airlock chamber. You're one door away from the great void of space. You can go out of the airlock into space.

On your right is a control panel for the airlock. It consists of a green button to pressurize the airlock chamber, a yellow button to depressurize it, a red button to open and close the inner airlock door, and a blue button to open and close the outer airlock door.

The engineering airlock outer door is open.

The engineering airlock inner door is closed.

A stern voice in your helmet intones "Air levels critical. Seek a pressurized location immediately."

>press red button
You hear a buzz indicating that the airlock chamber is in vacuum.

A stern voice in your helmet intones "Air levels critical. Seek a pressurized location immediately."

>press blue button
The outer door of the airlock slides closed.

A stern voice in your helmet intones "Air levels critical. Seek a pressurized location immediately."

>press green button
You wait several seconds for the door to chime indicating that the chamber is now pressurized.

>press red button
The inner door of the airlock slides open.

>out
You slowly clomp port in your mag boots.

Engineering Deck
The engineering crew is responsible for keeping the physical ship operating. They are in charge of every physical aspect of the ship, from the engines to hull integrity to the life support system.

The engineering deck consists of a large console giving a comprehensive view of the physical status of the ship. There is an airlock to starboard. The operations deck continues forward from here, and there are other exits to aft and port.

Near the console is a large cabinet with a card slot. It is closed.

On your right is a control panel for the airlock. It consists of a green button to pressurize the airlock chamber, a yellow button to depressurize it, a red button to open and close the inner airlock door, and a blue button to open and close the outer airlock door.

The engineering airlock inner door is open.

A device labeled "Suit Recharging Station" is here. It is shaped like a chair with nozzles protruding from either arm.

[My god, so glad to be back inside. I'm never going spacewalking again!]

You hear someone speaking forward of here.

>l
Engineering Deck
The engineering crew is responsible for keeping the physical ship operating. They are in charge of every physical aspect of the ship, from the engines to hull integrity to the life support system.

The engineering deck consists of a large console giving a comprehensive view of the physical status of the ship. There is an airlock to starboard. The operations deck continues forward from here, and there are other exits to aft and port.

Near the console is a large cabinet with a card slot. It is closed.

On your right is a control panel for the airlock. It consists of a green button to pressurize the airlock chamber, a yellow button to depressurize it, a red button to open and close the inner airlock door, and a blue button to open and close the outer airlock door.

The engineering airlock inner door is open.

A device labeled "Suit Recharging Station" is here. It is shaped like a chair with nozzles protruding from either arm.

>hints
Some players may find the temptation to rely on hints overwhelming, and you may prefer to remove temptation by disabling hints for the rest of this game. If you do so, however, you will not be able to access the hints unless you restart. Do you wish to disable hints? >

>no
Engineering Deck
The engineering crew is responsible for keeping the physical ship operating. They are in charge of every physical aspect of the ship, from the engines to hull integrity to the life support system.

The engineering deck consists of a large console giving a comprehensive view of the physical status of the ship. There is an airlock to starboard. The operations deck continues forward from here, and there are other exits to aft and port.

Near the console is a large cabinet with a card slot. It is closed.

On your right is a control panel for the airlock. It consists of a green button to pressurize the airlock chamber, a yellow button to depressurize it, a red button to open and close the inner airlock door, and a blue button to open and close the outer airlock door.

The engineering airlock inner door is open.

A device labeled "Suit Recharging Station" is here. It is shaped like a chair with nozzles protruding from either arm.

>showme
Engineering Deck - room
    engineering airlock inner door - inner airlock door
    yourself - person
        military ID card
        wallet - open container
        vac suit (worn)
    engineering cabinet - locked container
        engineering cabinet slot (part of engineering cabinet) - slot
        *hex-shaped tool
    engineering console
    suit recharging station - supporter
    red button - inner-door-opener-button
    blue button - outer-door-opener-button
    green button - airlock-pressurize-button
    yellow button - airlock-depressurize-button
* denotes things which are not in scope

>press inner-door-opener-button
The inner door of the airlock slides closed.

You hear someone speaking forward of here.

>gonear galley
The Galley
This narrow space is barely enough room for two Marines to prepare and eat a meal. There is a counter with two stools, a microwave oven, and a large closet here. Pots and pans hang from hooks in the ceiling. A ladder leads up through the fore/aft door, and you can leave aft.

On the starboard wall is a panel on which is a blue button. Tacked to the panel is the operator's manual for the fore/aft door.

>z
Time passes.

You faintly hear someone speaking above.

>gonear bridge
Bridge
This is where the captain, navigator, and pilot all sit. Large viewscreens give a full view of the space around the ship. To port you can see the huge blue-white disk of Deneb. Astern you can faintly see the fading embers of what was Space Station Omicron-5.

The pilot's and navigator's chairs sit before their respective consoles. The captain's chair, with command console, sits halfway between them and operations further aft.

>z
Time passes.

You hear someone speaking aft of here.

>a
You slowly clomp aft in your mag boots.

Operations
This is where all of the support activity for the bridge occurs. There are large consoles for environmental controls, communications, and power systems here. The bridge continues forward from here, and engineering is aft. There is a door set in the floor with a ladder leading through it. Set in the frame of the door is a blue button.

A large equipment trunk lies on the Fore/Aft door, blocking it.

>z
Time passes.

A man's voice comes over comms: "Come in, Usagi, Come in, Usagi."

[Finally, another person! I'm saved!]

⇒ By the way... you can get help about speaking to other characters by typing "help speech".

⇒ You might try saying hello.

>hello
(addressing the caller)
You call out "Yes! I'm here! I'm here! What's going on?"

The caller responds, "Ahoy there, SS Usagi, good to hear from you. Seems like you're a bit out of sorts, and we'd like to help you out. But before we get into that, who am I speaking to? Tell me about yourself."

>i am me
I only understood you as far as wanting to take inventory.

>tell caller about me
You tell the caller that you're a ship cleaner of the 95th Sanitation Division.

"Alright then, Captain Clean, I'll fill you in. Space Station Omicron-5 was bombed by separatists from Deneb IV. By some miracle the Usagi was spared the worst of the blast; you were thrown clear of the station. Only problem is now you're hurtling towards New Da Nang, a heavily-populated moon of Deneb II. An impact there would kill not only you but potentially thousands of people more.

 "So we've got some work to do. I'm Master Sergeant R. Mu Arvax. I'm going to try and help you get this ship under control again. First we have to establish, though, what the ship is currently doing. Normally, I'd be able to tap into the ship diagnostics and controls from here on Deneb III, but something seems to have gone wrong. So I'm going to need your help. Are you up to the task?"

[Captain Clean, guy thinks he's funny.]

* * *

>yes
"Great, great. Now let's get to work.

 "The first thing I need you to do is reboot the system, using the captain's data terminal. Once you do that, hopefully I'll be able to access ship controls. You'll have to use my security code: say 'computer, access code 2' and then..."

Master Sergeant R. Mu Arvax's voice breaks up and another voice comes over comms. "SS Usagi, this is Captain Jane Mulgrew, please come in. Repeat, this is Captain Mulgrew of the SS Usagi, Usagi come in."

[Somebody else?]

>hello
(addressing Captain Jane Mulgrew)
Captain Mulgrew responds, "Hello there, Usagi. That's my ship you've got there. Be careful with her.

"We've been listening in and we've heard your communications with Arvax. He had us jammed for a while, but we managed to break through and here we are. Now it's very important that you understand this: Arvax is not your friend. His allegiances lie with Deneb IV, not with the Space Authority. He would like nothing more than to see this ship wipe out a few neighborhoods on New Da Nang.

"So what we need you to do is deny Arvax by shutting down any access to the ship's controls from the outside by invoking the emergency protocols. That will put the ship in a state where we can board and take control of the ship. What do you say? Do you have any questions?"

Master Sergeant R. Mu Arvax's voice comes back over the radio: "You there still, Usagi? I think I lost you for a second."

* * *

>x wall
You really don't need to worry about the wall.

>f
You pass through the aft airlock and into the ship, closing the airlock doors behind you.

Aft Entry
You are forward from the aft airlock, inside the ship. Beyond the airlock is the station gangway.

On your right is a control panel for the airlock. It consists of a green button to pressurize the airlock chamber, a yellow button to depressurize it, a red button to open and close the inner airlock door, and a blue button to open and close the outer airlock door.

The airlock is aft of here, and a ladder leads up to the ship proper.

The aft airlock inner door is closed.

>x wall
You really don't need to worry about the wall.

>restart
Are you sure you want to restart?

* * *

>x wall
You can't see any such thing.

>restart
Are you sure you want to restart?

* * *

>f
You pass through the aft airlock and into the ship, closing the airlock doors behind you.

Aft Entry
You are forward from the aft airlock, inside the ship. Beyond the airlock is the station gangway.

On your right is a control panel for the airlock. It consists of a green button to pressurize the airlock chamber, a yellow button to depressurize it, a red button to open and close the inner airlock door, and a blue button to open and close the outer airlock door.

The airlock is aft of here, and a ladder leads up to the ship proper.

The aft airlock inner door is closed.

>uy
That noun did not make sense in this context.

>u
Crew Quarters
This is a busy junction when the ship is populated. To port and starboard are the crew bunks, aft is the door to the captain's quarters, and fore is the galley. A ladder leads down to the aft airlock.

⇒ You can ask for hints at any time by typing "hints".

BOOM -- suddenly everything goes to hell. A bulkhead seems to hurtle towards you...
pain...
confusion...
blackness...
Somehow you're okay. Inertial dampers must have kicked in. Nevertheless, you feel like you were hit by a truck.
But what happened?

Crash
An Interactive Fiction by Phil Riley
Release 4 / Serial number 220620 / Inform 7 build 6M62 (I6/v6.34 lib 6/12N) SD

[Where am I?]

* * *

>get off bunk
Which do you mean, the left top bunk, the left bottom bunk, the right bottom bunk, or the right top bunk?

>actions
Actions listing on.

>get off bunk
Which do you mean, the left top bunk, the left bottom bunk, the right bottom bunk, or the right top bunk?

>trace
[Trace on.]

>get off bunk
[Parsing for the verb 'get' (6 lines)]
[line 0 * 'out' / 'off' / 'down' / 'up' -> Exit]
[line 1 * 'in' / 'on' -> Enter]
[line 2 * multi -> Take]
[line 3 * 'in' / 'into' / 'on' / 'onto' noun -> Enter]
[line 4 * 'off' / 'down' noun -> GetOff]
Which do you mean, the left top bunk, the left bottom bunk, the right bottom bunk, or the right top bunk?

>trace off
[Parsing for the verb 'trace' (4 lines)]
[line 0 * -> TraceOn]
[line 1 * number -> TraceLevel]
[line 2 * 'on' -> TraceOn]
[line 3 * 'off' -> TraceOff]
[Line successfully parsed]
Trace off.

>get off
[exiting]
[(1) getting off the right bottom bunk]
You get off the right bottom bunk.

Port-Side Bunks
All crew members who aren't the captain sleep in this or the opposite-side bunk room. This one sleeps four in two sets of bunks, one on the left and one on the right, all done up with military precision. There is a large locker here, stretching almost to the ceiling. It is closed. The sole exit is to starboard.

Something is affixed to the wall by the top left bunk.

A leather wallet lies discarded on the ground.

On the right bottom bunk is a hand-held micro-compressing vacuum cleaner.

On the right top bunk is an extendable dusting device.

You can also see a sonic decontaminator here.

[(1) getting off the right bottom bunk - succeeded]

[Standing up makes me a little dizzy, oh my.]

[exiting - succeeded]

[Okay now, back to the station -- let's see, I'm in Port-Side Bunks, so I need to go starboard and then down...]

* * *

Would you like to use accessibility features like no ASCII art? (enter "y" for yes)

>n'
Space Station Gangway
This is the pressurized bridge from Space Station Omicron-5 to the SS Usagi. Behind you the safety of home, before you the promise of adventure... cleaning up after space marines. Such is the lot of the 95th Sanitation Division. Not what you dreamed of when you enlisted.

As is usual, the crew is all off the ship while you board to clean it. You usually have a partner, but today Private "Chubby" Franks has the flu, so it's your job alone.

To the fore is the aft airlock of the Usagi, beckoning you in.

[Better get a move on, I guess], you think.

⇒ For help with testing, enter "help test".

⇒ Tip: Type "help" to learn about this game, and interactive fiction in general.

>f
You pass through the aft airlock and into the ship, closing the airlock doors behind you.

Aft Entry
You are forward from the aft airlock, inside the ship. Beyond the airlock is the station gangway.

On your right is a control panel for the airlock. It consists of a green button to pressurize the airlock chamber, a yellow button to depressurize it, a red button to open and close the inner airlock door, and a blue button to open and close the outer airlock door.

The airlock is aft of here, and a ladder leads up to the ship proper.

The aft airlock inner door is closed.

* * *

>get off bunk
(the right bottom bunk)
You get off the right bottom bunk.

Port-Side Bunks
All crew members who aren't the captain sleep in this or the opposite-side bunk room. This one sleeps four in two sets of bunks, one on the left and one on the right, all done up with military precision. There is a large locker here, stretching almost to the ceiling. It is closed. The sole exit is to starboard.

Something is affixed to the wall by the top left bunk.

A leather wallet lies discarded on the ground.

On the right bottom bunk is a hand-held micro-compressing vacuum cleaner.

On the right top bunk is an extendable dusting device.

You can also see a sonic decontaminator here.

[Okay now, back to the station -- let's see, I'm in Port-Side Bunks, so I need to go starboard and then down...]

>x bunks
You really don't need to worry about the ceiling.

* * *

Would you like to use accessibility features like no ASCII art? (enter "y" for yes)

>protocols
Captain's Quarters
Neat and spartan, this cabin is the very model of a small fighting ship's captain's quarters. An impeccably organized desk is against one wall, while a typically spotless bed sits beneath a portrait of this very ship. There is a data terminal on the desk. Against a third wall is the captain's one indulgence: a set of free weights neatly put away in racks. You can exit to fore.

You can see a 9kg weight, a 15kg weight, a 29kg weight, a 32kg weight, and a 50kg weight here.

⇒ You may talk to the ship computer through the data terminal. You might try "computer, help" to get help on talking to the computer.

>f
The Captain's door opens as you approach, and closes silently behind you.

Crew Quarters
This is a busy junction when the ship is populated. To port and starboard are the crew bunks, aft is the door to the captain's quarters, and fore is the galley. A ladder leads down to the aft airlock.

* * *

>u
Operations
This is where all of the support activity for the bridge occurs. There are large consoles for environmental controls, communications, and power systems here. The bridge continues forward from here, and engineering is aft. There is a door set in the floor with a ladder leading through it. Set in the frame of the door is a blue button.

A large equipment trunk lies on the Fore/Aft door, blocking it.

You can also see an extendable dusting device, a hand-held micro-compressing vacuum cleaner, a sonic decontaminator, and a maintenance crew access card here.

>hello
(addressing Master Sergeant R. Mu Arvax)
"Finally! Where've you been? I'm sad to see you invoked Mulgrew's emergency protocols, but that's water under the bridge. Now we need to try to salvage the situation."

"I'm trying to divert the ship from its collision course with New Da Nang, but there are some problems: the helm is not responding to any commands, there is some physical issue with the starboard engine, and the fuel injection specification for the main engine is incorrect. 

"To be honest, friend, the readouts I'm seeing about the state of helm control are dire. I'm not sure it can be fixed."

>ask arvax about mulgrew
"Seems like she was one of the bad ones. I was suspicious when I learned she had escaped the space station explosion."

>ask arvax about emergency protocols
"I'm afraid I don't know anything about that."

>ask arvax about usagi
"I'm trying to divert the ship from its collision course with New Da Nang, but there are some problems: the helm is not responding to any commands, there is some physical issue with the starboard engine, and the fuel injection specification for the main engine is incorrect. 

"To be honest, friend, the readouts I'm seeing about the state of helm control are dire. I'm not sure it can be fixed."

* * *

>f
Bridge
This is where the captain, navigator, and pilot all sit. Large viewscreens give a full view of the space around the ship. To port you can see the huge blue-white disk of Deneb. Astern you can faintly see the fading embers of what was Space Station Omicron-5.

The pilot's and navigator's chairs sit before their respective consoles. The captain's chair, with command console, sits halfway between them and operations further aft.

>x pilot console
The pilot's console is a sloped table covered with cryptic readouts and touch controls. In the back is an access panel which is closed. A hex-shaped aperture is probably the locking mechanism.

You hear someone speaking aft of here.

>a
Operations
This is where all of the support activity for the bridge occurs. There are large consoles for environmental controls, communications, and power systems here. The bridge continues forward from here, and engineering is aft. There is a door set in the floor with a ladder leading through it. Set in the frame of the door is a blue button.

A large equipment trunk lies on the Fore/Aft door, blocking it.

You can also see an extendable dusting device, a hand-held micro-compressing vacuum cleaner, a sonic decontaminator, and a maintenance crew access card here.

>a
Engineering Deck
The engineering crew is responsible for keeping the physical ship operating. They are in charge of every physical aspect of the ship, from the engines to hull integrity to the life support system.

The engineering deck consists of a large console giving a comprehensive view of the physical status of the ship. There is an airlock to starboard. The operations deck continues forward from here, and there are other exits to aft and port.

Near the console is a large cabinet with a card slot. It is closed.

On your right is a control panel for the airlock. It consists of a green button to pressurize the airlock chamber, a yellow button to depressurize it, a red button to open and close the inner airlock door, and a blue button to open and close the outer airlock door.

The engineering airlock inner door is closed.

A device labeled "Suit Recharging Station" is here. It is shaped like a chair with nozzles protruding from either arm.

You hear someone speaking forward of here.

* * *

>hello
You are already talking to Master Sergeant R. Mu Arvax.

>hello
You are already talking to Master Sergeant R. Mu Arvax.

Master Sergeant R. Mu Arvax: "You there, Usagi? We don't have much time."

>ask arvax about usagi
"I'm trying to divert the ship from its collision course with New Da Nang, but there are some problems: the helm is not responding to any commands, there is some physical issue with the starboard engine, and the fuel injection specification for the main engine is incorrect. 

"To be honest, friend, the readouts I'm seeing about the state of helm control are dire. I'm not sure it can be fixed."

>ask arvax about usagi
"I'm trying to divert the ship from its collision course with New Da Nang, but there are some problems: the helm is not responding to any commands, there is some physical issue with the starboard engine, and the fuel injection specification for the main engine is incorrect. 

"To be honest, friend, the readouts I'm seeing about the state of helm control are dire. I'm not sure it can be fixed."

* * *

Would you like to use accessibility features like no ASCII art? (enter "y" for yes)

>rebooted
Captain's Quarters
Neat and spartan, this cabin is the very model of a small fighting ship's captain's quarters. An impeccably organized desk is against one wall, while a typically spotless bed sits beneath a portrait of this very ship. There is a data terminal on the desk. Against a third wall is the captain's one indulgence: a set of free weights neatly put away in racks. You can exit to fore.

You can see a 9kg weight, a 15kg weight, a 29kg weight, a 32kg weight, and a 50kg weight here.

⇒ You may talk to the ship computer through the data terminal. You might try "computer, help" to get help on talking to the computer.

>accessible on
Accessibility on.

>l
Captain's Quarters
Neat and spartan, this cabin is the very model of a small fighting ship's captain's quarters. An impeccably organized desk is against one wall, while a typically spotless bed sits beneath a portrait of this very ship. There is a data terminal on the desk. Against a third wall is the captain's one indulgence: a set of free weights neatly put away in racks. You can exit to fore.

You can see a 9kg weight, a 15kg weight, a 29kg weight, a 32kg weight, and a 50kg weight here.

>gonear diagram
Engine Room
Though no engines are actually in this room, it is where the combustion process is controlled. Monitoring electronics and controls cover the walls. A wide doorway opens forward to the Engineering Deck, and small portals to port and starboard provide access to the two engine chambers. The main engine, which drives the two side engines, is beyond the aft wall.

There is a large diagram of the fuel injection process on the aft wall. There is a large button below the diagram labeled "Test".

>x it
This is a diagram of the fuel injection process for the main engine. Printed above it is the label "Delphi Engine Controls Aleph-Null". Below that is a representation of the various inputs and the products created during the fuel injection process. Each input has a touch-sensitive surface which can be used to alter the diagram's settings.

Input 1 is unset. Neither is Input 2 set. Input 3 isn't set.
Input 4 isn't set.

Tip: Use "substance > input" to set each input. For instance, "Un > 3" sets input 3 to Unobtainium. You may also use "set <input> to <substance>" for the same effect. Use "disconnect <input>" to disconnect an input.

Tip: If you'd rather use an ASCII-art version of the diagram, use "ASCII on". You can use "ASCII off" to turn the ASCII-art version off again.

* * *

>f
The Captain's door opens as you approach, and closes silently behind you.

Crew Quarters
This is a busy junction when the ship is populated. To port and starboard are the crew bunks, aft is the door to the captain's quarters, and fore is the galley. A ladder leads down to the aft airlock.

* * *

>u
Operations
This is where all of the support activity for the bridge occurs. There are large consoles for environmental controls, communications, and power systems here. The bridge continues forward from here, and engineering is aft. There is a door set in the floor with a ladder leading through it. Set in the frame of the door is a blue button.

A large equipment trunk lies on the Fore/Aft door, blocking it.

You can also see an extendable dusting device, a hand-held micro-compressing vacuum cleaner, a sonic decontaminator, and a maintenance crew access card here.

>hello
(addressing Master Sergeant R. Mu Arvax)
"You're back! Great job rebooting the computer -- I'm getting telemetry now.

"I'm trying to divert the ship from its collision course with New Da Nang, but there are some problems: the helm is not responding to any commands, there is some physical issue with the starboard engine, and the fuel injection specification for the main engine is incorrect."

>ask arvax about mulgrew
"Wonder where she went? It suspicious that she disappeared after you didn't follow orders."

>ask arvax about ship
Which do you mean, the ship computer, the SS Usagi, or the portrait of the ship?

>usagi
"I'm trying to divert the ship from its collision course with New Da Nang, but there are some problems: the helm is not responding to any commands, there is some physical issue with the starboard engine, and the fuel injection specification for the main engine is incorrect."

>ask arvax about new da nang
"I'm afraid I don't know anything about that."

* * *

>hello
(addressing Master Sergeant R. Mu Arvax)
"You're back! Great job rebooting the computer -- I'm getting telemetry now.

"I'm trying to divert the ship from its collision course with New Da Nang, but there are some problems: the helm is not responding to any commands, there is some physical issue with the starboard engine, and the fuel injection specification for the main engine is incorrect."

>ask arvax about the duster
"I'm afraid I don't know anything about that."

* * *

>u
Operations
This is where all of the support activity for the bridge occurs. There are large consoles for environmental controls, communications, and power systems here. The bridge continues forward from here, and engineering is aft. There is a door set in the floor with a ladder leading through it. Set in the frame of the door is a blue button.

A large equipment trunk lies on the Fore/Aft door, blocking it.

You can also see an extendable dusting device, a hand-held micro-compressing vacuum cleaner, a sonic decontaminator, and a maintenance crew access card here.

>press button
The door slides open.

You hear someone speaking above.

>u
Operations
This is where all of the support activity for the bridge occurs. There are large consoles for environmental controls, communications, and power systems here. The bridge continues forward from here, and engineering is aft. There is a door set in the floor with a ladder leading through it. Set in the frame of the door is a blue button.

A large equipment trunk lies on the Fore/Aft door, blocking it.

You can also see an extendable dusting device, a hand-held micro-compressing vacuum cleaner, a sonic decontaminator and a maintenance crew access card here.

>hello
(addressing the Master Sergeant R. Mu Arvax)
You call out "Yes! I'm here! I'm here! What's going on?"

The Master Sergeant R. Mu Arvax responds, "Ahoy there, SS Usagi, good to hear from you. Seems like you're a bit out of sorts, and we'd like to help you out. But before we get into that, who am I speaking to? Tell me about yourself."

* * *

Would you like to use accessibility features like no ASCII art? (enter "y" for yes)

>test
>--> No test scripts exist for this game.

* * *

Would you like to use accessibility features like no ASCII art? (enter "y" for yes)

>test locks
Space Station Gangway
This is the pressurized bridge from Space Station Omicron-5 to the SS Usagi. Behind you the safety of home, before you the promise of adventure... cleaning up after space marines. Such is the lot of the 95th Sanitation Division. Not what you dreamed of when you enlisted.

As is usual, the crew is all off the ship while you board to clean it. You usually have a partner, but today Private "Chubby" Franks has the flu, so it's your job alone.

To the fore is the aft airlock of the Usagi, beckoning you in.

[Better get a move on, I guess], you think.

⇒ For help with testing, enter "help test".

⇒ Tip: Type "help" to learn about this game, and interactive fiction in general.

* * *

>a
The door stays shut as you try to go through it.

* * *

Would you like to use accessibility features like no ASCII art? (enter "y" for yes)

>test me
>--> The following tests are available:
'test airlock'
'test weights'
'test locker'
'test suit'
'test spacing'
'test segment1'
'test win'
'test proto'
'test proto2'
'test suicide'
'test suicide1'
'test suicide2'

* * *

Would you like to use accessibility features like no ASCII art? (enter "y" for yes)

>test onepass
Space Station Gangway
This is the pressurized bridge from Space Station Omicron-5 to the SS Usagi. Behind you the safety of home, before you the promise of adventure... cleaning up after space marines. Such is the lot of the 95th Sanitation Division. Not what you dreamed of when you enlisted.

As is usual, the crew is all off the ship while you board to clean it. You usually have a partner, but today Private "Chubby" Franks has the flu, so it's your job alone.

To the fore is the aft airlock of the Usagi, beckoning you in.

[Better get a move on, I guess], you think.

⇒ For help with testing, enter "help test".

⇒ Tip: Type "help" to learn about this game, and interactive fiction in general.

>test onepass
(Testing.)

>[1] gonear onepass
Starboard-Side Bunks
All crew members who aren't the captain sleep in this or the opposite-side bunk room. This one sleeps four in two sets of bunks, one on the left and one on the right, all done up with military precision. There is a large locker here, stretching almost to the ceiling. It is closed. The sole exit is to port.

On the left bottom bunk is a OnePass.

A copy of Stars Magazine is just peeking from underneath the left bottom bunk.

>[2] take onepass
Taken.

>[3] slide onepass in slot
A light on the locker flashes red.

>[4] purloin id
(the military ID card)
[Purloined.]

>[5] put id in onepass
The OnePass swallows up the military ID card. It is now available when using the OnePass.

>[6] purloin steel key
[Purloined.]

>[7] slide onepass in slot
A green light by the lock starts flashing insistently.

>[8] unlock locker with key
You unlock the starboard-side equipment locker.

You open the starboard-side equipment locker, revealing a beacon.

>p
Crew Quarters
This is a busy junction when the ship is populated. To port and starboard are the crew bunks, aft is the door to the captain's quarters, and fore is the galley. A ladder leads down to the aft airlock.

⇒ You can ask for hints at any time by typing "hints".

BOOM -- suddenly everything goes to hell. A bulkhead seems to hurtle towards you...
pain...
confusion...
blackness...
Somehow you're okay. Inertial dampers must have kicked in. Nevertheless, you feel like you were hit by a truck.
But what happened?

Crash
An Interactive Fiction by Phil Riley
Release 4 / Serial number 220620 / Inform 7 build 6M62 (I6/v6.34 lib 6/12N) SD

[Where am I?]

* * *

>s
Which do you mean, the south or starboard?

>rules
Rules tracing now switched on. Type "rules off" to switch it off again, or "rules all" to include even rules which do not apply.

* * *

>restart
[Rule "redirect to GEP line input rule" applies.]
[Rule "After reading a command" applies.]
[Rule "After reading a command" applies.]
[Rule "declare everything initially unmentioned rule" applies.]
[Rule "investigate player's awareness before action rule" applies.]
[Rule "player aware of his own actions rule" applies.]
[Rule "check stage rule" applies.]
[Rule "carry out stage rule" applies.]
Are you sure you want to restart?

>y
[Rule "redirect to GEP line input rule" applies.]

Would you like to use accessibility features like no ASCII art? (enter "y" for yes)

>n
Space Station Gangway
This is the pressurized bridge from Space Station Omicron-5 to the SS Usagi. Behind you the safety of home, before you the promise of adventure... cleaning up after space marines. Such is the lot of the 95th Sanitation Division. Not what you dreamed of when you enlisted.

As is usual, the crew is all off the ship while you board to clean it. You usually have a partner, but today Private "Chubby" Franks has the flu, so it's your job alone.

To the fore is the aft airlock of the Usagi, beckoning you in.

[Better get a move on, I guess], you think.

⇒ For help with testing, enter "help test".

⇒ Tip: Type "help" to learn about this game, and interactive fiction in general.

>test onepass
(Testing.)

>[1] gonear onepass
Starboard-Side Bunks
All crew members who aren't the captain sleep in this or the opposite-side bunk room. This one sleeps four in two sets of bunks, one on the left and one on the right, all done up with military precision. There is a large locker here, stretching almost to the ceiling. It is closed. The sole exit is to port.

On the left bottom bunk is a OnePass.

A copy of Stars Magazine is just peeking from underneath the left bottom bunk.

>[2] take onepass
Taken.

>[3] x it
Insert your cards in this part here, and swipe this part just like a card! 

[These things are great. You just put all your access cards in it, and then use it as a card instead.]

A little readout on the side of the OnePass says "No cards stored."

>[4] put card in onepass
>[5] x onepass
Insert your cards in this part here, and swipe this part just like a card! 

[These things are great. You just put all your access cards in it, and then use it as a card instead.]

A little readout on the side of the OnePass lists the cards stored: the maintenance crew access card.

>p
Crew Quarters
This is a busy junction when the ship is populated. To port and starboard are the crew bunks, aft is the door to the captain's quarters, and fore is the galley. A ladder leads down to the aft airlock.

⇒ You can ask for hints at any time by typing "hints".

BOOM -- suddenly everything goes to hell. A bulkhead seems to hurtle towards you...
pain...
confusion...
blackness...
Somehow you're okay. Inertial dampers must have kicked in. Nevertheless, you feel like you were hit by a truck.
But what happened?

Crash
An Interactive Fiction by Phil Riley
Release 4 / Serial number 220620 / Inform 7 build 6M62 (I6/v6.34 lib 6/12N) SD

[Where am I?]

* * *

>rules
Rules tracing now switched on. Type "rules off" to switch it off again, or "rules all" to include even rules which do not apply.

* * *

>s
(first getting off the right bottom bunk)
[Standing up makes me a little dizzy, oh my.]

Crew Quarters
This is a busy junction when the ship is populated. To port and starboard are the crew bunks, aft is the door to the captain's quarters, and fore is the galley. A ladder leads down to the aft airlock.

>slide onepass through slot
You slide the OnePass through the slot. The door buzzes three times, indicating the card is unreadable.

>s
Starboard-Side Bunks
All crew members who aren't the captain sleep in this or the opposite-side bunk room. This one sleeps four in two sets of bunks, one on the left and one on the right, all done up with military precision. There is a large locker here, stretching almost to the ceiling. It is closed. The sole exit is to port.

A copy of Stars Magazine is just peeking from underneath the left bottom bunk.

* * *

>p
Crew Quarters
This is a busy junction when the ship is populated. To port and starboard are the crew bunks, aft is the door to the captain's quarters, and fore is the galley. A ladder leads down to the aft airlock.

>p
Port-Side Bunks
All crew members who aren't the captain sleep in this or the opposite-side bunk room. This one sleeps four in two sets of bunks, one on the left and one on the right, all done up with military precision. There is a large locker here, stretching almost to the ceiling. It is closed. The sole exit is to starboard.

Something is affixed to the wall by the top left bunk.

A leather wallet lies discarded on the ground.

On the right bottom bunk is a hand-held micro-compressing vacuum cleaner.

On the right top bunk is an extendable dusting device.

You can also see a sonic decontaminator here.

[Okay now, back to the station -- let's see, I'm in Port-Side Bunks, so I need to go starboard and then down...]

>take all
sonic decontaminator: Taken.
wallet: Taken.
hand-held micro-compressing vacuum cleaner: Taken.
extendable dusting device: Taken.

>restart
Are you sure you want to restart?

* * *

>open door with onepass
[Rule "redirect to GEP line input rule" applies.]
[Rule "After reading a command" applies.]
[Rule "After reading a command" applies.]
[Rule "declare everything initially unmentioned rule" applies.]
[Rule "announce items from multiple object lists rule" applies.]
[Rule "set pronouns from items from multiple object lists rule" applies.]
[Rule "before stage rule" applies.]
[Rule "instead stage rule" applies.]
[Rule "investigate player's awareness before action rule" applies.]
[Rule "player aware of his own actions rule" applies.]
[Rule "check stage rule" applies.]
[Rule "Check sliding an access card ( called the card ) through a starship door ( called D )" applies.]
You slide the OnePass through the slot. The door buzzes three times, indicating the card is unreadable.

[Rule "A first turn sequence rule" applies.]
[Rule "every turn stage rule" applies.]
[Rule "Every turn when not talking about asking mulgrew questions" applies.]
[Rule "For asking for attention by Arvax while current conversation state is making contact" applies.]
[Rule "reset protocol rule" applies.]
[Rule "close open doors rule" applies.]
[Rule "deactivate equipment cabinets rule" applies.]
[Rule "A last turn sequence rule" applies.]
[Rule "notify score changes rule" applies.]

>s
[Rule "redirect to GEP line input rule" applies.]
[Rule "After reading a command" applies.]
[Rule "After reading a command" applies.]
Which do you mean, the south or starboard?

>trace
[Rule "redirect to GEP line input rule" applies.]
[Rule "After reading a command" applies.]
[Rule "After reading a command" applies.]
[Rule "declare everything initially unmentioned rule" applies.]
[Trace on.]

* * *

>restart
[Rule "redirect to GEP line input rule" applies.]
[Rule "After reading a command" applies.]
[Rule "After reading a command" applies.]
[Parsing for the verb 'restart' (1 lines)]
[line 0 * -> Restart]
[Line successfully parsed]
[Rule "declare everything initially unmentioned rule" applies.]
[Rule "investigate player's awareness before action rule" applies.]
[Rule "player aware of his own actions rule" applies.]
[Rule "check stage rule" applies.]
[Rule "carry out stage rule" applies.]
Are you sure you want to restart?

>y
[Rule "redirect to GEP line input rule" applies.]

Would you like to use accessibility features like no ASCII art? (enter "y" for yes)

* * *

>trace
[Trace on.]

>s
(first getting off the right bottom bunk)
[Standing up makes me a little dizzy, oh my.]

Crew Quarters
This is a busy junction when the ship is populated. To port and starboard are the crew bunks, aft is the door to the captain's quarters, and fore is the galley. A ladder leads down to the aft airlock.

>open door with onepass
[Parsing for the verb 'open' (4 lines)]
[line 0 * noun -> Open]
[line 1 * noun=Routine(597044) 'with' noun=Routine(597081) -> A111_sliding_it_through reverse]
[line 2 * noun=Routine(596970) 'with' noun=Routine(597007) -> A111_sliding_it_through reverse]
[Line successfully parsed]
You slide the OnePass through the slot. The door buzzes three times, indicating the card is unreadable.

>s
Which do you mean, the south or starboard?

>pronouns
[Parsing for the verb 'pronouns' (1 lines)]
[line 0 * -> Pronouns]
[Line successfully parsed]
At the moment, "it" means the OnePass, "him" is unset, "her" is unset, and "them" is unset.

>verbs
[Parsing for the verb 'no.verb' (1 lines)]
[line 0 * scope=Routine(601056) '>' scope=Routine(601215) -> A114_inputting_it_into]
That noun did not make sense in this context.

>verb
[Parsing for the verb 'no.verb' (1 lines)]
[line 0 * scope=Routine(601056) '>' scope=Routine(601215) -> A114_inputting_it_into]
That noun did not make sense in this context.

>showverb
[Parsing for the verb 'showverb' (1 lines)]
[line 0 * special -> Showverb]
[Line successfully parsed]
Try typing "showverb" and then the name of a verb.

>showverb s
[Parsing for the verb 'showverb' (1 lines)]
[line 0 * special -> Showverb]
[Line successfully parsed]
Try typing "showverb" and then the name of a verb.

>showverb go
[Parsing for the verb 'showverb' (1 lines)]
[line 0 * special -> Showverb]
[Line successfully parsed]
Verb 'go' 'run' 'walk' 
     * -> Go
     * noun=Routine(596933) -> Go
     * noun -> Enter
     * 'into' / 'in' / 'inside' / 'through' noun -> Enter

* * *

>x it
Insert your cards in this part here, and swipe this part just like a card! 

[These things are great. You just put all your access cards in it, and then use it as a card instead.]A little readout on the side of the OnePass says "No cards stored."

* * *

Would you like to use accessibility features like no ASCII art? (enter "y" for yes)

>test spacewalk
Space Station Gangway
This is the pressurized bridge from Space Station Omicron-5 to the SS Usagi. Behind you the safety of home, before you the promise of adventure... cleaning up after Space Marines. Such is the lot of the 95th Sanitation Division. Not what you dreamed of when you enlisted.

As is usual, the crew is all off the ship while you board to clean it. You usually have a partner, but today Pvt "Chubby" Franks has the flu, so it's your job alone.

To the fore is the aft airlock of the Usagi, beckoning you in.

[Better get a move on, I guess], you think.

⇒ For help with testing, enter "help test".

⇒ Tip: Type "help" to learn about this game, and interactive fiction in general.

* * *

>drop all
military ID card: Dropped.
wallet: Dropped.

Your vac suit pings gently to indicate you have expended a unit of air.

>l
Hull of the Usagi (vacuum)
Here the path runs aft to the aft airlock and starboard to the engineering airlock. Your path to starboard is blocked by a piece of debris lodged in the hull.  It's going to be tough to get over; it doesn't look magnetic, so you'll have to do it without the help of your mag boots.

It looks like you could break off a small piece of debris.

You can also see a wallet (empty) and a military ID card floating here.

Your vac suit pings gently to indicate you have expended a unit of air.

>take all
wallet: Taken.
military ID card: Taken.
small piece of debris: You break off a piece of the debris.

Your vac suit pings gently to indicate you have expended a unit of air.

>gonear captain's quarters
Captain's Quarters
Neat and spartan, this cabin is the very model of a small fighting ship's captain's quarters. An impeccably organized desk is against one wall, while a typically spotless bed sits beneath a portrait of this very ship. There is a data terminal on the desk. Against a third wall is the captain's one indulgence: a set of free weights neatly put away in racks. You can exit to fore.

You can see a 9kg weight, a 15kg weight, a 29kg weight, a 32kg weight, and a 50kg weight here.

The desk drawer is open and empty.

>take all
9kg weight: You can't carry that much weight.
15kg weight: You can't carry that much weight.
29kg weight: You can't carry that much weight.
32kg weight: You can't carry that much weight.
50kg weight: You can't carry that much weight.

>go near spacewalk 1
You can't see any such thing.

>gonear spacewalk 1
Outside the Aft Airlock (vacuum)
You are standing on the hull of the ship, outside the aft airlock, secured by your vac suit's mag boots. Most of the hull is taken up by the protrusions of various machinery, antennae, radio dishes, and heat sinks. There is a clear path to fore among the obstructions.

The aft airlock outer door is open.

Your vac suit pings gently to indicate you have expended a unit of air.

>drop all
small piece of debris: Dropped.
military ID card: Dropped.
wallet: Dropped.

A stern voice in your helmet intones "Air levels critical. Seek a pressurized location immediately."

>l
Outside the Aft Airlock (vacuum)
You are standing on the hull of the ship, outside the aft airlock, secured by your vac suit's mag boots. Most of the hull is taken up by the protrusions of various machinery, antennae, radio dishes, and heat sinks. There is a clear path to fore among the obstructions.

The aft airlock outer door is open.

You can also see a wallet (empty), a military ID card, and a small piece of debris floating here.

A stern voice in your helmet intones "Air levels critical. Seek a pressurized location immediately."

>take all
wallet: Taken.
military ID card: Taken.
small piece of debris: Taken.

A stern voice in your helmet intones "Air levels critical. Seek a pressurized location immediately."

* * *

>l
Engineering Airlock Chamber (vacuum)
You are in the Engineering airlock chamber. You're one door away from the great void of space. Both doors are closed; you'll have to open one to leave the airlock.

On your right is a control panel for the airlock. It consists of a green button to pressurize the airlock chamber, a yellow button to depressurize it, a red button to open and close the inner airlock door, and a blue button to open and close the outer airlock door.

The engineering airlock inner door is closed.

The engineering airlock outer door is closed.

"5"

Your vac suit pings gently to indicate you have expended a unit of air.

>out
You propel yourself away from the ship, away from the explosion that follows moments later. However, in the blackness of space, there is no way anyone will find you. You float until you run out of air and suffocate.

    *** You died saving New Da Nang. ***

Would you like to RESTART, RESTORE a saved game, QUIT, or UNDO the last command?

>undo
Engineering Airlock Chamber (vacuum)
[Previous turn undone.]

* * *

>press blue button
The outer door of the airlock slides open.

"4"

Your vac suit pings gently to indicate you have expended a unit of air.

>out
You propel yourself away from the ship, away from the explosion that follows moments later. However, in the blackness of space, there is no way anyone will find you. You float until you run out of air and suffocate.

    *** You died saving New Da Nang. ***

Would you like to RESTART, RESTORE a saved game, QUIT, or UNDO the last command?

* * *

>undo
Engineering Airlock Chamber (vacuum)
[Previous turn undone.]

>purloin beacon
[Purloined.]

>out
You propel yourself away from the ship, away from the explosion that follows moments later. You switch on your beacon. Hours later, after you'd given up hope, a ship of the Space Marines finds you and brings you home. You are sorry you couldn't save the SS Usagi, but for your part in saving the people of New Da Nang, you receive a medal for meritorious service and are promoted to Lance Corporal.

    *** You saved New Da Nang, but lost the ship. ***

Would you like to RESTART, RESTORE a saved game, QUIT, or UNDO the last command?

* * *

>undo
Engineering Airlock Chamber (vacuum)
[Previous turn undone.]

>rules
Rules tracing now switched on. Type "rules off" to switch it off again, or "rules all" to include even rules which do not apply.

>out'
[Rule "redirect to GEP line input rule" applies.]
[Rule "After reading a command" applies.]
That noun did not make sense in this context.

>out
[Rule "redirect to GEP line input rule" applies.]
[Rule "After reading a command" applies.]
[Rule "declare everything initially unmentioned rule" applies.]
[Rule "Setting action variables for exiting" applies.]
[Rule "announce items from multiple object lists rule" applies.]
[Rule "set pronouns from items from multiple object lists rule" applies.]
[Rule "before stage rule" applies.]
[Rule "instead stage rule" applies.]
[Rule "investigate player's awareness before action rule" applies.]
[Rule "player aware of his own actions rule" applies.]
[Rule "check stage rule" applies.]
[Rule "convert exit into go out rule" applies.]
[Rule "standard set going variables rule" applies.]
[Rule "announce items from multiple object lists rule" applies.]
[Rule "set pronouns from items from multiple object lists rule" applies.]
[Rule "before stage rule" applies.]
[Rule "instead stage rule" applies.]
[Rule "Instead of going from a room ( called R ) to a room ( called R2 ) when player is wearing vac suit and the vac suit is not mag boots activated and R is offboard or R2 is offboard" applies.]
You propel yourself away from the ship, away from the explosion that follows moments later. However, in the blackness of space, there is no way anyone will find you. You float until you run out of air and suffocate.

[Rule "when play ends stage rule" applies.]
[Rule "print player's obituary rule" applies.]

    *** You died saving New Da Nang. ***

[Rule "print the final question rule" applies.]
Would you like to RESTART, RESTORE a saved game, QUIT, or UNDO the last command?
[Rule "print the final prompt rule" applies.]

>out
[Rule "redirect to GEP line input rule" applies.]
[Rule "standard respond to final question rule" applies.]
Please give one of the answers above.

[Rule "print the final question rule" applies.]
Would you like to RESTART, RESTORE a saved game, QUIT, or UNDO the last command?
[Rule "print the final prompt rule" applies.]

>rules off
[Rule "redirect to GEP line input rule" applies.]
[Rule "standard respond to final question rule" applies.]
Please give one of the answers above.

[Rule "print the final question rule" applies.]
Would you like to RESTART, RESTORE a saved game, QUIT, or UNDO the last command?
[Rule "print the final prompt rule" applies.]

>out
[Rule "redirect to GEP line input rule" applies.]
[Rule "standard respond to final question rule" applies.]
Please give one of the answers above.

[Rule "print the final question rule" applies.]
Would you like to RESTART, RESTORE a saved game, QUIT, or UNDO the last command?
[Rule "print the final prompt rule" applies.]

>undo
[Rule "redirect to GEP line input rule" applies.]
[Rule "standard respond to final question rule" applies.]
Engineering Airlock Chamber (vacuum)
[Previous turn undone.]

>undo
[Rule "redirect to GEP line input rule" applies.]
Engineering Airlock Chamber (vacuum)
[Previous turn undone.]

>rules off
[Rule "redirect to GEP line input rule" applies.]
[Rule "After reading a command" applies.]
[Rule "declare everything initially unmentioned rule" applies.]
Rules tracing now switched off. Type "rules" to switch it on again.

>l
Engineering Airlock Chamber (vacuum)
You are in the Engineering airlock chamber. You're one door away from the great void of space. Both doors are closed; you'll have to open one to leave the airlock.

On your right is a control panel for the airlock. It consists of a green button to pressurize the airlock chamber, a yellow button to depressurize it, a red button to open and close the inner airlock door, and a blue button to open and close the outer airlock door.

The engineering airlock inner door is closed.

The engineering airlock outer door is closed.

"5"

Your vac suit pings gently to indicate you have expended a unit of air.

>suit, mag boots on
A pleasant voice says, "Mag boots activated."

"4"

Your vac suit pings gently to indicate you have expended a unit of air.

>out
You need to open the outer door with the blue button first.

"3"

Your vac suit pings gently to indicate you have expended a unit of air.

* * *

Would you like to use accessibility features like no ASCII art? (enter "y" for yes)

>y
Space Station Gangway
This is the pressurized bridge from Space Station Omicron-5 to the SS Usagi. Behind you the safety of home, before you the promise of adventure... cleaning up after Space Marines. Such is the lot of the 95th Sanitation Division. Not what you dreamed of when you enlisted.

As is usual, the crew is all off the ship while you board to clean it. You usually have a partner, but today Pvt "Chubby" Franks has the flu, so it's your job alone.

To the fore is the aft airlock of the Usagi, beckoning you in.

(You think "Better get a move on, I guess")

Tip: For help with testing, enter "help test".

Tip: Type "help" to learn about this game, and interactive fiction in general.

I beg your pardon?

* * *

>f
You pass through the aft airlock and into the ship, closing the airlock doors behind you.

Aft Entry
You are forward from the aft airlock, inside the ship. Beyond the airlock is the station gangway.

On your right is a control panel for the airlock. It consists of a green button to pressurize the airlock chamber, a yellow button to depressurize it, a red button to open and close the inner airlock door, and a blue button to open and close the outer airlock door.

The airlock is aft of here, and a ladder leads up to the ship proper.

The aft airlock inner door is closed.

>u
BOOM -- suddenly everything goes to hell. A bulkhead seems to hurtle towards you...
pain...
confusion...
blackness...
Somehow you're okay. Inertial dampers must have kicked in. Nevertheless, you feel like you were hit by a truck.
But what happened?

Crash
An Interactive Fiction by Phil Riley
Release 2 / Serial number 220619 / Inform 7 build 6M62 (I6/v6.34 lib 6/12N) 

You think, "Where am I?"

* * *

>help
Welcome to Crash by Phil Riley. There are a few things about this game you may want to be aware of.

Text adventures (also known as interactive fiction) have a number of conventions and common commands. Some are:

Move by entering the direction you want to travel. You can use abbreviations, such as "n" for "north" and "u" for "up". 

 - look (or l): prints a description of your surroundings.
 - take <something>: moves something from your surroundings to your person.
 - drop <something>: opposite of take.
 - sit on <something>, get up: what they sound like.
 - examine <something> (or x): get a more detailed description (sometimes) of something.
 - unlock <something> with <something>, open <something>
 - press <a button>
 - inventory (or i): list what the player is carrying.
 - wait (or z): pass one turn doing nothing.

If there's something else you'd like to try, type it in and see what happens!

You can ask for hints at any time by typing "hints". Note that the available hints will vary from time to time, and there may not be any hints available when you ask.

There are a few ways in which this game differs from many text adventures:

First, we use nautical directions: fore, aft, port, starboard, up, down, in, and out. ("f", "a", "p", "s", "u", "d", "in", and "out")

Fore is the direction towards the front of the ship, that is, the usual direction of travel. Aft is the opposite of fore. Port is the direction to your left when you're facing fore. Starboard is the opposite of port. You can remember port from starboard by remembering that "port" and "left" have the same number of letters.

Up and down are relative to the shipboard artificial gravity. This gravity doesn't extend beyond the hull. Instead, outside we have the radial directions in (toward the center of mass of the ship) and out (away from the center of mass).

Second, two new commands: 

 - clean <something> or dust <something>: you're a cleaner, you need to be able to clean.
 - slide <something> through <a card slot>: some of the doors in the game require access cards.

To turn on accessibility features, use "accessible on". To turn them off again, use "accessible off".

You can also get help talking to other characters with "help speech".

>accessible off
Accessibility off.

>help
Welcome to Crash by Phil Riley. There are a few things about this game you may want to be aware of.

Text adventures (also known as interactive fiction) have a number of conventions and common commands. Some are:

Move by entering the direction you want to travel. You can use abbreviations, such as "n" for "north" and "u" for "up". 

 - look (or l): prints a description of your surroundings.
 - take <something>: moves something from your surroundings to your person.
 - drop <something>: opposite of take.
 - sit on <something>, get up: what they sound like.
 - examine <something> (or x): get a more detailed description (sometimes) of something.
 - unlock <something> with <something>, open <something>
 - press <a button>
 - inventory (or i): list what the player is carrying.
 - wait (or z): pass one turn doing nothing.

If there's something else you'd like to try, type it in and see what happens!

You can ask for hints at any time by typing "hints". Note that the available hints will vary from time to time, and there may not be any hints available when you ask.

There are a few ways in which this game differs from many text adventures:

First, we use nautical directions: fore, aft, port, starboard, up, down, in, and out. ("f", "a", "p", "s", "u", "d", "in", and "out")

Fore is the direction towards the front of the ship, that is, the usual direction of travel. Aft is the opposite of fore. Port is the direction to your left when you're facing fore. Starboard is the opposite of port. You can remember port from starboard by remembering that "port" and "left" have the same number of letters.

Up and down are relative to the shipboard artificial gravity. This gravity doesn't extend beyond the hull. Instead, outside we have the radial directions in (toward the center of mass of the ship) and out (away from the center of mass).

Second, two new commands: 

 - clean <something> or dust <something>: you're a cleaner, you need to be able to clean.
 - slide <something> through <a card slot>: some of the doors in the game require access cards.

To turn on accessibility features, use "accessible on". To turn them off again, use "accessible off".

You can also get help talking to other characters with "help speech".
  And finally, [text that looks like this] is the main character's, i.e., your, thoughts.

* * *

>l
Space Station Gangway
This is the pressurized bridge from Space Station Omicron-5 to the SS Usagi. Behind you the safety of home, before you the promise of adventure... cleaning up after Space Marines. Such is the lot of the 95th Sanitation Division. Not what you dreamed of when you enlisted.

As is usual, the crew is all off the ship while you board to clean it. You usually have a partner, but today Pvt "Chubby" Franks has the flu, so it's your job alone.

To the fore is the aft airlock of the Usagi, beckoning you in.

(You think "Better get a move on, I guess")

Tip: Type "help" to learn about this game, and interactive fiction in general.

* * *

>z
You have a job to do. No messing around.

>l
Space Station Gangway
This is the pressurized bridge from Space Station Omicron-5 to the SS Usagi. Behind you the safety of home, before you the promise of adventure... cleaning up after Space Marines. Such is the lot of the 95th Sanitation Division. Not what you dreamed of when you enlisted.

As is usual, the crew is all off the ship while you board to clean it. You usually have a partner, but today Pvt "Chubby" Franks has the flu, so it's your job alone.

To the fore is the aft airlock of the Usagi, beckoning you in.

(You think "Better get a move on, I guess")

Tip: Type "help" to learn about this game, and interactive fiction in general.